datetime,bendahara_motorcycle,bendahara_car,bendahara_truck,bendahara_bus,bendahara_total,temenggong_motorcycle,temenggong_car,temenggong_truck,temenggong_bus,temenggong_total,temperature_2m,relative_humidity_2m,weathercode,windspeed_10m,total_traffic,is_weekend,hour,total_motorcycle,total_car,total_truck,total_bus,date_only,is_holiday_mlk,is_holiday,is_jam,car_share,motorcycle_share,truck_share,bus_share,peak_category,day_of_week,month
2024-01-01 00:00:00,25,225,0,0,250,52,66,0,0,118,25.3,92,3,5.9,368,False,0,77,291,0,0,2024-01-01,True,True,False,0.7907608695652174,0.20923913043478262,0.0,0.0,Off-Peak,Monday,January
2024-01-01 01:00:00,42,216,0,0,258,60,75,0,0,135,25.0,91,3,6.3,393,False,1,102,291,0,0,2024-01-01,True,True,False,0.7404580152671756,0.2595419847328244,0.0,0.0,Off-Peak,Monday,January
2024-01-01 02:00:00,30,221,0,0,251,131,162,0,0,293,24.7,93,1,7.5,544,False,2,161,383,0,0,2024-01-01,True,True,False,0.7040441176470589,0.2959558823529412,0.0,0.0,Off-Peak,Monday,January
2024-01-01 03:00:00,36,218,0,0,254,54,69,0,0,123,24.5,94,2,8.4,377,False,3,90,287,0,0,2024-01-01,True,True,False,0.7612732095490716,0.23872679045092837,0.0,0.0,Off-Peak,Monday,January
2024-01-01 04:00:00,46,213,0,0,259,67,88,1,0,156,24.3,94,2,9.7,415,False,4,113,301,1,0,2024-01-01,True,True,False,0.7253012048192771,0.27228915662650605,0.0024096385542168677,0.0,Off-Peak,Monday,January
2024-01-01 05:00:00,40,213,1,0,254,136,165,1,0,302,24.1,95,3,9.3,556,False,5,176,378,2,0,2024-01-01,True,True,False,0.6798561151079137,0.31654676258992803,0.0035971223021582736,0.0,Shoulder,Monday,January
2024-01-01 06:00:00,30,215,1,0,246,135,165,1,0,301,23.9,96,3,9.7,547,False,6,165,380,2,0,2024-01-01,True,True,False,0.6946983546617916,0.3016453382084095,0.003656307129798903,0.0,Shoulder,Monday,January
2024-01-01 07:00:00,32,213,1,0,246,67,84,1,0,152,23.6,97,3,8.2,398,False,7,99,297,2,0,2024-01-01,True,True,False,0.7462311557788944,0.24874371859296482,0.005025125628140704,0.0,Peak,Monday,January
2024-01-01 08:00:00,30,214,1,0,245,56,71,1,0,128,24.1,95,3,8.4,373,False,8,86,285,2,0,2024-01-01,True,True,False,0.7640750670241286,0.23056300268096513,0.005361930294906166,0.0,Peak,Monday,January
2024-01-01 09:00:00,46,217,1,0,264,117,143,1,0,261,26.4,89,3,8.9,525,False,9,163,360,2,0,2024-01-01,True,True,False,0.6857142857142857,0.31047619047619046,0.0038095238095238095,0.0,Shoulder,Monday,January
2024-01-01 10:00:00,23,214,1,0,238,124,151,1,0,276,28.1,79,3,11.3,514,False,10,147,365,2,0,2024-01-01,True,True,False,0.7101167315175098,0.28599221789883267,0.0038910505836575876,0.0,Shoulder,Monday,January
2024-01-01 11:00:00,39,213,1,0,253,85,106,1,0,192,29.4,72,3,12.4,445,False,11,124,319,2,0,2024-01-01,True,True,False,0.7168539325842697,0.2786516853932584,0.0044943820224719105,0.0,Peak,Monday,January
2024-01-01 12:00:00,48,212,1,0,261,76,94,1,1,172,30.3,68,3,14.0,433,False,12,124,306,2,1,2024-01-01,True,True,False,0.7066974595842956,0.2863741339491917,0.004618937644341801,0.0023094688221709007,Peak,Monday,January
2024-01-01 13:00:00,35,218,1,0,254,125,152,1,1,279,30.8,66,51,12.4,533,False,13,160,370,2,1,2024-01-01,True,True,False,0.6941838649155723,0.300187617260788,0.00375234521575985,0.001876172607879925,Peak,Monday,January
2024-01-01 14:00:00,37,214,1,0,252,113,138,1,1,253,31.1,66,3,14.1,505,False,14,150,352,2,1,2024-01-01,True,True,False,0.697029702970297,0.297029702970297,0.0039603960396039604,0.0019801980198019802,Peak,Monday,January
2024-01-01 15:00:00,41,215,1,0,257,29,38,1,1,69,31.0,64,51,13.3,326,False,15,70,253,2,1,2024-01-01,True,True,False,0.7760736196319018,0.2147239263803681,0.006134969325153374,0.003067484662576687,Peak,Monday,January
2024-01-01 16:00:00,46,220,1,0,267,41,53,1,1,96,30.4,68,51,8.7,363,False,16,87,273,2,1,2024-01-01,True,True,False,0.7520661157024794,0.2396694214876033,0.005509641873278237,0.0027548209366391185,Peak,Monday,January
2024-01-01 17:00:00,33,218,1,1,253,44,56,1,1,102,28.0,79,51,11.3,355,False,17,77,274,2,2,2024-01-01,True,True,False,0.7718309859154929,0.21690140845070421,0.005633802816901409,0.005633802816901409,Peak,Monday,January
2024-01-01 18:00:00,41,214,1,1,257,122,149,2,2,275,27.4,83,3,8.5,532,False,18,163,363,3,3,2024-01-01,True,True,False,0.6823308270676691,0.30639097744360905,0.005639097744360902,0.005639097744360902,Peak,Monday,January
2024-01-01 19:00:00,27,216,2,2,247,147,178,1,1,327,26.9,85,3,5.6,574,False,19,174,394,3,3,2024-01-01,True,True,False,0.686411149825784,0.30313588850174217,0.005226480836236934,0.005226480836236934,Peak,Monday,January
2024-01-01 20:00:00,28,213,1,1,243,72,91,1,1,165,26.2,91,3,3.1,408,False,20,100,304,2,2,2024-01-01,True,True,False,0.7450980392156863,0.24509803921568626,0.004901960784313725,0.004901960784313725,Shoulder,Monday,January
2024-01-01 21:00:00,36,216,1,1,254,163,199,1,1,364,26.2,91,3,5.9,618,False,21,199,415,2,2,2024-01-01,True,True,False,0.6715210355987055,0.3220064724919094,0.003236245954692557,0.003236245954692557,Shoulder,Monday,January
2024-01-01 22:00:00,47,213,1,1,262,87,110,1,1,199,25.8,93,3,4.7,461,False,22,134,323,2,2,2024-01-01,True,True,False,0.7006507592190889,0.29067245119305857,0.004338394793926247,0.004338394793926247,Shoulder,Monday,January
2024-01-01 23:00:00,32,213,1,1,247,95,118,1,1,215,25.5,95,3,4.2,462,False,23,127,331,2,2,2024-01-01,True,True,False,0.7164502164502164,0.2748917748917749,0.004329004329004329,0.004329004329004329,Shoulder,Monday,January
2024-01-02 00:00:00,30,322,0,0,352,11,42,1,0,54,25.2,95,3,3.8,406,False,0,41,364,1,0,2024-01-02,False,False,False,0.896551724137931,0.10098522167487685,0.0024630541871921183,0.0,Off-Peak,Tuesday,January
2024-01-02 01:00:00,6,75,1,0,82,17,64,0,0,81,24.8,96,3,4.2,163,False,1,23,139,1,0,2024-01-02,False,False,False,0.852760736196319,0.1411042944785276,0.006134969325153374,0.0,Off-Peak,Tuesday,January
2024-01-02 02:00:00,29,312,1,0,342,6,27,0,0,33,24.6,95,3,4.6,375,False,2,35,339,1,0,2024-01-02,False,False,False,0.904,0.09333333333333334,0.0026666666666666666,0.0,Off-Peak,Tuesday,January
2024-01-02 03:00:00,42,439,1,0,482,13,54,0,0,67,24.7,95,3,8.2,549,False,3,55,493,1,0,2024-01-02,False,False,False,0.8979963570127505,0.10018214936247723,0.0018214936247723133,0.0,Off-Peak,Tuesday,January
2024-01-02 04:00:00,33,351,1,0,385,29,114,0,0,143,24.5,96,3,9.2,528,False,4,62,465,1,0,2024-01-02,False,False,False,0.8806818181818182,0.11742424242424243,0.001893939393939394,0.0,Off-Peak,Tuesday,January
2024-01-02 05:00:00,9,104,1,0,114,23,95,0,0,118,24.4,96,3,8.7,232,False,5,32,199,1,0,2024-01-02,False,False,False,0.8577586206896551,0.13793103448275862,0.004310344827586207,0.0,Shoulder,Tuesday,January
2024-01-02 06:00:00,43,458,2,0,503,14,61,0,0,75,24.2,96,3,9.3,578,False,6,57,519,2,0,2024-01-02,False,False,False,0.8979238754325259,0.0986159169550173,0.0034602076124567475,0.0,Shoulder,Tuesday,January
2024-01-02 07:00:00,20,212,1,0,233,11,46,0,0,57,24.2,95,3,8.9,290,False,7,31,258,1,0,2024-01-02,False,False,False,0.8896551724137931,0.10689655172413794,0.0034482758620689655,0.0,Peak,Tuesday,January
2024-01-02 08:00:00,15,154,1,0,170,22,90,0,0,112,24.6,93,3,10.7,282,False,8,37,244,1,0,2024-01-02,False,False,False,0.8652482269503546,0.13120567375886524,0.0035460992907801418,0.0,Peak,Tuesday,January
2024-01-02 09:00:00,10,118,1,0,129,10,41,0,0,51,25.4,94,53,9.2,180,False,9,20,159,1,0,2024-01-02,False,False,False,0.8833333333333333,0.1111111111111111,0.005555555555555556,0.0,Shoulder,Tuesday,January
2024-01-02 10:00:00,45,482,1,0,528,13,51,0,0,64,26.9,89,51,11.0,592,False,10,58,533,1,0,2024-01-02,False,False,False,0.9003378378378378,0.09797297297297297,0.0016891891891891893,0.0,Shoulder,Tuesday,January
2024-01-02 11:00:00,31,318,1,0,350,27,102,0,0,129,27.6,83,53,10.0,479,False,11,58,420,1,0,2024-01-02,False,False,False,0.8768267223382046,0.12108559498956159,0.0020876826722338203,0.0,Peak,Tuesday,January
2024-01-02 12:00:00,23,246,1,0,270,27,105,1,0,133,28.5,77,3,10.0,403,False,12,50,351,2,0,2024-01-02,False,False,False,0.8709677419354839,0.12406947890818859,0.004962779156327543,0.0,Peak,Tuesday,January
2024-01-02 13:00:00,43,453,1,0,497,7,30,1,0,38,29.3,72,3,11.2,535,False,13,50,483,2,0,2024-01-02,False,False,False,0.902803738317757,0.09345794392523364,0.003738317757009346,0.0,Peak,Tuesday,January
2024-01-02 14:00:00,31,316,1,0,348,6,26,1,0,33,29.7,72,3,11.7,381,False,14,37,342,2,0,2024-01-02,False,False,False,0.8976377952755905,0.09711286089238845,0.005249343832020997,0.0,Peak,Tuesday,January
2024-01-02 15:00:00,22,227,1,0,250,32,121,1,0,154,30.1,67,3,10.3,404,False,15,54,348,2,0,2024-01-02,False,False,False,0.8613861386138614,0.13366336633663367,0.0049504950495049506,0.0,Peak,Tuesday,January
2024-01-02 16:00:00,17,177,1,0,195,25,96,1,0,122,29.1,71,51,11.8,317,False,16,42,273,2,0,2024-01-02,False,False,False,0.861198738170347,0.13249211356466878,0.006309148264984227,0.0,Peak,Tuesday,January
2024-01-02 17:00:00,7,80,1,0,88,27,102,1,0,130,29.0,74,51,15.1,218,False,17,34,182,2,0,2024-01-02,False,False,False,0.8348623853211009,0.1559633027522936,0.009174311926605505,0.0,Peak,Tuesday,January
2024-01-02 18:00:00,37,391,1,0,429,11,43,1,0,55,28.0,79,3,15.4,484,False,18,48,434,2,0,2024-01-02,False,False,False,0.8966942148760331,0.09917355371900827,0.004132231404958678,0.0,Peak,Tuesday,January
2024-01-02 19:00:00,8,88,2,0,98,26,106,1,0,133,27.3,82,3,12.7,231,False,19,34,194,3,0,2024-01-02,False,False,False,0.8398268398268398,0.1471861471861472,0.012987012987012988,0.0,Peak,Tuesday,January
2024-01-02 20:00:00,32,324,1,0,357,24,91,1,0,116,26.7,83,3,11.6,473,False,20,56,415,2,0,2024-01-02,False,False,False,0.8773784355179705,0.11839323467230443,0.004228329809725159,0.0,Shoulder,Tuesday,January
2024-01-02 21:00:00,39,399,2,0,440,17,68,1,0,86,26.5,86,51,9.2,526,False,21,56,467,3,0,2024-01-02,False,False,False,0.8878326996197718,0.10646387832699619,0.005703422053231939,0.0,Shoulder,Tuesday,January
2024-01-02 22:00:00,19,187,2,0,208,11,44,1,0,56,26.3,89,51,9.7,264,False,22,30,231,3,0,2024-01-02,False,False,False,0.875,0.11363636363636363,0.011363636363636364,0.0,Shoulder,Tuesday,January
2024-01-02 23:00:00,42,412,2,0,456,10,37,1,0,48,26.2,88,3,11.0,504,False,23,52,449,3,0,2024-01-02,False,False,False,0.8908730158730159,0.10317460317460317,0.005952380952380952,0.0,Shoulder,Tuesday,January
2024-01-03 00:00:00,131,565,2,0,698,17,32,2,0,51,25.9,88,3,10.6,749,False,0,148,597,4,0,2024-01-03,False,False,False,0.7970627503337784,0.19759679572763686,0.0053404539385847796,0.0,Off-Peak,Wednesday,January
2024-01-03 01:00:00,85,378,2,0,465,100,175,5,0,280,25.6,90,3,14.3,745,False,1,185,553,7,0,2024-01-03,False,False,False,0.7422818791946308,0.2483221476510067,0.009395973154362415,0.0,Off-Peak,Wednesday,January
2024-01-03 02:00:00,96,420,2,0,518,33,58,4,0,95,25.3,91,3,14.4,613,False,2,129,478,6,0,2024-01-03,False,False,False,0.7797716150081566,0.21044045676998369,0.009787928221859706,0.0,Off-Peak,Wednesday,January
2024-01-03 03:00:00,30,150,2,0,182,97,166,3,0,266,25.1,91,3,12.9,448,False,3,127,316,5,0,2024-01-03,False,False,False,0.7053571428571429,0.28348214285714285,0.011160714285714286,0.0,Off-Peak,Wednesday,January
2024-01-03 04:00:00,106,446,2,0,554,115,200,4,0,319,25.1,91,3,12.3,873,False,4,221,646,6,0,2024-01-03,False,False,False,0.7399770904925544,0.2531500572737686,0.006872852233676976,0.0,Off-Peak,Wednesday,January
2024-01-03 05:00:00,33,161,2,0,196,60,107,3,0,170,24.7,93,3,11.3,366,False,5,93,268,5,0,2024-01-03,False,False,False,0.73224043715847,0.2540983606557377,0.01366120218579235,0.0,Shoulder,Wednesday,January
2024-01-03 06:00:00,27,109,2,0,138,53,93,3,0,149,24.5,94,3,9.7,287,False,6,80,202,5,0,2024-01-03,False,False,False,0.7038327526132404,0.2787456445993031,0.017421602787456445,0.0,Shoulder,Wednesday,January
2024-01-03 07:00:00,55,246,2,0,303,62,105,4,0,171,24.2,96,3,5.4,474,False,7,117,351,6,0,2024-01-03,False,False,False,0.740506329113924,0.2468354430379747,0.012658227848101266,0.0,Peak,Wednesday,January
2024-01-03 08:00:00,27,130,2,0,159,56,96,3,0,155,24.8,94,3,8.4,314,False,8,83,226,5,0,2024-01-03,False,False,False,0.7197452229299363,0.2643312101910828,0.01592356687898089,0.0,Peak,Wednesday,January
2024-01-03 09:00:00,115,509,2,0,626,26,45,3,0,74,26.2,87,53,13.1,700,False,9,141,554,5,0,2024-01-03,False,False,False,0.7914285714285715,0.20142857142857143,0.007142857142857143,0.0,Shoulder,Wednesday,January
2024-01-03 10:00:00,45,201,2,0,248,101,173,3,0,277,27.4,85,51,8.4,525,False,10,146,374,5,0,2024-01-03,False,False,False,0.7123809523809523,0.2780952380952381,0.009523809523809525,0.0,Shoulder,Wednesday,January
2024-01-03 11:00:00,40,195,2,0,237,88,150,3,0,241,28.2,78,51,12.1,478,False,11,128,345,5,0,2024-01-03,False,False,False,0.7217573221757322,0.26778242677824265,0.010460251046025104,0.0,Peak,Wednesday,January
2024-01-03 12:00:00,97,421,2,0,520,31,56,4,0,91,28.5,77,53,11.1,611,False,12,128,477,6,0,2024-01-03,False,False,False,0.7806873977086743,0.20949263502454993,0.009819967266775777,0.0,Peak,Wednesday,January
2024-01-03 13:00:00,109,475,3,0,587,105,179,3,0,287,29.8,70,51,10.0,874,False,13,214,654,6,0,2024-01-03,False,False,False,0.7482837528604119,0.2448512585812357,0.006864988558352402,0.0,Peak,Wednesday,January
2024-01-03 14:00:00,63,291,3,0,357,83,144,3,0,230,30.3,66,3,7.6,587,False,14,146,435,6,0,2024-01-03,False,False,False,0.7410562180579217,0.24872231686541738,0.010221465076660987,0.0,Peak,Wednesday,January
2024-01-03 15:00:00,47,212,4,0,263,21,38,3,0,62,30.5,63,3,6.9,325,False,15,68,250,7,0,2024-01-03,False,False,False,0.7692307692307693,0.20923076923076922,0.021538461538461538,0.0,Peak,Wednesday,January
2024-01-03 16:00:00,28,137,3,0,168,99,168,3,0,270,29.9,66,51,8.1,438,False,16,127,305,6,0,2024-01-03,False,False,False,0.6963470319634704,0.2899543378995434,0.0136986301369863,0.0,Peak,Wednesday,January
2024-01-03 17:00:00,78,340,3,0,421,88,155,4,0,247,28.8,76,51,10.5,668,False,17,166,495,7,0,2024-01-03,False,False,False,0.7410179640718563,0.24850299401197604,0.010479041916167664,0.0,Peak,Wednesday,January
2024-01-03 18:00:00,153,661,3,0,817,69,122,4,0,195,27.5,82,3,11.6,1012,False,18,222,783,7,0,2024-01-03,False,False,False,0.7737154150197628,0.21936758893280633,0.00691699604743083,0.0,Peak,Wednesday,January
2024-01-03 19:00:00,42,205,3,0,250,101,170,4,0,275,27.0,86,3,10.6,525,False,19,143,375,7,0,2024-01-03,False,False,False,0.7142857142857143,0.2723809523809524,0.013333333333333334,0.0,Peak,Wednesday,January
2024-01-03 20:00:00,121,520,3,0,644,22,42,3,0,67,26.6,88,3,8.7,711,False,20,143,562,6,0,2024-01-03,False,False,False,0.790436005625879,0.2011251758087201,0.008438818565400843,0.0,Shoulder,Wednesday,January
2024-01-03 21:00:00,163,694,3,0,860,69,117,4,0,190,26.1,90,55,5.4,1050,False,21,232,811,7,0,2024-01-03,False,False,False,0.7723809523809524,0.22095238095238096,0.006666666666666667,0.0,Shoulder,Wednesday,January
2024-01-03 22:00:00,105,450,4,0,559,35,63,3,0,101,25.0,96,65,3.4,660,False,22,140,513,7,0,2024-01-03,False,False,False,0.7772727272727272,0.21212121212121213,0.010606060606060607,0.0,Shoulder,Wednesday,January
2024-01-03 23:00:00,73,309,3,0,385,52,89,4,0,145,24.9,96,53,3.8,530,False,23,125,398,7,0,2024-01-03,False,False,False,0.7509433962264151,0.2358490566037736,0.013207547169811321,0.0,Shoulder,Wednesday,January
2024-01-04 00:00:00,69,282,3,0,354,82,134,4,0,220,25.1,96,51,3.1,574,False,0,151,416,7,0,2024-01-04,False,False,False,0.7247386759581882,0.26306620209059234,0.012195121951219513,0.0,Off-Peak,Thursday,January
2024-01-04 01:00:00,117,467,3,0,587,36,60,3,0,99,24.9,96,53,2.9,686,False,1,153,527,6,0,2024-01-04,False,False,False,0.7682215743440233,0.2230320699708455,0.008746355685131196,0.0,Off-Peak,Thursday,January
2024-01-04 02:00:00,109,439,3,0,551,34,56,3,0,93,25.0,96,51,2.5,644,False,2,143,495,6,0,2024-01-04,False,False,False,0.7686335403726708,0.2220496894409938,0.009316770186335404,0.0,Off-Peak,Thursday,January
2024-01-04 03:00:00,94,375,3,0,472,79,128,4,0,211,24.8,96,51,6.1,683,False,3,173,503,7,0,2024-01-04,False,False,False,0.7364568081991215,0.25329428989751096,0.010248901903367497,0.0,Off-Peak,Thursday,January
2024-01-04 04:00:00,19,85,3,0,107,62,98,3,0,163,24.7,96,51,6.3,270,False,4,81,183,6,0,2024-01-04,False,False,False,0.6777777777777778,0.3,0.022222222222222223,0.0,Off-Peak,Thursday,January
2024-01-04 05:00:00,36,159,3,0,198,23,41,4,0,68,24.6,96,3,7.8,266,False,5,59,200,7,0,2024-01-04,False,False,False,0.7518796992481203,0.22180451127819548,0.02631578947368421,0.0,Shoulder,Thursday,January
2024-01-04 06:00:00,82,334,4,0,420,40,66,3,0,109,24.4,96,3,8.7,529,False,6,122,400,7,0,2024-01-04,False,False,False,0.7561436672967864,0.23062381852551986,0.013232514177693762,0.0,Shoulder,Thursday,January
2024-01-04 07:00:00,58,239,3,0,300,114,178,6,0,298,24.3,96,3,8.3,598,False,7,172,417,9,0,2024-01-04,False,False,False,0.697324414715719,0.28762541806020064,0.015050167224080268,0.0,Peak,Thursday,January
2024-01-04 08:00:00,49,207,3,0,259,73,117,4,0,194,24.6,96,3,9.3,453,False,8,122,324,7,0,2024-01-04,False,False,False,0.7152317880794702,0.2693156732891832,0.01545253863134658,0.0,Peak,Thursday,January
2024-01-04 09:00:00,116,459,3,0,578,22,38,5,0,65,25.5,91,3,7.9,643,False,9,138,497,8,0,2024-01-04,False,False,False,0.7729393468118196,0.21461897356143078,0.012441679626749611,0.0,Shoulder,Thursday,January
2024-01-04 10:00:00,48,191,3,0,242,39,65,3,0,107,26.5,87,3,6.4,349,False,10,87,256,6,0,2024-01-04,False,False,False,0.7335243553008596,0.2492836676217765,0.017191977077363897,0.0,Shoulder,Thursday,January
2024-01-04 11:00:00,135,522,4,0,661,60,95,6,0,161,28.4,78,3,11.6,822,False,11,195,617,10,0,2024-01-04,False,False,False,0.7506082725060828,0.23722627737226276,0.012165450121654502,0.0,Peak,Thursday,January
2024-01-04 12:00:00,126,506,5,0,637,56,92,4,0,152,29.7,72,3,14.1,789,False,12,182,598,9,0,2024-01-04,False,False,False,0.7579214195183777,0.23067173637515842,0.011406844106463879,0.0,Peak,Thursday,January
2024-01-04 13:00:00,38,151,3,0,192,35,63,4,0,102,30.0,69,3,14.4,294,False,13,73,214,7,0,2024-01-04,False,False,False,0.7278911564625851,0.24829931972789115,0.023809523809523808,0.0,Peak,Thursday,January
2024-01-04 14:00:00,77,311,3,0,391,57,92,4,0,153,30.7,67,3,13.4,544,False,14,134,403,7,0,2024-01-04,False,False,False,0.7408088235294118,0.24632352941176472,0.012867647058823529,0.0,Peak,Thursday,January
2024-01-04 15:00:00,57,229,3,0,289,34,57,4,0,95,28.5,78,61,14.0,384,False,15,91,286,7,0,2024-01-04,False,False,False,0.7447916666666666,0.23697916666666666,0.018229166666666668,0.0,Peak,Thursday,January
2024-01-04 16:00:00,91,355,5,0,451,38,63,4,0,105,27.6,81,61,14.8,556,False,16,129,418,9,0,2024-01-04,False,False,False,0.7517985611510791,0.23201438848920863,0.01618705035971223,0.0,Peak,Thursday,January
2024-01-04 17:00:00,91,367,4,0,462,93,152,5,0,250,26.6,84,63,11.2,712,False,17,184,519,9,0,2024-01-04,False,False,False,0.7289325842696629,0.25842696629213485,0.012640449438202247,0.0,Peak,Thursday,January
2024-01-04 18:00:00,140,557,4,0,701,26,45,4,0,75,25.8,89,53,12.8,776,False,18,166,602,8,0,2024-01-04,False,False,False,0.7757731958762887,0.21391752577319587,0.010309278350515464,0.0,Peak,Thursday,January
2024-01-04 19:00:00,108,424,4,0,536,41,68,5,0,114,25.2,91,3,12.8,650,False,19,149,492,9,0,2024-01-04,False,False,False,0.7569230769230769,0.22923076923076924,0.013846153846153847,0.0,Peak,Thursday,January
2024-01-04 20:00:00,94,371,4,0,469,30,52,5,0,87,25.0,92,3,12.4,556,False,20,124,423,9,0,2024-01-04,False,False,False,0.7607913669064749,0.22302158273381295,0.01618705035971223,0.0,Shoulder,Thursday,January
2024-01-04 21:00:00,92,366,4,0,462,193,304,6,0,503,24.8,92,3,12.2,965,False,21,285,670,10,0,2024-01-04,False,False,False,0.694300518134715,0.29533678756476683,0.010362694300518135,0.0,Shoulder,Thursday,January
2024-01-04 22:00:00,63,257,5,0,325,107,169,8,0,284,24.7,92,3,11.3,609,False,22,170,426,13,0,2024-01-04,False,False,False,0.6995073891625616,0.2791461412151067,0.021346469622331693,0.0,Shoulder,Thursday,January
2024-01-04 23:00:00,19,81,6,0,106,60,100,6,0,166,24.8,93,51,13.3,272,False,23,79,181,12,0,2024-01-04,False,False,False,0.6654411764705882,0.29044117647058826,0.04411764705882353,0.0,Shoulder,Thursday,January
2024-01-05 00:00:00,84,355,3,0,442,71,135,3,0,209,24.9,94,51,13.6,651,False,0,155,490,6,0,2024-01-05,False,False,False,0.7526881720430108,0.23809523809523808,0.009216589861751152,0.0,Off-Peak,Friday,January
2024-01-05 01:00:00,99,413,4,0,516,78,145,3,0,226,24.8,94,51,15.2,742,False,1,177,558,7,0,2024-01-05,False,False,False,0.7520215633423181,0.238544474393531,0.009433962264150943,0.0,Off-Peak,Friday,January
2024-01-05 02:00:00,51,216,4,0,271,103,190,3,0,296,24.7,93,51,15.9,567,False,2,154,406,7,0,2024-01-05,False,False,False,0.7160493827160493,0.2716049382716049,0.012345679012345678,0.0,Off-Peak,Friday,January
2024-01-05 03:00:00,110,459,3,0,572,53,100,4,0,157,24.6,93,51,17.3,729,False,3,163,559,7,0,2024-01-05,False,False,False,0.766803840877915,0.22359396433470508,0.009602194787379973,0.0,Off-Peak,Friday,January
2024-01-05 04:00:00,102,413,3,0,518,52,97,3,0,152,24.4,93,51,14.6,670,False,4,154,510,6,0,2024-01-05,False,False,False,0.7611940298507462,0.2298507462686567,0.008955223880597015,0.0,Off-Peak,Friday,January
2024-01-05 05:00:00,34,142,3,0,179,72,136,3,0,211,24.2,94,3,13.4,390,False,5,106,278,6,0,2024-01-05,False,False,False,0.7128205128205128,0.2717948717948718,0.015384615384615385,0.0,Shoulder,Friday,January
2024-01-05 06:00:00,63,252,3,0,318,79,148,3,0,230,23.9,96,3,13.9,548,False,6,142,400,6,0,2024-01-05,False,False,False,0.7299270072992701,0.2591240875912409,0.010948905109489052,0.0,Shoulder,Friday,January
2024-01-05 07:00:00,91,380,3,0,474,19,33,3,0,55,23.8,96,2,13.2,529,False,7,110,413,6,0,2024-01-05,False,False,False,0.780718336483932,0.20793950850661624,0.011342155009451797,0.0,Peak,Friday,January
2024-01-05 08:00:00,35,157,3,0,195,80,149,4,0,233,24.2,95,1,13.1,428,False,8,115,306,7,0,2024-01-05,False,False,False,0.7149532710280374,0.26869158878504673,0.016355140186915886,0.0,Peak,Friday,January
2024-01-05 09:00:00,20,100,3,0,123,18,36,3,0,57,25.3,90,51,11.2,180,False,9,38,136,6,0,2024-01-05,False,False,False,0.7555555555555555,0.2111111111111111,0.03333333333333333,0.0,Shoulder,Friday,January
2024-01-05 10:00:00,113,465,3,0,581,110,201,3,0,314,26.0,88,51,11.6,895,False,10,223,666,6,0,2024-01-05,False,False,False,0.7441340782122905,0.24916201117318434,0.0067039106145251395,0.0,Shoulder,Friday,January
2024-01-05 11:00:00,99,407,3,0,509,107,199,4,0,310,27.2,81,51,14.7,819,False,11,206,606,7,0,2024-01-05,False,False,False,0.73992673992674,0.2515262515262515,0.008547008547008548,0.0,Peak,Friday,January
2024-01-05 12:00:00,136,552,4,0,692,41,79,3,0,123,27.4,81,51,15.5,815,False,12,177,631,7,0,2024-01-05,False,False,False,0.7742331288343558,0.21717791411042944,0.008588957055214725,0.0,Peak,Friday,January
2024-01-05 13:00:00,110,445,4,0,559,101,182,4,0,287,28.6,74,3,16.3,846,False,13,211,627,8,0,2024-01-05,False,False,False,0.7411347517730497,0.24940898345153664,0.009456264775413711,0.0,Peak,Friday,January
2024-01-05 14:00:00,39,161,4,0,204,50,98,4,0,152,30.1,69,3,15.6,356,False,14,89,259,8,0,2024-01-05,False,False,False,0.7275280898876404,0.25,0.02247191011235955,0.0,Peak,Friday,January
2024-01-05 15:00:00,34,154,3,0,191,92,163,3,0,258,30.2,70,51,13.2,449,False,15,126,317,6,0,2024-01-05,False,False,False,0.7060133630289532,0.2806236080178174,0.013363028953229399,0.0,Peak,Friday,January
2024-01-05 16:00:00,86,353,4,0,443,39,74,3,0,116,28.5,75,51,12.6,559,False,16,125,427,7,0,2024-01-05,False,False,False,0.7638640429338104,0.22361359570661896,0.012522361359570662,0.0,Peak,Friday,January
2024-01-05 17:00:00,146,581,4,0,731,44,77,4,0,125,27.2,83,55,5.7,856,False,17,190,658,8,0,2024-01-05,False,False,False,0.7686915887850467,0.2219626168224299,0.009345794392523364,0.0,Peak,Friday,January
2024-01-05 18:00:00,77,325,4,0,406,113,205,4,0,322,27.4,83,3,10.9,728,False,18,190,530,8,0,2024-01-05,False,False,False,0.728021978021978,0.260989010989011,0.01098901098901099,0.0,Peak,Friday,January
2024-01-05 19:00:00,43,181,3,0,227,28,52,3,0,83,27.0,82,3,10.4,310,False,19,71,233,6,0,2024-01-05,False,False,False,0.7516129032258064,0.22903225806451613,0.01935483870967742,0.0,Peak,Friday,January
2024-01-05 20:00:00,119,488,4,0,611,34,62,3,0,99,26.5,84,3,10.7,710,False,20,153,550,7,0,2024-01-05,False,False,False,0.7746478873239436,0.21549295774647886,0.009859154929577466,0.0,Shoulder,Friday,January
2024-01-05 21:00:00,116,480,4,0,600,44,81,3,0,128,26.1,84,3,14.0,728,False,21,160,561,7,0,2024-01-05,False,False,False,0.7706043956043956,0.21978021978021978,0.009615384615384616,0.0,Shoulder,Friday,January
2024-01-05 22:00:00,80,323,5,0,408,65,117,4,0,186,25.8,85,3,10.3,594,False,22,145,440,9,0,2024-01-05,False,False,False,0.7407407407407407,0.2441077441077441,0.015151515151515152,0.0,Shoulder,Friday,January
2024-01-05 23:00:00,12,51,4,0,67,81,150,5,0,236,25.6,85,3,10.9,303,False,23,93,201,9,0,2024-01-05,False,False,False,0.6633663366336634,0.3069306930693069,0.0297029702970297,0.0,Shoulder,Friday,January
2024-01-06 00:00:00,27,135,3,0,165,59,77,2,0,138,25.2,87,2,13.2,303,True,0,86,212,5,0,2024-01-06,False,False,False,0.6996699669966997,0.2838283828382838,0.0165016501650165,0.0,Off-Peak,Saturday,January
2024-01-06 01:00:00,82,390,4,0,476,157,193,3,0,353,25.1,87,3,12.6,829,True,1,239,583,7,0,2024-01-06,False,False,False,0.7032569360675512,0.2882991556091677,0.008443908323281062,0.0,Off-Peak,Saturday,January
2024-01-06 02:00:00,36,165,3,0,204,122,153,3,0,278,24.8,89,3,12.1,482,True,2,158,318,6,0,2024-01-06,False,False,False,0.6597510373443983,0.3278008298755187,0.012448132780082987,0.0,Off-Peak,Saturday,January
2024-01-06 03:00:00,98,465,4,0,567,97,122,4,0,223,24.9,88,3,11.3,790,True,3,195,587,8,0,2024-01-06,False,False,False,0.7430379746835443,0.2468354430379747,0.010126582278481013,0.0,Off-Peak,Saturday,January
2024-01-06 04:00:00,76,353,5,0,434,112,138,3,0,253,24.7,89,1,11.1,687,True,4,188,491,8,0,2024-01-06,False,False,False,0.7147016011644832,0.27365356622998543,0.011644832605531296,0.0,Off-Peak,Saturday,January
2024-01-06 05:00:00,44,209,3,0,256,69,88,3,0,160,24.3,91,3,8.8,416,True,5,113,297,6,0,2024-01-06,False,False,False,0.7139423076923077,0.27163461538461536,0.014423076923076924,0.0,Shoulder,Saturday,January
2024-01-06 06:00:00,26,132,4,0,162,75,94,3,0,172,24.1,92,1,10.6,334,True,6,101,226,7,0,2024-01-06,False,False,False,0.6766467065868264,0.3023952095808383,0.020958083832335328,0.0,Shoulder,Saturday,January
2024-01-06 07:00:00,120,562,5,1,688,24,32,5,1,62,24.2,92,2,10.5,750,True,7,144,594,10,2,2024-01-06,False,False,False,0.792,0.192,0.013333333333333334,0.0026666666666666666,Peak,Saturday,January
2024-01-06 08:00:00,43,214,3,0,260,65,84,3,0,152,24.3,92,3,11.2,412,True,8,108,298,6,0,2024-01-06,False,False,False,0.7233009708737864,0.2621359223300971,0.014563106796116505,0.0,Peak,Saturday,January
2024-01-06 09:00:00,72,341,4,0,417,152,187,3,0,342,25.8,88,3,13.1,759,True,9,224,528,7,0,2024-01-06,False,False,False,0.6956521739130435,0.2951251646903821,0.00922266139657444,0.0,Shoulder,Saturday,January
2024-01-06 10:00:00,96,451,4,0,551,107,132,3,0,242,26.1,86,51,14.4,793,True,10,203,583,7,0,2024-01-06,False,False,False,0.7351828499369483,0.25598991172761665,0.008827238335435058,0.0,Shoulder,Saturday,January
2024-01-06 11:00:00,40,197,3,0,240,40,51,3,0,94,25.4,93,63,10.4,334,True,11,80,248,6,0,2024-01-06,False,False,False,0.7425149700598802,0.23952095808383234,0.017964071856287425,0.0,Peak,Saturday,January
2024-01-06 12:00:00,77,365,4,0,446,109,137,3,0,249,25.6,91,61,10.8,695,True,12,186,502,7,0,2024-01-06,False,False,False,0.7223021582733813,0.26762589928057556,0.010071942446043165,0.0,Peak,Saturday,January
2024-01-06 13:00:00,22,115,3,0,140,37,50,3,0,90,26.5,88,55,4.6,230,True,13,59,165,6,0,2024-01-06,False,False,False,0.717391304347826,0.2565217391304348,0.02608695652173913,0.0,Peak,Saturday,January
2024-01-06 14:00:00,87,417,5,0,509,82,102,4,0,188,28.0,86,51,10.1,697,True,14,169,519,9,0,2024-01-06,False,False,False,0.7446197991391679,0.242467718794835,0.01291248206599713,0.0,Peak,Saturday,January
2024-01-06 15:00:00,110,519,5,0,634,144,179,3,0,326,26.2,87,63,10.4,960,True,15,254,698,8,0,2024-01-06,False,False,False,0.7270833333333333,0.26458333333333334,0.008333333333333333,0.0,Peak,Saturday,January
2024-01-06 16:00:00,77,364,5,0,446,84,105,3,0,192,27.3,84,51,3.7,638,True,16,161,469,8,0,2024-01-06,False,False,False,0.7351097178683386,0.25235109717868337,0.012539184952978056,0.0,Peak,Saturday,January
2024-01-06 17:00:00,58,275,4,0,337,50,63,4,0,117,25.8,94,65,9.0,454,True,17,108,338,8,0,2024-01-06,False,False,False,0.7444933920704846,0.23788546255506607,0.01762114537444934,0.0,Peak,Saturday,January
2024-01-06 18:00:00,48,221,4,0,273,112,141,3,0,256,25.7,91,63,9.3,529,True,18,160,362,7,0,2024-01-06,False,False,False,0.6843100189035917,0.30245746691871456,0.013232514177693762,0.0,Peak,Saturday,January
2024-01-06 19:00:00,81,374,5,0,460,31,42,3,0,76,25.5,92,51,9.1,536,True,19,112,416,8,0,2024-01-06,False,False,False,0.7761194029850746,0.208955223880597,0.014925373134328358,0.0,Peak,Saturday,January
2024-01-06 20:00:00,107,497,6,0,610,69,87,3,0,159,25.0,94,53,8.5,769,True,20,176,584,9,0,2024-01-06,False,False,False,0.7594278283485045,0.22886866059817945,0.011703511053315995,0.0,Shoulder,Saturday,January
2024-01-06 21:00:00,78,369,5,0,452,110,136,3,0,249,25.2,93,3,11.3,701,True,21,188,505,8,0,2024-01-06,False,False,False,0.7203994293865906,0.268188302425107,0.011412268188302425,0.0,Shoulder,Saturday,January
2024-01-06 22:00:00,51,236,6,1,294,92,118,3,0,213,25.1,93,3,8.9,507,True,22,143,354,9,1,2024-01-06,False,False,False,0.6982248520710059,0.28205128205128205,0.01775147928994083,0.0019723865877712033,Shoulder,Saturday,January
2024-01-06 23:00:00,70,315,8,1,394,235,285,5,1,526,24.9,95,3,7.6,920,True,23,305,600,13,2,2024-01-06,False,False,False,0.6521739130434783,0.33152173913043476,0.014130434782608696,0.002173913043478261,Shoulder,Saturday,January
2024-01-07 00:00:00,26,130,2,0,158,157,235,4,0,396,24.9,95,3,7.2,554,True,0,183,365,6,0,2024-01-07,False,False,False,0.6588447653429603,0.3303249097472924,0.010830324909747292,0.0,Off-Peak,Sunday,January
2024-01-07 01:00:00,64,284,3,0,351,62,99,3,0,164,24.7,96,3,8.3,515,True,1,126,383,6,0,2024-01-07,False,False,False,0.7436893203883496,0.2446601941747573,0.011650485436893204,0.0,Off-Peak,Sunday,January
2024-01-07 02:00:00,79,356,3,0,438,130,198,3,0,331,24.3,97,3,4.8,769,True,2,209,554,6,0,2024-01-07,False,False,False,0.7204161248374512,0.2717815344603381,0.007802340702210663,0.0,Off-Peak,Sunday,January
2024-01-07 03:00:00,40,190,3,0,233,130,201,4,0,335,24.1,97,3,8.6,568,True,3,170,391,7,0,2024-01-07,False,False,False,0.6883802816901409,0.2992957746478873,0.01232394366197183,0.0,Off-Peak,Sunday,January
2024-01-07 04:00:00,145,635,3,0,783,100,151,3,0,254,23.8,96,53,6.6,1037,True,4,245,786,6,0,2024-01-07,False,False,False,0.7579556412729026,0.23625843780135006,0.0057859209257473485,0.0,Off-Peak,Sunday,January
2024-01-07 05:00:00,23,115,4,0,142,104,165,5,1,275,23.6,96,53,5.7,417,True,5,127,280,9,1,2024-01-07,False,False,False,0.6714628297362111,0.30455635491606714,0.02158273381294964,0.002398081534772182,Shoulder,Sunday,January
2024-01-07 06:00:00,25,131,3,0,159,54,84,4,0,142,23.5,97,61,9.6,301,True,6,79,215,7,0,2024-01-07,False,False,False,0.7142857142857143,0.26245847176079734,0.023255813953488372,0.0,Shoulder,Sunday,January
2024-01-07 07:00:00,59,264,3,0,326,50,80,3,0,133,23.4,96,61,2.6,459,True,7,109,344,6,0,2024-01-07,False,False,False,0.7494553376906318,0.2374727668845316,0.013071895424836602,0.0,Peak,Sunday,January
2024-01-07 08:00:00,83,373,3,0,459,97,145,3,0,245,23.4,98,61,11.5,704,True,8,180,518,6,0,2024-01-07,False,False,False,0.7357954545454546,0.2556818181818182,0.008522727272727272,0.0,Peak,Sunday,January
2024-01-07 09:00:00,62,281,4,0,347,44,70,3,0,117,25.0,94,51,4.6,464,True,9,106,351,7,0,2024-01-07,False,False,False,0.7564655172413793,0.22844827586206898,0.015086206896551725,0.0,Shoulder,Sunday,January
2024-01-07 10:00:00,60,275,4,1,340,106,160,3,0,269,25.4,93,53,2.0,609,True,10,166,435,7,1,2024-01-07,False,False,False,0.7142857142857143,0.27257799671592775,0.011494252873563218,0.0016420361247947454,Shoulder,Sunday,January
2024-01-07 11:00:00,46,214,3,0,263,125,193,4,0,322,25.6,91,53,4.4,585,True,11,171,407,7,0,2024-01-07,False,False,False,0.6957264957264957,0.2923076923076923,0.011965811965811967,0.0,Peak,Sunday,January
2024-01-07 12:00:00,93,414,3,0,510,73,109,4,0,186,25.6,90,55,5.8,696,True,12,166,523,7,0,2024-01-07,False,False,False,0.7514367816091954,0.23850574712643677,0.010057471264367816,0.0,Peak,Sunday,January
2024-01-07 13:00:00,35,164,3,0,202,159,238,4,0,401,25.4,91,61,9.5,603,True,13,194,402,7,0,2024-01-07,False,False,False,0.6666666666666666,0.32172470978441126,0.011608623548922056,0.0,Peak,Sunday,January
2024-01-07 14:00:00,81,368,3,0,452,133,203,4,0,340,25.2,93,63,10.8,792,True,14,214,571,7,0,2024-01-07,False,False,False,0.7209595959595959,0.2702020202020202,0.008838383838383838,0.0,Peak,Sunday,January
2024-01-07 15:00:00,46,215,4,0,265,166,251,5,0,422,25.7,91,61,12.4,687,True,15,212,466,9,0,2024-01-07,False,False,False,0.6783114992721979,0.30858806404657935,0.013100436681222707,0.0,Peak,Sunday,January
2024-01-07 16:00:00,188,825,4,0,1017,113,171,4,0,288,26.3,88,53,12.4,1305,True,16,301,996,8,0,2024-01-07,False,False,False,0.7632183908045977,0.23065134099616857,0.006130268199233717,0.0,Peak,Sunday,January
2024-01-07 17:00:00,116,513,4,0,633,69,108,4,0,181,27.0,85,51,12.1,814,True,17,185,621,8,0,2024-01-07,False,False,False,0.7628992628992629,0.22727272727272727,0.009828009828009828,0.0,Peak,Sunday,January
2024-01-07 18:00:00,60,279,3,0,342,67,103,4,0,174,26.7,86,3,11.5,516,True,18,127,382,7,0,2024-01-07,False,False,False,0.7403100775193798,0.24612403100775193,0.013565891472868217,0.0,Peak,Sunday,January
2024-01-07 19:00:00,45,212,3,1,261,36,59,4,0,99,26.1,87,51,12.3,360,True,19,81,271,7,1,2024-01-07,False,False,False,0.7527777777777778,0.225,0.019444444444444445,0.002777777777777778,Peak,Sunday,January
2024-01-07 20:00:00,129,566,4,1,700,71,112,5,1,189,25.3,89,51,12.2,889,True,20,200,678,9,2,2024-01-07,False,False,False,0.7626546681664792,0.2249718785151856,0.010123734533183352,0.0022497187851518562,Shoulder,Sunday,January
2024-01-07 21:00:00,28,139,3,1,171,65,105,5,1,176,24.5,94,51,9.2,347,True,21,93,244,8,2,2024-01-07,False,False,False,0.7031700288184438,0.2680115273775216,0.023054755043227664,0.005763688760806916,Shoulder,Sunday,January
2024-01-07 22:00:00,73,331,4,1,409,46,71,5,1,123,24.3,95,51,9.2,532,True,22,119,402,9,2,2024-01-07,False,False,False,0.7556390977443609,0.2236842105263158,0.016917293233082706,0.0037593984962406013,Shoulder,Sunday,January
2024-01-07 23:00:00,279,1175,6,1,1461,68,103,5,1,177,24.0,96,51,9.9,1638,True,23,347,1278,11,2,2024-01-07,False,False,True,0.7802197802197802,0.21184371184371184,0.006715506715506716,0.001221001221001221,Shoulder,Sunday,January
2024-01-08 00:00:00,16,108,2,0,126,86,156,2,0,244,23.8,96,51,9.2,370,False,0,102,264,4,0,2024-01-08,False,False,False,0.7135135135135136,0.2756756756756757,0.010810810810810811,0.0,Off-Peak,Monday,January
2024-01-08 01:00:00,113,573,3,0,689,31,57,2,0,90,23.7,97,53,8.0,779,False,1,144,630,5,0,2024-01-08,False,False,False,0.8087291399229781,0.18485237483953787,0.006418485237483954,0.0,Off-Peak,Monday,January
2024-01-08 02:00:00,97,489,4,0,590,76,137,2,0,215,23.7,96,3,10.7,805,False,2,173,626,6,0,2024-01-08,False,False,False,0.7776397515527951,0.21490683229813665,0.007453416149068323,0.0,Off-Peak,Monday,January
2024-01-08 03:00:00,21,115,3,0,139,54,95,2,0,151,23.7,97,3,11.5,290,False,3,75,210,5,0,2024-01-08,False,False,False,0.7241379310344828,0.25862068965517243,0.017241379310344827,0.0,Off-Peak,Monday,January
2024-01-08 04:00:00,39,217,3,0,259,66,127,2,0,195,23.7,96,3,11.0,454,False,4,105,344,5,0,2024-01-08,False,False,False,0.7577092511013216,0.23127753303964757,0.011013215859030838,0.0,Off-Peak,Monday,January
2024-01-08 05:00:00,71,357,4,0,432,26,44,2,0,72,23.7,96,3,11.2,504,False,5,97,401,6,0,2024-01-08,False,False,False,0.7956349206349206,0.19246031746031747,0.011904761904761904,0.0,Shoulder,Monday,January
2024-01-08 06:00:00,43,216,3,0,262,84,154,3,0,241,23.6,96,3,10.7,503,False,6,127,370,6,0,2024-01-08,False,False,False,0.73558648111332,0.2524850894632207,0.011928429423459244,0.0,Shoulder,Monday,January
2024-01-08 07:00:00,30,151,3,0,184,99,177,2,0,278,23.6,96,3,9.7,462,False,7,129,328,5,0,2024-01-08,False,False,False,0.70995670995671,0.2792207792207792,0.010822510822510822,0.0,Peak,Monday,January
2024-01-08 08:00:00,125,613,3,0,741,39,70,2,0,111,23.9,96,3,12.0,852,False,8,164,683,5,0,2024-01-08,False,False,False,0.8016431924882629,0.19248826291079812,0.005868544600938967,0.0,Peak,Monday,January
2024-01-08 09:00:00,54,280,3,0,337,71,134,2,0,207,25.7,90,3,16.1,544,False,9,125,414,5,0,2024-01-08,False,False,False,0.7610294117647058,0.22977941176470587,0.009191176470588236,0.0,Shoulder,Monday,January
2024-01-08 10:00:00,105,528,3,0,636,38,73,2,0,113,26.6,86,3,16.3,749,False,10,143,601,5,0,2024-01-08,False,False,False,0.8024032042723631,0.1909212283044059,0.006675567423230975,0.0,Shoulder,Monday,January
2024-01-08 11:00:00,83,414,3,0,500,96,175,2,0,273,27.6,82,3,18.2,773,False,11,179,589,5,0,2024-01-08,False,False,False,0.7619663648124192,0.2315653298835705,0.00646830530401035,0.0,Peak,Monday,January
2024-01-08 12:00:00,100,500,3,0,603,89,164,2,0,255,28.3,78,3,16.8,858,False,12,189,664,5,0,2024-01-08,False,False,False,0.7738927738927739,0.2202797202797203,0.005827505827505828,0.0,Peak,Monday,January
2024-01-08 13:00:00,48,255,3,0,306,90,162,3,0,255,29.3,73,51,16.0,561,False,13,138,417,6,0,2024-01-08,False,False,False,0.7433155080213903,0.24598930481283424,0.0106951871657754,0.0,Peak,Monday,January
2024-01-08 14:00:00,113,552,3,0,668,36,66,4,0,106,30.4,69,3,16.8,774,False,14,149,618,7,0,2024-01-08,False,False,False,0.7984496124031008,0.1925064599483204,0.00904392764857881,0.0,Peak,Monday,January
2024-01-08 15:00:00,57,304,3,0,364,26,54,3,0,83,29.5,71,51,15.6,447,False,15,83,358,6,0,2024-01-08,False,False,False,0.8008948545861297,0.18568232662192394,0.013422818791946308,0.0,Peak,Monday,January
2024-01-08 16:00:00,97,484,4,0,585,76,137,3,0,216,28.4,76,53,11.4,801,False,16,173,621,7,0,2024-01-08,False,False,False,0.7752808988764045,0.21598002496878901,0.008739076154806492,0.0,Peak,Monday,January
2024-01-08 17:00:00,41,218,3,0,262,43,76,3,0,122,28.0,78,51,13.3,384,False,17,84,294,6,0,2024-01-08,False,False,False,0.765625,0.21875,0.015625,0.0,Peak,Monday,January
2024-01-08 18:00:00,42,218,3,0,263,22,45,3,0,70,27.4,83,3,9.3,333,False,18,64,263,6,0,2024-01-08,False,False,False,0.7897897897897898,0.1921921921921922,0.018018018018018018,0.0,Peak,Monday,January
2024-01-08 19:00:00,59,296,3,0,358,71,129,3,0,203,26.6,88,3,4.5,561,False,19,130,425,6,0,2024-01-08,False,False,False,0.7575757575757576,0.23172905525846701,0.0106951871657754,0.0,Peak,Monday,January
2024-01-08 20:00:00,138,679,3,0,820,77,138,4,0,219,25.9,91,3,4.2,1039,False,20,215,817,7,0,2024-01-08,False,False,False,0.7863330125120308,0.20692974013474494,0.006737247353224254,0.0,Shoulder,Monday,January
2024-01-08 21:00:00,89,449,3,0,541,44,83,3,0,130,24.9,95,63,8.3,671,False,21,133,532,6,0,2024-01-08,False,False,False,0.7928464977645305,0.19821162444113263,0.00894187779433681,0.0,Shoulder,Monday,January
2024-01-08 22:00:00,111,544,3,0,658,58,112,3,0,173,25.0,94,61,5.5,831,False,22,169,656,6,0,2024-01-08,False,False,False,0.789410348977136,0.20336943441636582,0.007220216606498195,0.0,Shoulder,Monday,January
2024-01-08 23:00:00,48,236,3,0,287,26,46,3,0,75,24.7,96,63,3.9,362,False,23,74,282,6,0,2024-01-08,False,False,False,0.7790055248618785,0.20441988950276244,0.016574585635359115,0.0,Shoulder,Monday,January
2024-01-09 00:00:00,35,190,0,0,225,71,120,0,0,191,25.1,91,51,6.8,416,False,0,106,310,0,0,2024-01-09,False,False,False,0.7451923076923077,0.2548076923076923,0.0,0.0,Off-Peak,Tuesday,January
2024-01-09 01:00:00,26,146,1,0,173,82,136,1,0,219,24.7,95,3,8.2,392,False,1,108,282,2,0,2024-01-09,False,False,False,0.7193877551020408,0.2755102040816326,0.00510204081632653,0.0,Off-Peak,Tuesday,January
2024-01-09 02:00:00,81,417,1,0,499,14,27,1,0,42,24.7,96,3,10.5,541,False,2,95,444,2,0,2024-01-09,False,False,False,0.8207024029574861,0.1756007393715342,0.0036968576709796672,0.0,Off-Peak,Tuesday,January
2024-01-09 03:00:00,75,387,1,0,463,76,127,1,0,204,24.4,97,51,11.9,667,False,3,151,514,2,0,2024-01-09,False,False,False,0.7706146926536732,0.22638680659670166,0.0029985007496251873,0.0,Off-Peak,Tuesday,January
2024-01-09 04:00:00,79,409,1,0,489,55,94,1,0,150,24.4,96,3,11.0,639,False,4,134,503,2,0,2024-01-09,False,False,False,0.7871674491392802,0.20970266040688576,0.003129890453834116,0.0,Off-Peak,Tuesday,January
2024-01-09 05:00:00,86,447,1,0,534,38,64,1,0,103,24.3,94,3,13.4,637,False,5,124,511,2,0,2024-01-09,False,False,False,0.8021978021978022,0.1946624803767661,0.0031397174254317113,0.0,Shoulder,Tuesday,January
2024-01-09 06:00:00,103,534,1,0,638,68,112,1,0,181,23.9,95,3,12.9,819,False,6,171,646,2,0,2024-01-09,False,False,False,0.7887667887667887,0.2087912087912088,0.002442002442002442,0.0,Shoulder,Tuesday,January
2024-01-09 07:00:00,61,315,1,0,377,75,125,1,0,201,23.6,96,3,12.7,578,False,7,136,440,2,0,2024-01-09,False,False,False,0.7612456747404844,0.23529411764705882,0.0034602076124567475,0.0,Peak,Tuesday,January
2024-01-09 08:00:00,32,175,1,0,208,21,37,1,0,59,23.7,96,3,12.3,267,False,8,53,212,2,0,2024-01-09,False,False,False,0.7940074906367042,0.19850187265917604,0.00749063670411985,0.0,Peak,Tuesday,January
2024-01-09 09:00:00,97,499,1,0,597,57,97,1,0,155,25.0,94,51,13.5,752,False,9,154,596,2,0,2024-01-09,False,False,False,0.7925531914893617,0.2047872340425532,0.0026595744680851063,0.0,Shoulder,Tuesday,January
2024-01-09 10:00:00,79,413,1,0,493,48,80,1,0,129,25.4,92,51,13.2,622,False,10,127,493,2,0,2024-01-09,False,False,False,0.792604501607717,0.20418006430868169,0.003215434083601286,0.0,Shoulder,Tuesday,January
2024-01-09 11:00:00,44,222,2,0,268,49,82,1,0,132,25.3,94,55,11.7,400,False,11,93,304,3,0,2024-01-09,False,False,False,0.76,0.2325,0.0075,0.0,Peak,Tuesday,January
2024-01-09 12:00:00,78,404,1,0,483,87,146,1,0,234,25.6,92,63,10.7,717,False,12,165,550,2,0,2024-01-09,False,False,False,0.7670850767085077,0.2301255230125523,0.002789400278940028,0.0,Peak,Tuesday,January
2024-01-09 13:00:00,36,192,1,0,229,34,57,2,0,93,26.1,92,63,7.5,322,False,13,70,249,3,0,2024-01-09,False,False,False,0.7732919254658385,0.21739130434782608,0.009316770186335404,0.0,Peak,Tuesday,January
2024-01-09 14:00:00,95,486,1,0,582,37,63,1,0,101,26.8,89,53,4.0,683,False,14,132,549,2,0,2024-01-09,False,False,False,0.8038067349926794,0.19326500732064422,0.0029282576866764276,0.0,Peak,Tuesday,January
2024-01-09 15:00:00,44,237,1,0,282,50,86,1,0,137,27.0,84,63,12.7,419,False,15,94,323,2,0,2024-01-09,False,False,False,0.7708830548926014,0.2243436754176611,0.00477326968973747,0.0,Peak,Tuesday,January
2024-01-09 16:00:00,90,464,2,0,556,63,105,1,0,169,26.7,83,53,13.3,725,False,16,153,569,3,0,2024-01-09,False,False,False,0.7848275862068965,0.2110344827586207,0.004137931034482759,0.0,Peak,Tuesday,January
2024-01-09 17:00:00,76,390,2,0,468,37,64,1,0,102,26.4,88,53,7.1,570,False,17,113,454,3,0,2024-01-09,False,False,False,0.7964912280701755,0.19824561403508772,0.005263157894736842,0.0,Peak,Tuesday,January
2024-01-09 18:00:00,23,121,2,0,146,19,34,1,0,54,26.5,88,51,9.7,200,False,18,42,155,3,0,2024-01-09,False,False,False,0.775,0.21,0.015,0.0,Peak,Tuesday,January
2024-01-09 19:00:00,77,398,2,0,477,77,127,1,0,205,25.8,91,51,10.5,682,False,19,154,525,3,0,2024-01-09,False,False,False,0.7697947214076246,0.22580645161290322,0.004398826979472141,0.0,Peak,Tuesday,January
2024-01-09 20:00:00,39,195,2,0,236,69,114,2,0,185,24.7,93,61,10.9,421,False,20,108,309,4,0,2024-01-09,False,False,False,0.7339667458432304,0.25653206650831356,0.009501187648456057,0.0,Shoulder,Tuesday,January
2024-01-09 21:00:00,31,157,3,0,191,69,114,2,0,185,25.5,93,3,12.6,376,False,21,100,271,5,0,2024-01-09,False,False,False,0.7207446808510638,0.26595744680851063,0.013297872340425532,0.0,Shoulder,Tuesday,January
2024-01-09 22:00:00,88,445,2,0,535,17,33,2,0,52,25.4,93,3,12.4,587,False,22,105,478,4,0,2024-01-09,False,False,False,0.8143100511073254,0.1788756388415673,0.0068143100511073255,0.0,Shoulder,Tuesday,January
2024-01-09 23:00:00,60,306,2,0,368,89,146,2,0,237,24.9,95,3,11.8,605,False,23,149,452,4,0,2024-01-09,False,False,False,0.7471074380165289,0.2462809917355372,0.006611570247933884,0.0,Shoulder,Tuesday,January
2024-01-10 00:00:00,97,458,3,0,558,83,129,3,0,215,24.8,95,3,13.4,773,False,0,180,587,6,0,2024-01-10,False,False,False,0.759379042690815,0.23285899094437257,0.007761966364812419,0.0,Off-Peak,Wednesday,January
2024-01-10 01:00:00,74,361,4,0,439,27,45,3,0,75,24.6,94,3,12.4,514,False,1,101,406,7,0,2024-01-10,False,False,False,0.7898832684824902,0.19649805447470817,0.013618677042801557,0.0,Off-Peak,Wednesday,January
2024-01-10 02:00:00,51,249,3,0,303,29,45,4,0,78,24.5,94,51,10.0,381,False,2,80,294,7,0,2024-01-10,False,False,False,0.7716535433070866,0.2099737532808399,0.01837270341207349,0.0,Off-Peak,Wednesday,January
2024-01-10 03:00:00,39,191,3,0,233,96,146,4,0,246,24.3,95,53,9.0,479,False,3,135,337,7,0,2024-01-10,False,False,False,0.7035490605427975,0.2818371607515658,0.014613778705636743,0.0,Off-Peak,Wednesday,January
2024-01-10 04:00:00,74,366,3,0,443,106,164,4,0,274,24.1,96,61,11.4,717,False,4,180,530,7,0,2024-01-10,False,False,False,0.7391910739191074,0.2510460251046025,0.009762900976290097,0.0,Off-Peak,Wednesday,January
2024-01-10 05:00:00,30,160,3,0,193,33,55,4,0,92,23.8,96,61,9.7,285,False,5,63,215,7,0,2024-01-10,False,False,False,0.7543859649122807,0.22105263157894736,0.02456140350877193,0.0,Shoulder,Wednesday,January
2024-01-10 06:00:00,43,212,3,0,258,50,78,3,0,131,23.8,97,53,5.2,389,False,6,93,290,6,0,2024-01-10,False,False,False,0.7455012853470437,0.2390745501285347,0.015424164524421594,0.0,Shoulder,Wednesday,January
2024-01-10 07:00:00,124,588,3,0,715,58,91,3,0,152,23.9,96,51,5.8,867,False,7,182,679,6,0,2024-01-10,False,False,False,0.7831603229527105,0.209919261822376,0.006920415224913495,0.0,Peak,Wednesday,January
2024-01-10 08:00:00,97,461,3,0,561,88,135,3,0,226,24.0,97,51,7.6,787,False,8,185,596,6,0,2024-01-10,False,False,False,0.7573062261753494,0.23506988564167725,0.007623888182973317,0.0,Peak,Wednesday,January
2024-01-10 09:00:00,126,603,4,0,733,61,95,3,0,159,26.1,90,3,7.9,892,False,9,187,698,7,0,2024-01-10,False,False,False,0.7825112107623319,0.20964125560538116,0.007847533632286996,0.0,Shoulder,Wednesday,January
2024-01-10 10:00:00,115,552,3,0,670,49,76,3,0,128,27.2,85,51,8.1,798,False,10,164,628,6,0,2024-01-10,False,False,False,0.7869674185463659,0.20551378446115287,0.007518796992481203,0.0,Shoulder,Wednesday,January
2024-01-10 11:00:00,102,493,3,0,598,100,155,3,0,258,28.2,81,51,10.3,856,False,11,202,648,6,0,2024-01-10,False,False,False,0.7570093457943925,0.23598130841121495,0.007009345794392523,0.0,Peak,Wednesday,January
2024-01-10 12:00:00,67,329,3,0,399,29,48,3,0,80,29.1,78,3,14.6,479,False,12,96,377,6,0,2024-01-10,False,False,False,0.7870563674321504,0.20041753653444677,0.012526096033402923,0.0,Peak,Wednesday,January
2024-01-10 13:00:00,102,495,4,0,601,38,61,3,0,102,28.1,78,51,19.5,703,False,13,140,556,7,0,2024-01-10,False,False,False,0.7908961593172119,0.19914651493598862,0.00995732574679943,0.0,Peak,Wednesday,January
2024-01-10 14:00:00,16,81,3,0,100,113,172,4,0,289,28.8,77,3,13.0,389,False,14,129,253,7,0,2024-01-10,False,False,False,0.6503856041131105,0.33161953727506427,0.017994858611825194,0.0,Peak,Wednesday,January
2024-01-10 15:00:00,56,273,3,0,332,101,155,5,0,261,29.1,73,3,13.5,593,False,15,157,428,8,0,2024-01-10,False,False,False,0.7217537942664418,0.26475548060708265,0.013490725126475547,0.0,Peak,Wednesday,January
2024-01-10 16:00:00,67,327,4,0,398,35,56,3,0,94,28.8,73,3,15.8,492,False,16,102,383,7,0,2024-01-10,False,False,False,0.7784552845528455,0.2073170731707317,0.014227642276422764,0.0,Peak,Wednesday,January
2024-01-10 17:00:00,112,528,5,0,645,70,108,4,0,182,28.0,78,3,12.0,827,False,17,182,636,9,0,2024-01-10,False,False,False,0.7690447400241838,0.22007255139056833,0.010882708585247884,0.0,Peak,Wednesday,January
2024-01-10 18:00:00,24,124,4,0,152,22,36,3,0,61,28.0,79,3,9.0,213,False,18,46,160,7,0,2024-01-10,False,False,False,0.7511737089201878,0.215962441314554,0.03286384976525822,0.0,Peak,Wednesday,January
2024-01-10 19:00:00,46,228,3,0,277,109,164,4,0,277,27.2,82,3,8.2,554,False,19,155,392,7,0,2024-01-10,False,False,False,0.7075812274368231,0.27978339350180503,0.01263537906137184,0.0,Peak,Wednesday,January
2024-01-10 20:00:00,88,421,4,0,513,93,142,4,0,239,26.4,86,3,8.6,752,False,20,181,563,8,0,2024-01-10,False,False,False,0.7486702127659575,0.24069148936170212,0.010638297872340425,0.0,Shoulder,Wednesday,January
2024-01-10 21:00:00,74,358,5,0,437,90,138,5,0,233,25.4,95,53,4.5,670,False,21,164,496,10,0,2024-01-10,False,False,False,0.7402985074626866,0.24477611940298508,0.014925373134328358,0.0,Shoulder,Wednesday,January
2024-01-10 22:00:00,65,312,5,0,382,35,55,5,0,95,24.9,97,3,3.6,477,False,22,100,367,10,0,2024-01-10,False,False,False,0.7693920335429769,0.20964360587002095,0.020964360587002098,0.0,Shoulder,Wednesday,January
2024-01-10 23:00:00,73,332,6,0,411,75,115,5,0,195,24.4,97,53,6.2,606,False,23,148,447,11,0,2024-01-10,False,False,False,0.7376237623762376,0.24422442244224424,0.018151815181518153,0.0,Shoulder,Wednesday,January
2024-01-11 00:00:00,22,96,1,0,119,16,29,0,0,45,24.0,96,61,7.0,164,False,0,38,125,1,0,2024-01-11,False,False,False,0.7621951219512195,0.23170731707317074,0.006097560975609756,0.0,Off-Peak,Thursday,January
2024-01-11 01:00:00,42,172,2,0,216,11,20,0,0,31,24.1,95,51,2.9,247,False,1,53,192,2,0,2024-01-11,False,False,False,0.7773279352226721,0.2145748987854251,0.008097165991902834,0.0,Off-Peak,Thursday,January
2024-01-11 02:00:00,38,159,1,0,198,7,12,0,0,19,23.7,96,3,6.8,217,False,2,45,171,1,0,2024-01-11,False,False,False,0.7880184331797235,0.2073732718894009,0.004608294930875576,0.0,Off-Peak,Thursday,January
2024-01-11 03:00:00,9,40,1,0,50,22,38,0,0,60,23.8,96,3,7.9,110,False,3,31,78,1,0,2024-01-11,False,False,False,0.7090909090909091,0.2818181818181818,0.00909090909090909,0.0,Off-Peak,Thursday,January
2024-01-11 04:00:00,33,136,1,0,170,27,47,0,0,74,23.6,97,2,6.7,244,False,4,60,183,1,0,2024-01-11,False,False,False,0.75,0.2459016393442623,0.004098360655737705,0.0,Off-Peak,Thursday,January
2024-01-11 05:00:00,34,135,1,0,170,6,13,0,0,19,23.6,97,3,7.6,189,False,5,40,148,1,0,2024-01-11,False,False,False,0.783068783068783,0.21164021164021163,0.005291005291005291,0.0,Shoulder,Thursday,January
2024-01-11 06:00:00,37,141,1,0,179,15,25,0,0,40,23.7,97,2,9.4,219,False,6,52,166,1,0,2024-01-11,False,False,False,0.7579908675799086,0.2374429223744292,0.0045662100456621,0.0,Shoulder,Thursday,January
2024-01-11 07:00:00,18,70,1,0,89,7,14,1,0,22,23.7,97,2,7.9,111,False,7,25,84,2,0,2024-01-11,False,False,False,0.7567567567567568,0.22522522522522523,0.018018018018018018,0.0,Peak,Thursday,January
2024-01-11 08:00:00,17,61,1,0,79,21,36,2,0,59,24.1,97,1,9.7,138,False,8,38,97,3,0,2024-01-11,False,False,False,0.7028985507246377,0.2753623188405797,0.021739130434782608,0.0,Peak,Thursday,January
2024-01-11 09:00:00,19,83,1,0,103,12,21,1,0,34,26.1,89,3,12.4,137,False,9,31,104,2,0,2024-01-11,False,False,False,0.7591240875912408,0.22627737226277372,0.014598540145985401,0.0,Shoulder,Thursday,January
2024-01-11 10:00:00,20,84,1,0,105,37,65,1,0,103,27.7,86,3,11.3,208,False,10,57,149,2,0,2024-01-11,False,False,False,0.7163461538461539,0.27403846153846156,0.009615384615384616,0.0,Shoulder,Thursday,January
2024-01-11 11:00:00,40,158,1,0,199,29,49,1,0,79,29.1,79,3,14.7,278,False,11,69,207,2,0,2024-01-11,False,False,False,0.7446043165467626,0.24820143884892087,0.007194244604316547,0.0,Peak,Thursday,January
2024-01-11 12:00:00,14,61,1,0,76,29,51,1,0,81,29.9,72,3,18.2,157,False,12,43,112,2,0,2024-01-11,False,False,False,0.7133757961783439,0.27388535031847133,0.012738853503184714,0.0,Peak,Thursday,January
2024-01-11 13:00:00,11,45,1,0,57,35,57,1,0,93,28.8,74,53,17.4,150,False,13,46,102,2,0,2024-01-11,False,False,False,0.68,0.30666666666666664,0.013333333333333334,0.0,Peak,Thursday,January
2024-01-11 14:00:00,49,201,1,0,251,16,27,1,0,44,29.8,73,51,15.9,295,False,14,65,228,2,0,2024-01-11,False,False,False,0.7728813559322034,0.22033898305084745,0.006779661016949152,0.0,Peak,Thursday,January
2024-01-11 15:00:00,11,45,2,0,58,10,19,1,0,30,30.1,71,3,16.8,88,False,15,21,64,3,0,2024-01-11,False,False,False,0.7272727272727273,0.23863636363636365,0.03409090909090909,0.0,Peak,Thursday,January
2024-01-11 16:00:00,48,187,2,0,237,30,49,1,0,80,29.6,70,51,13.0,317,False,16,78,236,3,0,2024-01-11,False,False,False,0.7444794952681388,0.24605678233438485,0.00946372239747634,0.0,Peak,Thursday,January
2024-01-11 17:00:00,33,137,2,0,172,25,41,1,0,67,29.5,73,53,9.4,239,False,17,58,178,3,0,2024-01-11,False,False,False,0.7447698744769874,0.24267782426778242,0.012552301255230125,0.0,Peak,Thursday,January
2024-01-11 18:00:00,35,137,2,0,174,29,49,1,0,79,28.3,77,51,11.5,253,False,18,64,186,3,0,2024-01-11,False,False,False,0.7351778656126482,0.25296442687747034,0.011857707509881422,0.0,Peak,Thursday,January
2024-01-11 19:00:00,37,145,2,0,184,13,21,1,0,35,26.3,89,63,2.1,219,False,19,50,166,3,0,2024-01-11,False,False,False,0.7579908675799086,0.228310502283105,0.0136986301369863,0.0,Peak,Thursday,January
2024-01-11 20:00:00,10,44,2,0,56,38,64,1,0,103,25.7,92,3,3.4,159,False,20,48,108,3,0,2024-01-11,False,False,False,0.6792452830188679,0.3018867924528302,0.018867924528301886,0.0,Shoulder,Thursday,January
2024-01-11 21:00:00,28,97,3,0,128,6,10,1,0,17,25.8,94,51,2.9,145,False,21,34,107,4,0,2024-01-11,False,False,False,0.7379310344827587,0.23448275862068965,0.027586206896551724,0.0,Shoulder,Thursday,January
2024-01-11 22:00:00,17,71,2,0,90,37,55,1,0,93,26.2,91,3,1.3,183,False,22,54,126,3,0,2024-01-11,False,False,False,0.6885245901639344,0.29508196721311475,0.01639344262295082,0.0,Shoulder,Thursday,January
2024-01-11 23:00:00,22,81,2,0,105,35,59,1,0,95,25.0,94,3,4.6,200,False,23,57,140,3,0,2024-01-11,False,False,False,0.7,0.285,0.015,0.0,Shoulder,Thursday,January
2024-01-12 00:00:00,14,79,0,0,93,23,34,0,0,57,25.1,92,3,8.6,150,False,0,37,113,0,0,2024-01-12,False,False,False,0.7533333333333333,0.24666666666666667,0.0,0.0,Off-Peak,Friday,January
2024-01-12 01:00:00,19,111,0,0,130,13,20,0,0,33,24.8,93,3,11.2,163,False,1,32,131,0,0,2024-01-12,False,False,False,0.803680981595092,0.19631901840490798,0.0,0.0,Off-Peak,Friday,January
2024-01-12 02:00:00,8,50,0,0,58,26,39,0,0,65,24.6,94,3,10.1,123,False,2,34,89,0,0,2024-01-12,False,False,False,0.7235772357723578,0.2764227642276423,0.0,0.0,Off-Peak,Friday,January
2024-01-12 03:00:00,6,40,0,0,46,17,27,0,0,44,24.5,94,3,9.7,90,False,3,23,67,0,0,2024-01-12,False,False,False,0.7444444444444445,0.25555555555555554,0.0,0.0,Off-Peak,Friday,January
2024-01-12 04:00:00,25,154,0,0,179,13,19,1,0,33,24.3,95,3,9.5,212,False,4,38,173,1,0,2024-01-12,False,False,False,0.8160377358490566,0.1792452830188679,0.0047169811320754715,0.0,Off-Peak,Friday,January
2024-01-12 05:00:00,18,108,0,0,126,29,45,1,0,75,24.4,94,3,11.0,201,False,5,47,153,1,0,2024-01-12,False,False,False,0.7611940298507462,0.23383084577114427,0.004975124378109453,0.0,Shoulder,Friday,January
2024-01-12 06:00:00,28,156,0,0,184,16,25,1,0,42,24.3,93,3,11.2,226,False,6,44,181,1,0,2024-01-12,False,False,False,0.8008849557522124,0.19469026548672566,0.004424778761061947,0.0,Shoulder,Friday,January
2024-01-12 07:00:00,16,99,0,0,115,30,47,1,0,78,24.1,94,3,10.1,193,False,7,46,146,1,0,2024-01-12,False,False,False,0.7564766839378239,0.23834196891191708,0.0051813471502590676,0.0,Peak,Friday,January
2024-01-12 08:00:00,4,24,0,0,28,30,46,1,0,77,24.2,94,3,11.5,105,False,8,34,70,1,0,2024-01-12,False,False,False,0.6666666666666666,0.3238095238095238,0.009523809523809525,0.0,Peak,Friday,January
2024-01-12 09:00:00,14,80,0,0,94,22,33,2,0,57,26.5,91,3,13.3,151,False,9,36,113,2,0,2024-01-12,False,False,False,0.7483443708609272,0.23841059602649006,0.013245033112582781,0.0,Shoulder,Friday,January
2024-01-12 10:00:00,21,126,0,0,147,22,32,1,0,55,26.7,87,51,12.4,202,False,10,43,158,1,0,2024-01-12,False,False,False,0.7821782178217822,0.21287128712871287,0.0049504950495049506,0.0,Shoulder,Friday,January
2024-01-12 11:00:00,21,124,0,0,145,5,8,1,0,14,27.2,84,51,10.8,159,False,11,26,132,1,0,2024-01-12,False,False,False,0.8301886792452831,0.16352201257861634,0.006289308176100629,0.0,Peak,Friday,January
2024-01-12 12:00:00,8,42,1,0,51,18,27,1,0,46,27.7,84,3,9.4,97,False,12,26,69,2,0,2024-01-12,False,False,False,0.711340206185567,0.26804123711340205,0.020618556701030927,0.0,Peak,Friday,January
2024-01-12 13:00:00,12,69,1,0,82,32,48,1,0,81,27.8,77,51,13.4,163,False,13,44,117,2,0,2024-01-12,False,False,False,0.7177914110429447,0.26993865030674846,0.012269938650306749,0.0,Peak,Friday,January
2024-01-12 14:00:00,14,84,1,0,99,10,16,1,0,27,28.6,74,3,9.6,126,False,14,24,100,2,0,2024-01-12,False,False,False,0.7936507936507936,0.19047619047619047,0.015873015873015872,0.0,Peak,Friday,January
2024-01-12 15:00:00,24,136,1,0,161,26,39,1,0,66,29.4,71,3,15.6,227,False,15,50,175,2,0,2024-01-12,False,False,False,0.7709251101321586,0.22026431718061673,0.00881057268722467,0.0,Peak,Friday,January
2024-01-12 16:00:00,20,103,1,0,124,16,24,1,0,41,29.5,67,51,13.8,165,False,16,36,127,2,0,2024-01-12,False,False,False,0.7696969696969697,0.21818181818181817,0.012121212121212121,0.0,Peak,Friday,January
2024-01-12 17:00:00,21,121,1,0,143,32,46,1,0,79,28.8,70,3,12.8,222,False,17,53,167,2,0,2024-01-12,False,False,False,0.7522522522522522,0.23873873873873874,0.009009009009009009,0.0,Peak,Friday,January
2024-01-12 18:00:00,8,48,1,0,57,17,26,1,0,44,28.2,76,3,12.0,101,False,18,25,74,2,0,2024-01-12,False,False,False,0.7326732673267327,0.24752475247524752,0.019801980198019802,0.0,Peak,Friday,January
2024-01-12 19:00:00,9,54,1,0,64,11,17,1,0,29,27.6,78,3,10.1,93,False,19,20,71,2,0,2024-01-12,False,False,False,0.7634408602150538,0.21505376344086022,0.021505376344086023,0.0,Peak,Friday,January
2024-01-12 20:00:00,19,97,1,0,117,14,22,1,0,37,26.9,83,3,6.1,154,False,20,33,119,2,0,2024-01-12,False,False,False,0.7727272727272727,0.21428571428571427,0.012987012987012988,0.0,Shoulder,Friday,January
2024-01-12 21:00:00,32,168,1,0,201,44,63,1,0,108,26.2,88,51,7.0,309,False,21,76,231,2,0,2024-01-12,False,False,False,0.7475728155339806,0.2459546925566343,0.006472491909385114,0.0,Shoulder,Friday,January
2024-01-12 22:00:00,23,115,1,0,139,28,42,1,0,71,25.8,88,3,8.8,210,False,22,51,157,2,0,2024-01-12,False,False,False,0.7476190476190476,0.24285714285714285,0.009523809523809525,0.0,Shoulder,Friday,January
2024-01-12 23:00:00,18,91,2,0,111,26,38,1,0,65,25.2,89,3,5.6,176,False,23,44,129,3,0,2024-01-12,False,False,False,0.7329545454545454,0.25,0.017045454545454544,0.0,Shoulder,Friday,January
2024-01-13 00:00:00,116,632,3,0,751,88,89,1,0,178,24.1,93,3,6.6,929,True,0,204,721,4,0,2024-01-13,False,False,False,0.7761033369214209,0.21959095801937567,0.004305705059203444,0.0,Off-Peak,Saturday,January
2024-01-13 01:00:00,30,169,3,0,202,108,108,3,1,220,24.3,93,3,4.8,422,True,1,138,277,6,1,2024-01-13,False,False,False,0.6563981042654028,0.32701421800947866,0.014218009478672985,0.002369668246445498,Off-Peak,Saturday,January
2024-01-13 02:00:00,23,139,4,0,166,43,45,2,0,90,24.4,93,3,7.3,256,True,2,66,184,6,0,2024-01-13,False,False,False,0.71875,0.2578125,0.0234375,0.0,Off-Peak,Saturday,January
2024-01-13 03:00:00,82,458,4,0,544,138,139,2,0,279,24.2,94,3,7.4,823,True,3,220,597,6,0,2024-01-13,False,False,False,0.7253948967193196,0.267314702308627,0.007290400972053463,0.0,Off-Peak,Saturday,January
2024-01-13 04:00:00,68,377,3,0,448,53,54,2,0,109,24.2,93,3,9.7,557,True,4,121,431,5,0,2024-01-13,False,False,False,0.7737881508078994,0.21723518850987433,0.008976660682226212,0.0,Off-Peak,Saturday,January
2024-01-13 05:00:00,108,592,3,0,703,90,92,2,0,184,23.9,94,3,9.3,887,True,5,198,684,5,0,2024-01-13,False,False,False,0.7711386696730552,0.22322435174746336,0.005636978579481398,0.0,Shoulder,Saturday,January
2024-01-13 06:00:00,75,403,3,0,481,83,84,2,0,169,23.6,94,3,10.7,650,True,6,158,487,5,0,2024-01-13,False,False,False,0.7492307692307693,0.24307692307692308,0.007692307692307693,0.0,Shoulder,Saturday,January
2024-01-13 07:00:00,46,269,3,0,318,135,137,3,0,275,23.5,94,3,11.2,593,True,7,181,406,6,0,2024-01-13,False,False,False,0.684654300168634,0.30522765598650925,0.01011804384485666,0.0,Peak,Saturday,January
2024-01-13 08:00:00,84,468,3,0,555,124,125,3,0,252,23.8,92,3,12.2,807,True,8,208,593,6,0,2024-01-13,False,False,False,0.734820322180917,0.2577447335811648,0.007434944237918215,0.0,Peak,Saturday,January
2024-01-13 09:00:00,14,88,3,0,105,115,116,3,0,234,25.5,95,3,9.9,339,True,9,129,204,6,0,2024-01-13,False,False,False,0.6017699115044248,0.3805309734513274,0.017699115044247787,0.0,Shoulder,Saturday,January
2024-01-13 10:00:00,107,578,3,0,688,126,127,3,0,256,26.2,91,3,12.5,944,True,10,233,705,6,0,2024-01-13,False,False,False,0.746822033898305,0.2468220338983051,0.006355932203389831,0.0,Shoulder,Saturday,January
2024-01-13 11:00:00,59,323,3,0,385,79,80,4,0,163,27.4,86,3,11.1,548,True,11,138,403,7,0,2024-01-13,False,False,False,0.7354014598540146,0.2518248175182482,0.012773722627737226,0.0,Peak,Saturday,January
2024-01-13 12:00:00,60,328,4,0,392,34,37,3,0,74,29.4,70,3,11.5,466,True,12,94,365,7,0,2024-01-13,False,False,False,0.7832618025751072,0.2017167381974249,0.015021459227467811,0.0,Peak,Saturday,January
2024-01-13 13:00:00,68,384,3,0,455,91,93,3,0,187,30.3,60,51,13.9,642,True,13,159,477,6,0,2024-01-13,False,False,False,0.7429906542056075,0.24766355140186916,0.009345794392523364,0.0,Peak,Saturday,January
2024-01-13 14:00:00,73,399,5,0,477,81,83,3,0,167,30.4,60,51,13.9,644,True,14,154,482,8,0,2024-01-13,False,False,False,0.7484472049689441,0.2391304347826087,0.012422360248447204,0.0,Peak,Saturday,January
2024-01-13 15:00:00,99,550,3,0,652,69,71,3,0,143,30.0,62,51,14.7,795,True,15,168,621,6,0,2024-01-13,False,False,False,0.7811320754716982,0.21132075471698114,0.007547169811320755,0.0,Peak,Saturday,January
2024-01-13 16:00:00,77,417,4,1,499,28,28,3,0,59,29.6,65,3,14.5,558,True,16,105,445,7,1,2024-01-13,False,False,False,0.7974910394265233,0.1881720430107527,0.012544802867383513,0.0017921146953405018,Peak,Saturday,January
2024-01-13 17:00:00,38,211,3,0,252,84,85,3,0,172,29.0,67,3,14.0,424,True,17,122,296,6,0,2024-01-13,False,False,False,0.6981132075471698,0.28773584905660377,0.014150943396226415,0.0,Peak,Saturday,January
2024-01-13 18:00:00,65,365,4,0,434,132,133,3,0,268,27.5,76,3,11.2,702,True,18,197,498,7,0,2024-01-13,False,False,False,0.7094017094017094,0.28062678062678065,0.009971509971509971,0.0,Peak,Saturday,January
2024-01-13 19:00:00,58,326,4,0,388,122,124,3,0,249,27.0,80,3,8.0,637,True,19,180,450,7,0,2024-01-13,False,False,False,0.706436420722135,0.282574568288854,0.01098901098901099,0.0,Peak,Saturday,January
2024-01-13 20:00:00,57,316,4,0,377,31,34,3,0,68,26.3,82,3,9.8,445,True,20,88,350,7,0,2024-01-13,False,False,False,0.7865168539325843,0.19775280898876405,0.015730337078651686,0.0,Shoulder,Saturday,January
2024-01-13 21:00:00,46,257,3,0,306,22,25,3,0,50,26.2,86,3,6.1,356,True,21,68,282,6,0,2024-01-13,False,False,False,0.7921348314606742,0.19101123595505617,0.016853932584269662,0.0,Shoulder,Saturday,January
2024-01-13 22:00:00,28,158,3,1,190,31,34,3,0,68,25.8,88,3,4.8,258,True,22,59,192,6,1,2024-01-13,False,False,False,0.7441860465116279,0.22868217054263565,0.023255813953488372,0.003875968992248062,Shoulder,Saturday,January
2024-01-13 23:00:00,98,514,5,1,618,105,106,3,0,214,25.7,89,3,6.4,832,True,23,203,620,8,1,2024-01-13,False,False,False,0.7451923076923077,0.2439903846153846,0.009615384615384616,0.001201923076923077,Shoulder,Saturday,January
2024-01-14 00:00:00,116,679,4,0,799,177,181,2,0,360,25.5,90,3,5.9,1159,True,0,293,860,6,0,2024-01-14,False,True,False,0.7420189818809318,0.2528041415012942,0.005176876617773943,0.0,Off-Peak,Sunday,January
2024-01-14 01:00:00,98,583,3,0,684,143,147,2,0,292,25.5,89,3,8.6,976,True,1,241,730,5,0,2024-01-14,False,True,False,0.7479508196721312,0.24692622950819673,0.005122950819672131,0.0,Off-Peak,Sunday,January
2024-01-14 02:00:00,66,394,3,0,463,146,150,2,0,298,25.0,89,3,10.6,761,True,2,212,544,5,0,2024-01-14,False,True,False,0.7148488830486203,0.278580814717477,0.006570302233902759,0.0,Off-Peak,Sunday,January
2024-01-14 03:00:00,89,523,3,0,615,158,163,2,0,323,24.9,87,3,12.8,938,True,3,247,686,5,0,2024-01-14,False,True,False,0.7313432835820896,0.26332622601279315,0.005330490405117271,0.0,Off-Peak,Sunday,January
2024-01-14 04:00:00,37,234,3,0,274,164,166,2,0,332,24.5,87,3,14.1,606,True,4,201,400,5,0,2024-01-14,False,True,False,0.6600660066006601,0.3316831683168317,0.00825082508250825,0.0,Off-Peak,Sunday,January
2024-01-14 05:00:00,20,136,3,0,159,39,44,2,0,85,24.4,87,3,12.6,244,True,5,59,180,5,0,2024-01-14,False,True,False,0.7377049180327869,0.24180327868852458,0.020491803278688523,0.0,Shoulder,Sunday,January
2024-01-14 06:00:00,37,232,4,0,273,56,60,2,0,118,24.3,88,3,10.8,391,True,6,93,292,6,0,2024-01-14,False,True,False,0.7468030690537084,0.23785166240409208,0.015345268542199489,0.0,Shoulder,Sunday,January
2024-01-14 07:00:00,52,309,3,0,364,168,172,2,0,342,24.1,88,3,11.6,706,True,7,220,481,5,0,2024-01-14,False,True,False,0.6813031161473088,0.311614730878187,0.007082152974504249,0.0,Peak,Sunday,January
2024-01-14 08:00:00,74,430,5,0,509,44,47,3,0,94,24.3,88,3,10.9,603,True,8,118,477,8,0,2024-01-14,False,True,False,0.7910447761194029,0.1956882255389718,0.013266998341625208,0.0,Peak,Sunday,January
2024-01-14 09:00:00,85,481,6,0,572,116,120,3,0,239,25.7,89,3,11.6,811,True,9,201,601,9,0,2024-01-14,False,True,False,0.7410604192355117,0.24784217016029594,0.011097410604192354,0.0,Shoulder,Sunday,January
2024-01-14 10:00:00,36,212,3,0,251,164,168,3,0,335,27.1,84,3,13.0,586,True,10,200,380,6,0,2024-01-14,False,True,False,0.6484641638225256,0.3412969283276451,0.010238907849829351,0.0,Shoulder,Sunday,January
2024-01-14 11:00:00,81,480,4,0,565,27,30,3,0,60,28.5,75,51,13.5,625,True,11,108,510,7,0,2024-01-14,False,True,False,0.816,0.1728,0.0112,0.0,Peak,Sunday,January
2024-01-14 12:00:00,48,299,3,0,350,161,165,3,0,329,28.4,72,3,14.8,679,True,12,209,464,6,0,2024-01-14,False,True,False,0.6833578792341679,0.3078055964653903,0.008836524300441826,0.0,Peak,Sunday,January
2024-01-14 13:00:00,76,457,4,0,537,70,73,3,0,146,28.1,76,53,13.6,683,True,13,146,530,7,0,2024-01-14,False,True,False,0.7759882869692533,0.21376281112737922,0.010248901903367497,0.0,Peak,Sunday,January
2024-01-14 14:00:00,17,113,3,0,133,155,159,3,0,317,28.6,74,55,13.8,450,True,14,172,272,6,0,2024-01-14,False,True,False,0.6044444444444445,0.38222222222222224,0.013333333333333334,0.0,Peak,Sunday,January
2024-01-14 15:00:00,101,599,4,0,704,79,83,3,0,165,29.0,66,51,16.1,869,True,15,180,682,7,0,2024-01-14,False,True,False,0.7848101265822784,0.20713463751438435,0.00805523590333717,0.0,Peak,Sunday,January
2024-01-14 16:00:00,20,126,4,1,151,105,110,3,0,218,28.7,65,2,15.8,369,True,16,125,236,7,1,2024-01-14,False,True,False,0.6395663956639567,0.33875338753387535,0.018970189701897018,0.0027100271002710027,Peak,Sunday,January
2024-01-14 17:00:00,57,338,3,0,398,38,41,3,0,82,28.9,67,1,13.5,480,True,17,95,379,6,0,2024-01-14,False,True,False,0.7895833333333333,0.19791666666666666,0.0125,0.0,Peak,Sunday,January
2024-01-14 18:00:00,53,322,3,0,378,126,130,4,0,260,28.6,73,0,12.5,638,True,18,179,452,7,0,2024-01-14,False,True,False,0.7084639498432602,0.28056426332288403,0.0109717868338558,0.0,Peak,Sunday,January
2024-01-14 19:00:00,66,385,5,1,457,29,32,4,1,66,27.8,77,1,7.5,523,True,19,95,417,9,2,2024-01-14,False,True,False,0.7973231357552581,0.18164435946462715,0.017208413001912046,0.0038240917782026767,Peak,Sunday,January
2024-01-14 20:00:00,68,399,5,1,473,158,165,3,1,327,26.8,79,3,5.6,800,True,20,226,564,8,2,2024-01-14,False,True,False,0.705,0.2825,0.01,0.0025,Shoulder,Sunday,January
2024-01-14 21:00:00,42,251,4,1,298,146,151,3,1,301,26.5,91,51,4.3,599,True,21,188,402,7,2,2024-01-14,False,True,False,0.671118530884808,0.31385642737896496,0.011686143572621035,0.00333889816360601,Shoulder,Sunday,January
2024-01-14 22:00:00,99,579,6,1,685,68,74,3,1,146,26.3,90,51,7.8,831,True,22,167,653,9,2,2024-01-14,False,True,False,0.7858002406738869,0.2009626955475331,0.010830324909747292,0.0024067388688327317,Shoulder,Sunday,January
2024-01-14 23:00:00,122,698,6,1,827,50,54,4,1,109,25.7,87,3,10.5,936,True,23,172,752,10,2,2024-01-14,False,True,False,0.8034188034188035,0.18376068376068377,0.010683760683760684,0.002136752136752137,Shoulder,Sunday,January
2024-01-15 00:00:00,71,403,0,0,474,64,124,0,0,188,25.0,88,3,12.6,662,False,0,135,527,0,0,2024-01-15,False,True,False,0.7960725075528701,0.2039274924471299,0.0,0.0,Off-Peak,Monday,January
2024-01-15 01:00:00,18,109,1,0,128,48,95,1,0,144,24.4,89,3,10.7,272,False,1,66,204,2,0,2024-01-15,False,True,False,0.75,0.2426470588235294,0.007352941176470588,0.0,Off-Peak,Monday,January
2024-01-15 02:00:00,20,125,1,0,146,72,141,1,0,214,24.1,90,3,11.8,360,False,2,92,266,2,0,2024-01-15,False,True,False,0.7388888888888889,0.25555555555555554,0.005555555555555556,0.0,Off-Peak,Monday,January
2024-01-15 03:00:00,51,295,1,0,347,63,124,1,0,188,23.8,91,3,11.6,535,False,3,114,419,2,0,2024-01-15,False,True,False,0.7831775700934579,0.2130841121495327,0.003738317757009346,0.0,Off-Peak,Monday,January
2024-01-15 04:00:00,116,637,2,0,755,41,79,1,0,121,23.6,91,3,11.1,876,False,4,157,716,3,0,2024-01-15,False,True,False,0.817351598173516,0.17922374429223745,0.003424657534246575,0.0,Off-Peak,Monday,January
2024-01-15 05:00:00,23,141,1,0,165,48,93,1,0,142,23.5,91,3,10.8,307,False,5,71,234,2,0,2024-01-15,False,True,False,0.762214983713355,0.23127035830618892,0.006514657980456026,0.0,Shoulder,Monday,January
2024-01-15 06:00:00,30,177,1,0,208,67,132,1,0,200,23.2,92,3,9.7,408,False,6,97,309,2,0,2024-01-15,False,True,False,0.7573529411764706,0.23774509803921567,0.004901960784313725,0.0,Shoulder,Monday,January
2024-01-15 07:00:00,42,243,1,0,286,12,26,1,0,39,23.1,93,3,8.5,325,False,7,54,269,2,0,2024-01-15,False,True,False,0.8276923076923077,0.16615384615384615,0.006153846153846154,0.0,Peak,Monday,January
2024-01-15 08:00:00,42,253,1,0,296,77,148,1,0,226,23.6,91,3,9.7,522,False,8,119,401,2,0,2024-01-15,False,True,False,0.7681992337164751,0.22796934865900384,0.0038314176245210726,0.0,Peak,Monday,January
2024-01-15 09:00:00,111,619,1,0,731,68,128,2,0,198,25.7,94,55,7.4,929,False,9,179,747,3,0,2024-01-15,False,True,False,0.8040904198062433,0.19268030139935413,0.0032292787944025836,0.0,Shoulder,Monday,January
2024-01-15 10:00:00,91,485,2,0,578,33,64,2,0,99,26.5,90,53,7.6,677,False,10,124,549,4,0,2024-01-15,False,True,False,0.810930576070901,0.1831610044313146,0.005908419497784343,0.0,Shoulder,Monday,January
2024-01-15 11:00:00,91,506,1,0,598,19,40,1,0,60,26.1,91,61,10.5,658,False,11,110,546,2,0,2024-01-15,False,True,False,0.8297872340425532,0.16717325227963525,0.00303951367781155,0.0,Peak,Monday,January
2024-01-15 12:00:00,64,355,1,0,420,78,147,1,0,226,26.1,88,63,7.9,646,False,12,142,502,2,0,2024-01-15,False,True,False,0.7770897832817337,0.21981424148606812,0.0030959752321981426,0.0,Peak,Monday,January
2024-01-15 13:00:00,93,526,1,0,620,62,120,1,0,183,27.4,86,53,7.2,803,False,13,155,646,2,0,2024-01-15,False,True,False,0.8044831880448319,0.1930261519302615,0.0024906600249066002,0.0,Peak,Monday,January
2024-01-15 14:00:00,78,428,1,0,507,18,38,1,0,57,27.3,86,53,10.0,564,False,14,96,466,2,0,2024-01-15,False,True,False,0.8262411347517731,0.1702127659574468,0.0035460992907801418,0.0,Peak,Monday,January
2024-01-15 15:00:00,58,330,1,0,389,23,44,1,0,68,27.4,84,51,5.9,457,False,15,81,374,2,0,2024-01-15,False,True,False,0.8183807439824945,0.1772428884026258,0.00437636761487965,0.0,Peak,Monday,January
2024-01-15 16:00:00,70,384,1,0,455,57,107,2,0,166,28.2,80,51,8.8,621,False,16,127,491,3,0,2024-01-15,False,True,False,0.7906602254428341,0.20450885668276972,0.004830917874396135,0.0,Peak,Monday,January
2024-01-15 17:00:00,19,121,1,0,141,66,127,2,0,195,26.7,86,63,10.3,336,False,17,85,248,3,0,2024-01-15,False,True,False,0.7380952380952381,0.25297619047619047,0.008928571428571428,0.0,Peak,Monday,January
2024-01-15 18:00:00,45,261,2,0,308,20,42,2,0,64,26.4,89,3,11.3,372,False,18,65,303,4,0,2024-01-15,False,True,False,0.8145161290322581,0.17473118279569894,0.010752688172043012,0.0,Peak,Monday,January
2024-01-15 19:00:00,46,271,2,0,319,32,62,2,0,96,26.1,90,3,11.0,415,False,19,78,333,4,0,2024-01-15,False,True,False,0.8024096385542169,0.18795180722891566,0.00963855421686747,0.0,Peak,Monday,January
2024-01-15 20:00:00,38,220,2,0,260,51,96,2,0,149,25.7,91,55,12.1,409,False,20,89,316,4,0,2024-01-15,False,True,False,0.7726161369193154,0.2176039119804401,0.009779951100244499,0.0,Shoulder,Monday,January
2024-01-15 21:00:00,131,707,2,0,840,39,76,2,0,117,25.3,93,61,13.4,957,False,21,170,783,4,0,2024-01-15,False,True,False,0.8181818181818182,0.17763845350052246,0.0041797283176593526,0.0,Shoulder,Monday,January
2024-01-15 22:00:00,72,392,2,0,466,54,101,2,0,157,25.2,93,51,8.7,623,False,22,126,493,4,0,2024-01-15,False,True,False,0.7913322632423756,0.20224719101123595,0.006420545746388443,0.0,Shoulder,Monday,January
2024-01-15 23:00:00,167,891,2,0,1060,101,186,2,0,289,25.1,93,51,12.9,1349,False,23,268,1077,4,0,2024-01-15,False,True,False,0.7983691623424759,0.19866567828020756,0.0029651593773165306,0.0,Shoulder,Monday,January
2024-01-16 00:00:00,38,197,1,0,236,47,66,2,0,115,24.9,95,51,12.4,351,False,0,85,263,3,0,2024-01-16,False,False,False,0.7492877492877493,0.24216524216524216,0.008547008547008548,0.0,Off-Peak,Tuesday,January
2024-01-16 01:00:00,111,517,3,0,631,121,163,5,0,289,24.8,95,51,10.3,920,False,1,232,680,8,0,2024-01-16,False,False,False,0.7391304347826086,0.25217391304347825,0.008695652173913044,0.0,Off-Peak,Tuesday,January
2024-01-16 02:00:00,123,582,2,0,707,32,46,4,0,82,24.6,96,51,10.4,789,False,2,155,628,6,0,2024-01-16,False,False,False,0.7959442332065906,0.1964512040557668,0.0076045627376425855,0.0,Off-Peak,Tuesday,January
2024-01-16 03:00:00,28,153,2,0,183,100,136,5,0,241,24.5,96,3,8.1,424,False,3,128,289,7,0,2024-01-16,False,False,False,0.6816037735849056,0.3018867924528302,0.01650943396226415,0.0,Off-Peak,Tuesday,January
2024-01-16 04:00:00,70,340,2,0,412,69,93,3,0,165,24.3,97,51,8.9,577,False,4,139,433,5,0,2024-01-16,False,False,False,0.7504332755632582,0.24090121317157712,0.008665511265164644,0.0,Off-Peak,Tuesday,January
2024-01-16 05:00:00,44,212,2,0,258,47,65,3,0,115,24.2,97,51,6.5,373,False,5,91,277,5,0,2024-01-16,False,False,False,0.7426273458445041,0.24396782841823056,0.013404825737265416,0.0,Shoulder,Tuesday,January
2024-01-16 06:00:00,35,177,2,0,214,44,60,4,0,108,24.2,96,51,7.5,322,False,6,79,237,6,0,2024-01-16,False,False,False,0.7360248447204969,0.2453416149068323,0.018633540372670808,0.0,Shoulder,Tuesday,January
2024-01-16 07:00:00,50,244,2,0,296,113,151,4,0,268,24.0,96,51,7.3,564,False,7,163,395,6,0,2024-01-16,False,False,False,0.700354609929078,0.28900709219858156,0.010638297872340425,0.0,Peak,Tuesday,January
2024-01-16 08:00:00,95,445,3,0,543,131,177,4,0,312,24.2,95,51,7.7,855,False,8,226,622,7,0,2024-01-16,False,False,False,0.7274853801169591,0.26432748538011697,0.008187134502923977,0.0,Peak,Tuesday,January
2024-01-16 09:00:00,37,177,2,0,216,47,67,3,0,117,24.5,95,63,16.8,333,False,9,84,244,5,0,2024-01-16,False,False,False,0.7327327327327328,0.25225225225225223,0.015015015015015015,0.0,Shoulder,Tuesday,January
2024-01-16 10:00:00,115,540,2,0,657,77,105,4,0,186,24.5,94,63,16.8,843,False,10,192,645,6,0,2024-01-16,False,False,False,0.7651245551601423,0.2277580071174377,0.0071174377224199285,0.0,Shoulder,Tuesday,January
2024-01-16 11:00:00,54,249,2,0,305,120,159,4,0,283,24.7,94,63,16.2,588,False,11,174,408,6,0,2024-01-16,False,False,False,0.6938775510204082,0.29591836734693877,0.01020408163265306,0.0,Peak,Tuesday,January
2024-01-16 12:00:00,107,497,3,0,607,62,85,3,0,150,24.9,94,61,12.3,757,False,12,169,582,6,0,2024-01-16,False,False,False,0.7688243064729194,0.22324966974900926,0.007926023778071334,0.0,Peak,Tuesday,January
2024-01-16 13:00:00,160,748,3,0,911,34,48,3,0,85,25.1,93,53,12.0,996,False,13,194,796,6,0,2024-01-16,False,False,False,0.7991967871485943,0.19477911646586346,0.006024096385542169,0.0,Peak,Tuesday,January
2024-01-16 14:00:00,91,438,3,0,532,70,92,4,0,166,25.9,90,53,14.6,698,False,14,161,530,7,0,2024-01-16,False,False,False,0.7593123209169055,0.23065902578796563,0.01002865329512894,0.0,Peak,Tuesday,January
2024-01-16 15:00:00,142,663,3,0,808,115,156,5,0,276,27.5,84,53,13.3,1084,False,15,257,819,8,0,2024-01-16,False,False,False,0.7555350553505535,0.2370848708487085,0.007380073800738007,0.0,Peak,Tuesday,January
2024-01-16 16:00:00,52,253,3,0,308,83,111,6,0,200,28.1,78,51,16.2,508,False,16,135,364,9,0,2024-01-16,False,False,False,0.7165354330708661,0.265748031496063,0.017716535433070866,0.0,Peak,Tuesday,January
2024-01-16 17:00:00,105,502,3,0,610,66,89,4,0,159,28.0,78,3,14.3,769,False,17,171,591,7,0,2024-01-16,False,False,False,0.7685305591677504,0.2223667100130039,0.009102730819245773,0.0,Peak,Tuesday,January
2024-01-16 18:00:00,64,308,3,0,375,42,58,4,0,104,27.7,79,3,16.9,479,False,18,106,366,7,0,2024-01-16,False,False,False,0.7640918580375783,0.22129436325678498,0.014613778705636743,0.0,Peak,Tuesday,January
2024-01-16 19:00:00,54,258,3,0,315,114,156,5,0,275,26.4,86,3,13.8,590,False,19,168,414,8,0,2024-01-16,False,False,False,0.7016949152542373,0.2847457627118644,0.013559322033898305,0.0,Peak,Tuesday,January
2024-01-16 20:00:00,85,390,3,0,478,65,88,4,0,157,26.1,86,3,13.3,635,False,20,150,478,7,0,2024-01-16,False,False,False,0.752755905511811,0.23622047244094488,0.011023622047244094,0.0,Shoulder,Tuesday,January
2024-01-16 21:00:00,113,524,3,0,640,41,57,5,0,103,25.4,93,53,14.0,743,False,21,154,581,8,0,2024-01-16,False,False,False,0.7819650067294751,0.2072678331090175,0.010767160161507403,0.0,Shoulder,Tuesday,January
2024-01-16 22:00:00,60,287,3,0,350,129,173,6,0,308,25.4,93,51,13.6,658,False,22,189,460,9,0,2024-01-16,False,False,False,0.6990881458966566,0.2872340425531915,0.013677811550151976,0.0,Shoulder,Tuesday,January
2024-01-16 23:00:00,159,725,3,0,887,66,91,7,0,164,25.3,92,51,17.6,1051,False,23,225,816,10,0,2024-01-16,False,False,False,0.7764034253092293,0.21408182683158897,0.009514747859181731,0.0,Shoulder,Tuesday,January
2024-01-17 00:00:00,50,226,1,0,277,98,143,3,0,244,25.0,93,51,16.6,521,False,0,148,369,4,0,2024-01-17,False,False,False,0.708253358925144,0.2840690978886756,0.007677543186180422,0.0,Off-Peak,Wednesday,January
2024-01-17 01:00:00,85,391,2,0,478,43,62,3,0,108,24.9,92,3,17.1,586,False,1,128,453,5,0,2024-01-17,False,False,False,0.773037542662116,0.21843003412969283,0.008532423208191127,0.0,Off-Peak,Wednesday,January
2024-01-17 02:00:00,133,601,2,0,736,87,128,4,0,219,24.6,93,3,15.0,955,False,2,220,729,6,0,2024-01-17,False,False,False,0.7633507853403141,0.23036649214659685,0.0062827225130890054,0.0,Off-Peak,Wednesday,January
2024-01-17 03:00:00,125,572,3,0,700,65,95,5,0,165,24.5,93,3,15.1,865,False,3,190,667,8,0,2024-01-17,False,False,False,0.7710982658959538,0.21965317919075145,0.009248554913294798,0.0,Off-Peak,Wednesday,January
2024-01-17 04:00:00,73,324,3,0,400,69,106,4,0,179,24.3,93,3,13.4,579,False,4,142,430,7,0,2024-01-17,False,False,False,0.7426597582037997,0.2452504317789292,0.012089810017271158,0.0,Off-Peak,Wednesday,January
2024-01-17 05:00:00,36,171,2,0,209,71,102,3,0,176,24.1,94,3,12.8,385,False,5,107,273,5,0,2024-01-17,False,False,False,0.7090909090909091,0.2779220779220779,0.012987012987012988,0.0,Shoulder,Wednesday,January
2024-01-17 06:00:00,97,452,2,0,551,34,54,3,0,91,23.9,94,3,11.3,642,False,6,131,506,5,0,2024-01-17,False,False,False,0.7881619937694704,0.20404984423676012,0.00778816199376947,0.0,Shoulder,Wednesday,January
2024-01-17 07:00:00,50,230,2,0,282,93,133,4,0,230,23.7,95,2,9.8,512,False,7,143,363,6,0,2024-01-17,False,False,False,0.708984375,0.279296875,0.01171875,0.0,Peak,Wednesday,January
2024-01-17 08:00:00,127,581,2,0,710,101,147,4,0,252,23.9,95,3,9.0,962,False,8,228,728,6,0,2024-01-17,False,False,False,0.7567567567567568,0.23700623700623702,0.006237006237006237,0.0,Peak,Wednesday,January
2024-01-17 09:00:00,34,164,2,0,200,60,90,3,0,153,26.2,91,51,16.8,353,False,9,94,254,5,0,2024-01-17,False,False,False,0.7195467422096318,0.26628895184135976,0.014164305949008499,0.0,Shoulder,Wednesday,January
2024-01-17 10:00:00,140,620,2,0,762,142,204,4,0,350,27.1,88,51,14.1,1112,False,10,282,824,6,0,2024-01-17,False,False,False,0.7410071942446043,0.25359712230215825,0.00539568345323741,0.0,Shoulder,Wednesday,January
2024-01-17 11:00:00,108,489,3,0,600,76,111,4,0,191,26.4,87,65,13.6,791,False,11,184,600,7,0,2024-01-17,False,False,False,0.7585335018963337,0.23261694058154236,0.008849557522123894,0.0,Peak,Wednesday,January
2024-01-17 12:00:00,109,496,3,0,608,30,45,3,0,78,26.5,84,61,15.9,686,False,12,139,541,6,0,2024-01-17,False,False,False,0.7886297376093294,0.20262390670553937,0.008746355685131196,0.0,Peak,Wednesday,January
2024-01-17 13:00:00,69,314,3,0,386,84,121,3,0,208,25.7,89,63,16.8,594,False,13,153,435,6,0,2024-01-17,False,False,False,0.7323232323232324,0.25757575757575757,0.010101010101010102,0.0,Peak,Wednesday,January
2024-01-17 14:00:00,70,323,4,0,397,112,159,4,0,275,25.3,91,63,14.0,672,False,14,182,482,8,0,2024-01-17,False,False,False,0.7172619047619048,0.2708333333333333,0.011904761904761904,0.0,Peak,Wednesday,January
2024-01-17 15:00:00,60,279,3,0,342,143,205,6,0,354,26.1,88,53,15.1,696,False,15,203,484,9,0,2024-01-17,False,False,False,0.6954022988505747,0.2916666666666667,0.01293103448275862,0.0,Peak,Wednesday,January
2024-01-17 16:00:00,112,505,3,0,620,28,44,3,0,75,26.1,90,53,12.8,695,False,16,140,549,6,0,2024-01-17,False,False,False,0.7899280575539568,0.2014388489208633,0.008633093525179856,0.0,Peak,Wednesday,January
2024-01-17 17:00:00,102,458,3,0,563,42,63,4,0,109,26.5,88,51,11.1,672,False,17,144,521,7,0,2024-01-17,False,False,False,0.7752976190476191,0.21428571428571427,0.010416666666666666,0.0,Peak,Wednesday,January
2024-01-17 18:00:00,97,440,3,0,540,66,95,3,0,164,26.2,88,55,13.6,704,False,18,163,535,6,0,2024-01-17,False,False,False,0.7599431818181818,0.2315340909090909,0.008522727272727272,0.0,Peak,Wednesday,January
2024-01-17 19:00:00,91,411,3,0,505,57,85,4,0,146,25.6,90,51,13.3,651,False,19,148,496,7,0,2024-01-17,False,False,False,0.7619047619047619,0.22734254992319508,0.010752688172043012,0.0,Peak,Wednesday,January
2024-01-17 20:00:00,63,299,3,0,365,49,74,4,0,127,25.2,92,3,11.8,492,False,20,112,373,7,0,2024-01-17,False,False,False,0.758130081300813,0.22764227642276422,0.014227642276422764,0.0,Shoulder,Wednesday,January
2024-01-17 21:00:00,70,313,3,0,386,188,263,5,0,456,25.6,91,3,13.9,842,False,21,258,576,8,0,2024-01-17,False,False,False,0.684085510688836,0.30641330166270786,0.009501187648456057,0.0,Shoulder,Wednesday,January
2024-01-17 22:00:00,26,124,3,0,153,89,130,5,0,224,25.1,93,3,11.8,377,False,22,115,254,8,0,2024-01-17,False,False,False,0.6737400530503979,0.3050397877984085,0.021220159151193633,0.0,Shoulder,Wednesday,January
2024-01-17 23:00:00,131,578,3,0,712,79,114,5,0,198,25.0,93,3,11.4,910,False,23,210,692,8,0,2024-01-17,False,False,False,0.7604395604395604,0.23076923076923078,0.008791208791208791,0.0,Shoulder,Wednesday,January
2024-01-18 00:00:00,117,483,3,0,603,25,36,2,0,63,24.6,94,61,11.3,666,False,0,142,519,5,0,2024-01-18,False,False,False,0.7792792792792793,0.2132132132132132,0.0075075075075075074,0.0,Off-Peak,Thursday,January
2024-01-18 01:00:00,39,169,3,0,211,110,144,3,0,257,24.4,95,63,9.5,468,False,1,149,313,6,0,2024-01-18,False,False,False,0.6688034188034188,0.31837606837606836,0.01282051282051282,0.0,Off-Peak,Thursday,January
2024-01-18 02:00:00,77,311,3,0,391,29,41,3,0,73,24.4,94,3,11.9,464,False,2,106,352,6,0,2024-01-18,False,False,False,0.7586206896551724,0.22844827586206898,0.01293103448275862,0.0,Off-Peak,Thursday,January
2024-01-18 03:00:00,103,428,3,0,534,101,131,4,0,236,24.3,95,3,11.0,770,False,3,204,559,7,0,2024-01-18,False,False,False,0.7259740259740259,0.2649350649350649,0.00909090909090909,0.0,Off-Peak,Thursday,January
2024-01-18 04:00:00,85,349,3,0,437,125,160,4,0,289,24.1,96,3,11.6,726,False,4,210,509,7,0,2024-01-18,False,False,False,0.7011019283746557,0.2892561983471074,0.009641873278236915,0.0,Off-Peak,Thursday,January
2024-01-18 05:00:00,32,136,4,0,172,110,140,4,0,254,24.0,96,3,9.0,426,False,5,142,276,8,0,2024-01-18,False,False,False,0.647887323943662,0.3333333333333333,0.018779342723004695,0.0,Shoulder,Thursday,January
2024-01-18 06:00:00,38,163,3,0,204,116,150,4,0,270,24.0,95,3,9.1,474,False,6,154,313,7,0,2024-01-18,False,False,False,0.6603375527426161,0.32489451476793246,0.014767932489451477,0.0,Shoulder,Thursday,January
2024-01-18 07:00:00,114,467,4,0,585,62,82,3,0,147,23.8,95,3,8.1,732,False,7,176,549,7,0,2024-01-18,False,False,False,0.75,0.24043715846994534,0.009562841530054645,0.0,Peak,Thursday,January
2024-01-18 08:00:00,125,503,3,0,631,104,135,4,0,243,24.1,94,3,8.2,874,False,8,229,638,7,0,2024-01-18,False,False,False,0.7299771167048055,0.2620137299771167,0.008009153318077803,0.0,Peak,Thursday,January
2024-01-18 09:00:00,22,108,3,0,133,64,84,4,0,152,25.9,89,3,13.3,285,False,9,86,192,7,0,2024-01-18,False,False,False,0.6736842105263158,0.3017543859649123,0.02456140350877193,0.0,Shoulder,Thursday,January
2024-01-18 10:00:00,68,279,3,0,350,47,62,3,0,112,26.8,85,3,13.9,462,False,10,115,341,6,0,2024-01-18,False,False,False,0.7380952380952381,0.24891774891774893,0.012987012987012988,0.0,Shoulder,Thursday,January
2024-01-18 11:00:00,129,522,3,0,654,101,130,4,0,235,27.5,84,51,12.7,889,False,11,230,652,7,0,2024-01-18,False,False,False,0.7334083239595051,0.25871766029246346,0.007874015748031496,0.0,Peak,Thursday,January
2024-01-18 12:00:00,33,139,4,0,176,37,51,3,0,91,28.9,76,51,17.7,267,False,12,70,190,7,0,2024-01-18,False,False,False,0.7116104868913857,0.26217228464419473,0.026217228464419477,0.0,Peak,Thursday,January
2024-01-18 13:00:00,57,243,4,0,304,98,127,4,0,229,28.8,74,51,13.7,533,False,13,155,370,8,0,2024-01-18,False,False,False,0.6941838649155723,0.29080675422138835,0.0150093808630394,0.0,Peak,Thursday,January
2024-01-18 14:00:00,53,226,3,0,282,112,145,4,0,261,28.8,76,51,9.8,543,False,14,165,371,7,0,2024-01-18,False,False,False,0.6832412523020258,0.30386740331491713,0.01289134438305709,0.0,Peak,Thursday,January
2024-01-18 15:00:00,97,398,3,0,498,55,73,4,0,132,28.1,80,53,4.9,630,False,15,152,471,7,0,2024-01-18,False,False,False,0.7476190476190476,0.24126984126984127,0.011111111111111112,0.0,Peak,Thursday,January
2024-01-18 16:00:00,148,591,4,0,743,65,85,3,0,153,27.9,80,53,11.6,896,False,16,213,676,7,0,2024-01-18,False,False,False,0.7544642857142857,0.23772321428571427,0.0078125,0.0,Peak,Thursday,January
2024-01-18 17:00:00,73,284,4,0,361,94,121,4,0,219,27.2,79,53,14.6,580,False,17,167,405,8,0,2024-01-18,False,False,False,0.6982758620689655,0.28793103448275864,0.013793103448275862,0.0,Peak,Thursday,January
2024-01-18 18:00:00,149,606,4,0,759,87,114,5,0,206,26.7,86,61,7.4,965,False,18,236,720,9,0,2024-01-18,False,False,False,0.7461139896373057,0.24455958549222798,0.00932642487046632,0.0,Peak,Thursday,January
2024-01-18 19:00:00,33,151,3,0,187,124,158,5,0,287,26.0,91,51,4.3,474,False,19,157,309,8,0,2024-01-18,False,False,False,0.6518987341772152,0.33122362869198313,0.016877637130801686,0.0,Peak,Thursday,January
2024-01-18 20:00:00,185,728,4,0,917,82,108,6,0,196,25.3,94,3,4.7,1113,False,20,267,836,10,0,2024-01-18,False,False,False,0.7511230907457322,0.2398921832884097,0.008984725965858042,0.0,Shoulder,Thursday,January
2024-01-18 21:00:00,87,359,3,0,449,116,151,5,0,272,25.0,96,51,3.1,721,False,21,203,510,8,0,2024-01-18,False,False,False,0.7073509015256588,0.2815533980582524,0.011095700416088766,0.0,Shoulder,Thursday,January
2024-01-18 22:00:00,124,497,5,0,626,80,102,6,0,188,25.4,93,3,4.8,814,False,22,204,599,11,0,2024-01-18,False,False,False,0.7358722358722358,0.25061425061425063,0.013513513513513514,0.0,Shoulder,Thursday,January
2024-01-18 23:00:00,99,399,5,0,503,71,91,5,0,167,25.3,92,3,9.0,670,False,23,170,490,10,0,2024-01-18,False,False,False,0.7313432835820896,0.2537313432835821,0.014925373134328358,0.0,Shoulder,Thursday,January
2024-01-19 00:00:00,121,547,4,0,672,26,37,5,0,68,24.9,93,3,8.0,740,False,0,147,584,9,0,2024-01-19,False,False,False,0.7891891891891892,0.19864864864864865,0.012162162162162163,0.0,Off-Peak,Friday,January
2024-01-19 01:00:00,128,558,4,0,690,65,82,3,0,150,24.7,94,3,8.3,840,False,1,193,640,7,0,2024-01-19,False,False,False,0.7619047619047619,0.22976190476190475,0.008333333333333333,0.0,Off-Peak,Friday,January
2024-01-19 02:00:00,97,440,4,0,541,112,141,5,0,258,24.5,94,3,10.4,799,False,2,209,581,9,0,2024-01-19,False,False,False,0.7271589486858573,0.2615769712140175,0.011264080100125156,0.0,Off-Peak,Friday,January
2024-01-19 03:00:00,113,509,4,0,626,40,52,4,0,96,24.3,95,3,10.2,722,False,3,153,561,8,0,2024-01-19,False,False,False,0.7770083102493075,0.21191135734072022,0.0110803324099723,0.0,Off-Peak,Friday,January
2024-01-19 04:00:00,112,507,4,0,623,22,33,3,0,58,24.0,95,3,9.4,681,False,4,134,540,7,0,2024-01-19,False,False,False,0.7929515418502202,0.19676945668135096,0.010279001468428781,0.0,Off-Peak,Friday,January
2024-01-19 05:00:00,110,487,5,0,602,69,89,4,0,162,23.8,96,3,9.4,764,False,5,179,576,9,0,2024-01-19,False,False,False,0.7539267015706806,0.2342931937172775,0.011780104712041885,0.0,Shoulder,Friday,January
2024-01-19 06:00:00,21,98,4,0,123,82,104,4,0,190,23.8,95,3,9.5,313,False,6,103,202,8,0,2024-01-19,False,False,False,0.645367412140575,0.329073482428115,0.025559105431309903,0.0,Shoulder,Friday,January
2024-01-19 07:00:00,71,313,4,0,388,111,142,4,0,257,23.6,95,3,6.9,645,False,7,182,455,8,0,2024-01-19,False,False,False,0.7054263565891473,0.28217054263565894,0.012403100775193798,0.0,Peak,Friday,January
2024-01-19 08:00:00,98,436,5,0,539,57,72,3,0,132,23.9,94,3,8.7,671,False,8,155,508,8,0,2024-01-19,False,False,False,0.7570789865871833,0.23099850968703428,0.011922503725782414,0.0,Peak,Friday,January
2024-01-19 09:00:00,60,267,3,0,330,70,88,3,0,161,25.6,93,3,8.0,491,False,9,130,355,6,0,2024-01-19,False,False,False,0.7230142566191446,0.26476578411405294,0.012219959266802444,0.0,Shoulder,Friday,January
2024-01-19 10:00:00,85,386,4,0,475,88,112,4,0,204,26.6,89,3,10.6,679,False,10,173,498,8,0,2024-01-19,False,False,False,0.7334315169366715,0.2547864506627393,0.011782032400589101,0.0,Shoulder,Friday,January
2024-01-19 11:00:00,98,435,4,0,537,75,94,3,0,172,27.1,85,51,12.7,709,False,11,173,529,7,0,2024-01-19,False,False,False,0.7461212976022567,0.24400564174894218,0.009873060648801129,0.0,Peak,Friday,January
2024-01-19 12:00:00,85,387,4,0,476,91,114,6,0,211,26.7,87,61,16.0,687,False,12,176,501,10,0,2024-01-19,False,False,False,0.7292576419213974,0.2561863173216885,0.01455604075691412,0.0,Peak,Friday,January
2024-01-19 13:00:00,108,481,4,0,593,36,47,4,0,87,25.6,92,65,10.1,680,False,13,144,528,8,0,2024-01-19,False,False,False,0.7764705882352941,0.21176470588235294,0.011764705882352941,0.0,Peak,Friday,January
2024-01-19 14:00:00,67,304,5,0,376,42,56,5,0,103,26.5,86,53,10.4,479,False,14,109,360,10,0,2024-01-19,False,False,False,0.7515657620041754,0.22755741127348644,0.020876826722338204,0.0,Peak,Friday,January
2024-01-19 15:00:00,53,240,3,0,296,134,167,5,0,306,28.3,82,3,9.7,602,False,15,187,407,8,0,2024-01-19,False,False,False,0.6760797342192691,0.3106312292358804,0.013289036544850499,0.0,Peak,Friday,January
2024-01-19 16:00:00,52,238,3,0,293,104,132,5,0,241,30.1,68,51,12.2,534,False,16,156,370,8,0,2024-01-19,False,False,False,0.6928838951310862,0.29213483146067415,0.0149812734082397,0.0,Peak,Friday,January
2024-01-19 17:00:00,44,201,4,0,249,51,67,4,0,122,29.4,73,51,7.8,371,False,17,95,268,8,0,2024-01-19,False,False,False,0.7223719676549866,0.2560646900269542,0.0215633423180593,0.0,Peak,Friday,January
2024-01-19 18:00:00,99,425,6,0,530,64,82,4,0,150,27.7,78,53,3.7,680,False,18,163,507,10,0,2024-01-19,False,False,False,0.7455882352941177,0.23970588235294119,0.014705882352941176,0.0,Peak,Friday,January
2024-01-19 19:00:00,82,363,6,0,451,127,160,5,0,292,26.6,85,3,5.0,743,False,19,209,523,11,0,2024-01-19,False,False,False,0.7039030955585465,0.2812920592193809,0.014804845222072678,0.0,Peak,Friday,January
2024-01-19 20:00:00,101,457,5,0,563,88,110,5,0,203,25.8,91,51,3.2,766,False,20,189,567,10,0,2024-01-19,False,False,False,0.7402088772845953,0.24673629242819844,0.013054830287206266,0.0,Shoulder,Friday,January
2024-01-19 21:00:00,47,199,4,0,250,102,127,6,0,235,25.8,95,51,3.7,485,False,21,149,326,10,0,2024-01-19,False,False,False,0.6721649484536083,0.30721649484536084,0.020618556701030927,0.0,Shoulder,Friday,January
2024-01-19 22:00:00,65,292,5,0,362,61,80,5,0,146,25.2,93,63,7.7,508,False,22,126,372,10,0,2024-01-19,False,False,False,0.7322834645669292,0.24803149606299213,0.01968503937007874,0.0,Shoulder,Friday,January
2024-01-19 23:00:00,30,149,5,0,184,109,136,7,0,252,24.9,93,51,7.8,436,False,23,139,285,12,0,2024-01-19,False,False,False,0.6536697247706422,0.31880733944954126,0.027522935779816515,0.0,Shoulder,Friday,January
2024-01-20 00:00:00,133,609,4,0,746,100,112,4,0,216,24.7,94,3,5.5,962,True,0,233,721,8,0,2024-01-20,False,False,False,0.7494802494802495,0.24220374220374222,0.008316008316008316,0.0,Off-Peak,Saturday,January
2024-01-20 01:00:00,70,321,3,0,394,52,60,3,0,115,24.1,97,3,4.6,509,True,1,122,381,6,0,2024-01-20,False,False,False,0.7485265225933202,0.23968565815324164,0.011787819253438114,0.0,Off-Peak,Saturday,January
2024-01-20 02:00:00,81,378,3,0,462,79,88,4,0,171,24.4,96,3,6.0,633,True,2,160,466,7,0,2024-01-20,False,False,False,0.7361769352290679,0.2527646129541864,0.011058451816745656,0.0,Off-Peak,Saturday,January
2024-01-20 03:00:00,168,729,3,0,900,87,97,3,0,187,24.3,96,3,6.1,1087,True,3,255,826,6,0,2024-01-20,False,False,False,0.7598896044158233,0.23459061637534498,0.005519779208831647,0.0,Off-Peak,Saturday,January
2024-01-20 04:00:00,92,418,6,0,516,28,33,4,0,65,24.1,97,3,5.8,581,True,4,120,451,10,0,2024-01-20,False,False,False,0.7762478485370051,0.20654044750430292,0.01721170395869191,0.0,Off-Peak,Saturday,January
2024-01-20 05:00:00,71,317,3,0,391,163,178,4,0,345,23.6,98,3,4.1,736,True,5,234,495,7,0,2024-01-20,False,False,False,0.6725543478260869,0.3179347826086957,0.009510869565217392,0.0,Shoulder,Saturday,January
2024-01-20 06:00:00,42,190,4,0,236,76,85,3,0,164,23.5,98,3,5.4,400,True,6,118,275,7,0,2024-01-20,False,False,False,0.6875,0.295,0.0175,0.0,Shoulder,Saturday,January
2024-01-20 07:00:00,75,337,3,0,415,127,139,4,0,270,23.2,98,3,3.6,685,True,7,202,476,7,0,2024-01-20,False,False,False,0.6948905109489051,0.2948905109489051,0.010218978102189781,0.0,Peak,Saturday,January
2024-01-20 08:00:00,97,444,4,0,545,31,37,4,0,72,23.8,96,3,6.6,617,True,8,128,481,8,0,2024-01-20,False,False,False,0.779578606158833,0.20745542949756887,0.012965964343598054,0.0,Peak,Saturday,January
2024-01-20 09:00:00,146,650,4,0,800,60,68,3,0,131,25.0,96,53,4.9,931,True,9,206,718,7,0,2024-01-20,False,False,False,0.7712137486573577,0.22126745435016112,0.007518796992481203,0.0,Shoulder,Saturday,January
2024-01-20 10:00:00,83,367,3,0,453,141,154,4,0,299,25.1,94,51,8.2,752,True,10,224,521,7,0,2024-01-20,False,False,False,0.6928191489361702,0.2978723404255319,0.009308510638297872,0.0,Shoulder,Saturday,January
2024-01-20 11:00:00,154,679,4,0,837,74,83,3,0,160,25.9,92,53,6.6,997,True,11,228,762,7,0,2024-01-20,False,False,False,0.7642928786359077,0.22868605817452356,0.007021063189568706,0.0,Peak,Saturday,January
2024-01-20 12:00:00,52,232,4,1,289,153,167,5,0,325,25.9,92,51,7.2,614,True,12,205,399,9,1,2024-01-20,False,False,False,0.6498371335504886,0.3338762214983713,0.014657980456026058,0.0016286644951140066,Peak,Saturday,January
2024-01-20 13:00:00,35,173,3,0,211,37,44,4,0,85,26.1,89,51,6.3,296,True,13,72,217,7,0,2024-01-20,False,False,False,0.7331081081081081,0.24324324324324326,0.02364864864864865,0.0,Peak,Saturday,January
2024-01-20 14:00:00,143,618,5,0,766,149,162,6,0,317,26.8,88,51,4.0,1083,True,14,292,780,11,0,2024-01-20,False,False,False,0.7202216066481995,0.2696214219759926,0.010156971375807941,0.0,Peak,Saturday,January
2024-01-20 15:00:00,91,410,4,0,505,78,87,4,0,169,27.3,79,51,8.8,674,True,15,169,497,8,0,2024-01-20,False,False,False,0.7373887240356083,0.2507418397626113,0.011869436201780416,0.0,Peak,Saturday,January
2024-01-20 16:00:00,114,519,4,0,637,87,96,5,0,188,27.1,73,3,10.6,825,True,16,201,615,9,0,2024-01-20,False,False,False,0.7454545454545455,0.24363636363636362,0.01090909090909091,0.0,Peak,Saturday,January
2024-01-20 17:00:00,154,679,4,0,837,153,168,5,0,326,26.5,79,3,8.7,1163,True,17,307,847,9,0,2024-01-20,False,False,False,0.7282889079965607,0.26397248495270853,0.007738607050730868,0.0,Peak,Saturday,January
2024-01-20 18:00:00,87,404,5,1,497,22,27,5,1,55,25.9,81,3,10.5,552,True,18,109,431,10,2,2024-01-20,False,False,False,0.7807971014492754,0.19746376811594202,0.018115942028985508,0.0036231884057971015,Peak,Saturday,January
2024-01-20 19:00:00,62,282,5,1,350,138,153,5,0,296,25.1,79,3,11.0,646,True,19,200,435,10,1,2024-01-20,False,False,False,0.673374613003096,0.30959752321981426,0.015479876160990712,0.0015479876160990713,Peak,Saturday,January
2024-01-20 20:00:00,74,343,4,1,422,110,121,5,0,236,24.3,80,3,9.9,658,True,20,184,464,9,1,2024-01-20,False,False,False,0.7051671732522796,0.2796352583586626,0.013677811550151976,0.001519756838905775,Shoulder,Saturday,January
2024-01-20 21:00:00,84,375,5,1,465,86,96,6,1,189,24.5,90,51,14.0,654,True,21,170,471,11,2,2024-01-20,False,False,False,0.7201834862385321,0.2599388379204893,0.016819571865443424,0.0030581039755351682,Shoulder,Saturday,January
2024-01-20 22:00:00,75,335,5,1,416,50,58,5,1,114,24.4,89,51,10.6,530,True,22,125,393,10,2,2024-01-20,False,False,False,0.7415094339622641,0.2358490566037736,0.018867924528301886,0.0037735849056603774,Shoulder,Saturday,January
2024-01-20 23:00:00,66,310,5,1,382,143,159,6,1,309,24.0,93,51,10.2,691,True,23,209,469,11,2,2024-01-20,False,False,False,0.678726483357453,0.3024602026049204,0.015918958031837915,0.002894356005788712,Shoulder,Saturday,January
2024-01-21 00:00:00,50,251,2,0,303,142,165,4,0,311,24.0,92,51,10.4,614,True,0,192,416,6,0,2024-01-21,False,False,False,0.6775244299674267,0.3127035830618892,0.009771986970684038,0.0,Off-Peak,Sunday,January
2024-01-21 01:00:00,74,353,2,0,429,140,162,3,0,305,23.8,94,51,10.7,734,True,1,214,515,5,0,2024-01-21,False,False,False,0.7016348773841962,0.29155313351498635,0.006811989100817439,0.0,Off-Peak,Sunday,January
2024-01-21 02:00:00,129,627,3,1,760,160,184,4,0,348,23.8,95,55,8.8,1108,True,2,289,811,7,1,2024-01-21,False,False,False,0.7319494584837545,0.2608303249097473,0.00631768953068592,0.0009025270758122744,Off-Peak,Sunday,January
2024-01-21 03:00:00,129,623,2,0,754,105,122,4,0,231,23.8,95,53,8.9,985,True,3,234,745,6,0,2024-01-21,False,False,False,0.7563451776649747,0.23756345177664975,0.006091370558375634,0.0,Off-Peak,Sunday,January
2024-01-21 04:00:00,139,674,4,0,817,39,50,3,0,92,23.6,94,53,10.9,909,True,4,178,724,7,0,2024-01-21,False,False,False,0.7964796479647965,0.19581958195819582,0.007700770077007701,0.0,Off-Peak,Sunday,January
2024-01-21 05:00:00,80,392,3,0,475,153,178,4,0,335,23.4,94,51,12.3,810,True,5,233,570,7,0,2024-01-21,False,False,False,0.7037037037037037,0.2876543209876543,0.008641975308641974,0.0,Shoulder,Sunday,January
2024-01-21 06:00:00,35,160,3,0,198,113,134,4,0,251,23.1,92,51,12.5,449,True,6,148,294,7,0,2024-01-21,False,False,False,0.6547884187082406,0.32962138084632514,0.015590200445434299,0.0,Shoulder,Sunday,January
2024-01-21 07:00:00,109,535,3,0,647,131,151,5,0,287,22.9,91,3,10.2,934,True,7,240,686,8,0,2024-01-21,False,False,False,0.734475374732334,0.2569593147751606,0.008565310492505354,0.0,Peak,Sunday,January
2024-01-21 08:00:00,23,104,3,0,130,78,93,3,0,174,23.0,91,3,10.8,304,True,8,101,197,6,0,2024-01-21,False,False,False,0.6480263157894737,0.33223684210526316,0.019736842105263157,0.0,Peak,Sunday,January
2024-01-21 09:00:00,104,502,3,0,609,26,34,3,0,63,25.6,94,51,7.0,672,True,9,130,536,6,0,2024-01-21,False,False,False,0.7976190476190477,0.19345238095238096,0.008928571428571428,0.0,Shoulder,Sunday,January
2024-01-21 10:00:00,35,171,3,0,209,111,131,4,0,246,26.2,90,51,8.3,455,True,10,146,302,7,0,2024-01-21,False,False,False,0.6637362637362637,0.3208791208791209,0.015384615384615385,0.0,Shoulder,Sunday,January
2024-01-21 11:00:00,70,338,3,0,411,132,151,4,0,287,27.4,87,51,9.4,698,True,11,202,489,7,0,2024-01-21,False,False,False,0.7005730659025788,0.28939828080229224,0.01002865329512894,0.0,Peak,Sunday,January
2024-01-21 12:00:00,46,221,3,0,270,68,82,3,0,153,27.6,83,51,9.4,423,True,12,114,303,6,0,2024-01-21,False,False,False,0.7163120567375887,0.2695035460992908,0.014184397163120567,0.0,Peak,Sunday,January
2024-01-21 13:00:00,118,566,3,0,687,81,97,4,0,182,27.2,83,51,9.8,869,True,13,199,663,7,0,2024-01-21,False,False,False,0.762945914844649,0.2289988492520138,0.00805523590333717,0.0,Peak,Sunday,January
2024-01-21 14:00:00,94,430,4,0,528,33,41,4,0,78,28.9,80,51,10.8,606,True,14,127,471,8,0,2024-01-21,False,False,False,0.7772277227722773,0.20957095709570958,0.013201320132013201,0.0,Peak,Sunday,January
2024-01-21 15:00:00,66,322,3,0,391,67,81,3,0,151,28.4,80,53,11.7,542,True,15,133,403,6,0,2024-01-21,False,False,False,0.7435424354243543,0.24538745387453875,0.01107011070110701,0.0,Peak,Sunday,January
2024-01-21 16:00:00,117,553,3,0,673,84,101,4,0,189,27.1,83,63,10.1,862,True,16,201,654,7,0,2024-01-21,False,False,False,0.7587006960556845,0.23317865429234338,0.008120649651972157,0.0,Peak,Sunday,January
2024-01-21 17:00:00,29,133,3,0,165,133,154,6,0,293,27.8,81,3,12.4,458,True,17,162,287,9,0,2024-01-21,False,False,False,0.6266375545851528,0.3537117903930131,0.019650655021834062,0.0,Peak,Sunday,January
2024-01-21 18:00:00,151,720,3,0,874,107,123,5,1,236,27.0,84,51,11.0,1110,True,18,258,843,8,1,2024-01-21,False,False,False,0.7594594594594595,0.23243243243243245,0.007207207207207207,0.0009009009009009009,Peak,Sunday,January
2024-01-21 19:00:00,24,123,3,0,150,175,202,5,1,383,26.3,87,3,11.1,533,True,19,199,325,8,1,2024-01-21,False,False,False,0.6097560975609756,0.37335834896810505,0.0150093808630394,0.001876172607879925,Peak,Sunday,January
2024-01-21 20:00:00,22,107,3,1,133,80,94,5,2,181,25.5,90,3,9.1,314,True,20,102,201,8,3,2024-01-21,False,False,False,0.6401273885350318,0.3248407643312102,0.025477707006369428,0.009554140127388535,Shoulder,Sunday,January
2024-01-21 21:00:00,142,680,3,1,826,77,91,4,1,173,25.1,95,63,4.7,999,True,21,219,771,7,2,2024-01-21,False,False,False,0.7717717717717718,0.21921921921921922,0.007007007007007007,0.002002002002002002,Shoulder,Sunday,January
2024-01-21 22:00:00,114,534,3,1,652,152,175,5,1,333,24.8,96,51,7.5,985,True,22,266,709,8,2,2024-01-21,False,False,False,0.7197969543147208,0.2700507614213198,0.008121827411167513,0.0020304568527918783,Shoulder,Sunday,January
2024-01-21 23:00:00,127,606,3,1,737,29,34,6,1,70,24.4,96,53,8.5,807,True,23,156,640,9,2,2024-01-21,False,False,False,0.7930607187112764,0.19330855018587362,0.011152416356877323,0.0024783147459727386,Shoulder,Sunday,January
2024-01-22 00:00:00,24,121,0,0,145,45,80,1,0,126,24.4,95,53,7.1,271,False,0,69,201,1,0,2024-01-22,False,False,False,0.7416974169741697,0.25461254612546125,0.0036900369003690036,0.0,Off-Peak,Monday,January
2024-01-22 01:00:00,98,501,2,0,601,53,92,1,0,146,24.3,96,55,3.6,747,False,1,151,593,3,0,2024-01-22,False,False,False,0.7938420348058902,0.20214190093708165,0.004016064257028112,0.0,Off-Peak,Monday,January
2024-01-22 02:00:00,43,214,1,0,258,34,61,1,0,96,24.1,98,51,4.7,354,False,2,77,275,2,0,2024-01-22,False,False,False,0.7768361581920904,0.2175141242937853,0.005649717514124294,0.0,Off-Peak,Monday,January
2024-01-22 03:00:00,84,454,1,0,539,44,78,1,0,123,24.2,98,3,3.9,662,False,3,128,532,2,0,2024-01-22,False,False,False,0.8036253776435045,0.1933534743202417,0.0030211480362537764,0.0,Off-Peak,Monday,January
2024-01-22 04:00:00,114,622,1,0,737,58,103,2,0,163,24.2,97,3,7.1,900,False,4,172,725,3,0,2024-01-22,False,False,False,0.8055555555555556,0.19111111111111112,0.0033333333333333335,0.0,Off-Peak,Monday,January
2024-01-22 05:00:00,83,433,1,0,517,22,40,1,0,63,24.2,97,3,8.5,580,False,5,105,473,2,0,2024-01-22,False,False,False,0.8155172413793104,0.1810344827586207,0.0034482758620689655,0.0,Shoulder,Monday,January
2024-01-22 06:00:00,95,478,1,0,574,81,146,1,0,228,24.0,98,3,6.8,802,False,6,176,624,2,0,2024-01-22,False,False,False,0.7780548628428927,0.2194513715710723,0.0024937655860349127,0.0,Shoulder,Monday,January
2024-01-22 07:00:00,105,556,1,0,662,74,131,1,0,206,23.8,98,0,8.4,868,False,7,179,687,2,0,2024-01-22,False,False,False,0.7914746543778802,0.20622119815668202,0.002304147465437788,0.0,Peak,Monday,January
2024-01-22 08:00:00,35,197,1,0,233,30,54,1,0,85,23.9,98,1,10.1,318,False,8,65,251,2,0,2024-01-22,False,False,False,0.789308176100629,0.20440251572327045,0.006289308176100629,0.0,Peak,Monday,January
2024-01-22 09:00:00,90,468,1,0,559,16,29,1,0,46,25.5,96,51,6.5,605,False,9,106,497,2,0,2024-01-22,False,False,False,0.8214876033057851,0.17520661157024794,0.003305785123966942,0.0,Shoulder,Monday,January
2024-01-22 10:00:00,62,312,1,0,375,43,77,1,0,121,26.1,95,53,3.3,496,False,10,105,389,2,0,2024-01-22,False,False,False,0.7842741935483871,0.21169354838709678,0.004032258064516129,0.0,Shoulder,Monday,January
2024-01-22 11:00:00,76,393,1,0,470,76,134,1,0,211,26.7,90,63,3.3,681,False,11,152,527,2,0,2024-01-22,False,False,False,0.7738619676945668,0.22320117474302498,0.002936857562408223,0.0,Peak,Monday,January
2024-01-22 12:00:00,81,433,1,0,515,60,104,1,0,165,27.0,90,61,4.8,680,False,12,141,537,2,0,2024-01-22,False,False,False,0.7897058823529411,0.2073529411764706,0.0029411764705882353,0.0,Peak,Monday,January
2024-01-22 13:00:00,91,470,1,0,562,68,120,1,0,189,27.7,89,55,4.0,751,False,13,159,590,2,0,2024-01-22,False,False,False,0.7856191744340879,0.21171770972037285,0.002663115845539281,0.0,Peak,Monday,January
2024-01-22 14:00:00,39,183,2,0,224,28,49,1,0,78,27.9,89,53,8.8,302,False,14,67,232,3,0,2024-01-22,False,False,False,0.7682119205298014,0.22185430463576158,0.009933774834437087,0.0,Peak,Monday,January
2024-01-22 15:00:00,42,211,1,0,254,54,95,1,0,150,27.6,85,61,6.6,404,False,15,96,306,2,0,2024-01-22,False,False,False,0.7574257425742574,0.2376237623762376,0.0049504950495049506,0.0,Peak,Monday,January
2024-01-22 16:00:00,91,497,1,0,589,67,121,1,0,189,27.0,86,3,2.6,778,False,16,158,618,2,0,2024-01-22,False,False,False,0.794344473007712,0.20308483290488433,0.002570694087403599,0.0,Peak,Monday,January
2024-01-22 17:00:00,86,433,1,0,520,66,117,2,0,185,27.5,82,3,2.8,705,False,17,152,550,3,0,2024-01-22,False,False,False,0.7801418439716312,0.21560283687943263,0.00425531914893617,0.0,Peak,Monday,January
2024-01-22 18:00:00,69,359,1,0,429,104,182,2,0,288,27.3,84,53,6.5,717,False,18,173,541,3,0,2024-01-22,False,False,False,0.7545327754532776,0.2412831241283124,0.0041841004184100415,0.0,Peak,Monday,January
2024-01-22 19:00:00,48,251,1,0,300,43,76,2,0,121,26.3,91,61,8.6,421,False,19,91,327,3,0,2024-01-22,False,False,False,0.7767220902612827,0.2161520190023753,0.007125890736342043,0.0,Peak,Monday,January
2024-01-22 20:00:00,36,189,1,0,226,106,184,3,0,293,25.2,94,3,10.8,519,False,20,142,373,4,0,2024-01-22,False,False,False,0.7186897880539499,0.27360308285163776,0.007707129094412331,0.0,Shoulder,Monday,January
2024-01-22 21:00:00,46,228,1,0,275,100,177,2,0,279,25.9,93,3,6.8,554,False,21,146,405,3,0,2024-01-22,False,False,False,0.7310469314079422,0.26353790613718414,0.005415162454873646,0.0,Shoulder,Monday,January
2024-01-22 22:00:00,42,209,2,0,253,40,69,2,0,111,25.2,96,3,9.3,364,False,22,82,278,4,0,2024-01-22,False,False,False,0.7637362637362637,0.22527472527472528,0.01098901098901099,0.0,Shoulder,Monday,January
2024-01-22 23:00:00,49,243,2,0,294,90,157,2,0,249,24.7,96,51,11.0,543,False,23,139,400,4,0,2024-01-22,False,False,False,0.7366482504604052,0.2559852670349908,0.007366482504604052,0.0,Shoulder,Monday,January
2024-01-23 00:00:00,40,182,2,0,224,101,140,4,0,245,24.2,94,3,13.4,469,False,0,141,322,6,0,2024-01-23,False,False,False,0.6865671641791045,0.3006396588486141,0.01279317697228145,0.0,Off-Peak,Tuesday,January
2024-01-23 01:00:00,151,627,3,0,781,86,118,5,0,209,23.9,94,3,12.2,990,False,1,237,745,8,0,2024-01-23,False,False,False,0.7525252525252525,0.23939393939393938,0.00808080808080808,0.0,Off-Peak,Tuesday,January
2024-01-23 02:00:00,73,295,2,0,370,38,52,4,0,94,23.8,94,3,10.5,464,False,2,111,347,6,0,2024-01-23,False,False,False,0.7478448275862069,0.23922413793103448,0.01293103448275862,0.0,Off-Peak,Tuesday,January
2024-01-23 03:00:00,100,439,2,0,541,125,171,4,0,300,23.9,93,3,11.8,841,False,3,225,610,6,0,2024-01-23,False,False,False,0.7253269916765755,0.267538644470868,0.007134363852556481,0.0,Off-Peak,Tuesday,January
2024-01-23 04:00:00,80,328,3,0,411,132,181,4,0,317,23.9,94,3,11.0,728,False,4,212,509,7,0,2024-01-23,False,False,False,0.6991758241758241,0.29120879120879123,0.009615384615384616,0.0,Off-Peak,Tuesday,January
2024-01-23 05:00:00,127,508,5,0,640,111,153,5,0,269,23.9,94,3,12.6,909,False,5,238,661,10,0,2024-01-23,False,False,False,0.7271727172717272,0.26182618261826185,0.011001100110011002,0.0,Shoulder,Tuesday,January
2024-01-23 06:00:00,53,207,3,0,263,139,191,4,0,334,23.9,93,3,12.8,597,False,6,192,398,7,0,2024-01-23,False,False,False,0.6666666666666666,0.32160804020100503,0.011725293132328308,0.0,Shoulder,Tuesday,January
2024-01-23 07:00:00,99,420,3,0,522,122,169,4,0,295,23.8,93,3,12.3,817,False,7,221,589,7,0,2024-01-23,False,False,False,0.7209302325581395,0.27050183598531213,0.008567931456548347,0.0,Peak,Tuesday,January
2024-01-23 08:00:00,119,490,3,0,612,34,46,4,0,84,24.0,93,3,11.7,696,False,8,153,536,7,0,2024-01-23,False,False,False,0.7701149425287356,0.21982758620689655,0.010057471264367816,0.0,Peak,Tuesday,January
2024-01-23 09:00:00,33,148,3,0,184,112,155,4,0,271,25.7,93,3,5.4,455,False,9,145,303,7,0,2024-01-23,False,False,False,0.6659340659340659,0.31868131868131866,0.015384615384615385,0.0,Shoulder,Tuesday,January
2024-01-23 10:00:00,32,137,3,0,172,137,187,5,0,329,26.6,89,3,11.8,501,False,10,169,324,8,0,2024-01-23,False,False,False,0.6467065868263473,0.3373253493013972,0.015968063872255488,0.0,Shoulder,Tuesday,January
2024-01-23 11:00:00,158,656,3,0,817,98,134,4,0,236,26.7,87,51,10.4,1053,False,11,256,790,7,0,2024-01-23,False,False,False,0.7502374169040835,0.24311490978157646,0.006647673314339981,0.0,Peak,Tuesday,January
2024-01-23 12:00:00,45,190,3,0,238,138,191,4,0,333,27.4,83,51,7.2,571,False,12,183,381,7,0,2024-01-23,False,False,False,0.6672504378283712,0.3204903677758319,0.012259194395796848,0.0,Peak,Tuesday,January
2024-01-23 13:00:00,82,337,3,0,422,45,61,5,0,111,27.8,82,51,3.6,533,False,13,127,398,8,0,2024-01-23,False,False,False,0.7467166979362101,0.23827392120075047,0.0150093808630394,0.0,Peak,Tuesday,January
2024-01-23 14:00:00,37,161,3,0,201,90,124,4,0,218,29.0,77,51,2.3,419,False,14,127,285,7,0,2024-01-23,False,False,False,0.6801909307875895,0.3031026252983294,0.016706443914081145,0.0,Peak,Tuesday,January
2024-01-23 15:00:00,48,200,3,0,251,123,168,4,0,295,30.1,72,51,7.2,546,False,15,171,368,7,0,2024-01-23,False,False,False,0.673992673992674,0.3131868131868132,0.01282051282051282,0.0,Peak,Tuesday,January
2024-01-23 16:00:00,60,261,3,0,324,131,180,4,0,315,27.4,80,63,7.9,639,False,16,191,441,7,0,2024-01-23,False,False,False,0.6901408450704225,0.29890453834115804,0.010954616588419406,0.0,Peak,Tuesday,January
2024-01-23 17:00:00,137,573,3,0,713,61,85,4,0,150,26.8,85,51,10.5,863,False,17,198,658,7,0,2024-01-23,False,False,False,0.7624565469293163,0.22943221320973348,0.008111239860950173,0.0,Peak,Tuesday,January
2024-01-23 18:00:00,95,404,3,0,502,73,98,4,0,175,26.8,85,51,7.7,677,False,18,168,502,7,0,2024-01-23,False,False,False,0.741506646971935,0.2481536189069424,0.0103397341211226,0.0,Peak,Tuesday,January
2024-01-23 19:00:00,110,462,3,0,575,105,145,4,0,254,26.4,87,51,12.6,829,False,19,215,607,7,0,2024-01-23,False,False,False,0.7322074788902292,0.25934861278648974,0.008443908323281062,0.0,Peak,Tuesday,January
2024-01-23 20:00:00,105,443,3,0,551,108,147,4,0,259,25.5,90,51,12.6,810,False,20,213,590,7,0,2024-01-23,False,False,False,0.7283950617283951,0.26296296296296295,0.008641975308641974,0.0,Shoulder,Tuesday,January
2024-01-23 21:00:00,112,452,3,0,567,79,109,4,0,192,26.1,91,51,17.4,759,False,21,191,561,7,0,2024-01-23,False,False,False,0.7391304347826086,0.2516469038208169,0.00922266139657444,0.0,Shoulder,Tuesday,January
2024-01-23 22:00:00,59,240,3,0,302,74,100,5,0,179,25.4,94,3,13.9,481,False,22,133,340,8,0,2024-01-23,False,False,False,0.7068607068607069,0.2765072765072765,0.016632016632016633,0.0,Shoulder,Tuesday,January
2024-01-23 23:00:00,129,534,3,0,666,42,56,5,0,103,25.0,94,3,12.1,769,False,23,171,590,8,0,2024-01-23,False,False,False,0.7672301690507152,0.2223667100130039,0.010403120936280884,0.0,Shoulder,Tuesday,January
2024-01-24 00:00:00,45,215,3,0,263,81,72,3,0,156,24.9,95,3,13.9,419,False,0,126,287,6,0,2024-01-24,False,False,False,0.684964200477327,0.30071599045346065,0.014319809069212411,0.0,Off-Peak,Wednesday,January
2024-01-24 01:00:00,83,381,4,0,468,39,33,5,0,77,24.7,96,3,11.8,545,False,1,122,414,9,0,2024-01-24,False,False,False,0.7596330275229358,0.22385321100917432,0.01651376146788991,0.0,Off-Peak,Wednesday,January
2024-01-24 02:00:00,109,518,4,0,631,200,175,5,0,380,24.6,96,3,13.8,1011,False,2,309,693,9,0,2024-01-24,False,False,False,0.685459940652819,0.3056379821958457,0.008902077151335312,0.0,Off-Peak,Wednesday,January
2024-01-24 03:00:00,59,281,4,0,344,41,35,4,0,80,24.5,96,3,11.5,424,False,3,100,316,8,0,2024-01-24,False,False,False,0.7452830188679245,0.2358490566037736,0.018867924528301886,0.0,Off-Peak,Wednesday,January
2024-01-24 04:00:00,57,270,4,0,331,143,126,5,0,274,24.6,94,2,14.6,605,False,4,200,396,9,0,2024-01-24,False,False,False,0.6545454545454545,0.3305785123966942,0.01487603305785124,0.0,Off-Peak,Wednesday,January
2024-01-24 05:00:00,29,134,4,0,167,196,172,4,0,372,24.4,95,3,12.8,539,False,5,225,306,8,0,2024-01-24,False,False,False,0.5677179962894249,0.4174397031539889,0.014842300556586271,0.0,Shoulder,Wednesday,January
2024-01-24 06:00:00,90,421,5,0,516,187,165,4,0,356,24.4,94,3,14.8,872,False,6,277,586,9,0,2024-01-24,False,False,False,0.6720183486238532,0.3176605504587156,0.010321100917431193,0.0,Shoulder,Wednesday,January
2024-01-24 07:00:00,135,635,4,0,774,164,143,4,0,311,24.4,94,3,14.3,1085,False,7,299,778,8,0,2024-01-24,False,False,False,0.7170506912442396,0.27557603686635945,0.007373271889400922,0.0,Peak,Wednesday,January
2024-01-24 08:00:00,81,383,4,0,468,132,115,4,0,251,24.8,92,3,14.0,719,False,8,213,498,8,0,2024-01-24,False,False,False,0.6926286509040334,0.29624478442280944,0.011126564673157162,0.0,Peak,Wednesday,January
2024-01-24 09:00:00,107,513,4,0,624,177,156,5,0,338,26.0,91,3,15.8,962,False,9,284,669,9,0,2024-01-24,False,False,False,0.6954261954261954,0.29521829521829523,0.009355509355509356,0.0,Shoulder,Wednesday,January
2024-01-24 10:00:00,97,456,4,0,557,155,137,5,0,297,27.1,85,3,19.4,854,False,10,252,593,9,0,2024-01-24,False,False,False,0.6943793911007026,0.29508196721311475,0.01053864168618267,0.0,Shoulder,Wednesday,January
2024-01-24 11:00:00,122,576,4,0,702,42,36,4,0,82,28.3,81,51,14.8,784,False,11,164,612,8,0,2024-01-24,False,False,False,0.7806122448979592,0.20918367346938777,0.01020408163265306,0.0,Peak,Wednesday,January
2024-01-24 12:00:00,74,349,4,0,427,166,146,5,0,317,27.5,85,53,9.2,744,False,12,240,495,9,0,2024-01-24,False,False,False,0.6653225806451613,0.3225806451612903,0.012096774193548387,0.0,Peak,Wednesday,January
2024-01-24 13:00:00,37,166,5,0,208,107,95,6,0,208,28.0,83,53,4.6,416,False,13,144,261,11,0,2024-01-24,False,False,False,0.6274038461538461,0.34615384615384615,0.026442307692307692,0.0,Peak,Wednesday,January
2024-01-24 14:00:00,66,308,4,0,378,73,64,4,0,141,25.2,93,65,9.2,519,False,14,139,372,8,0,2024-01-24,False,False,False,0.7167630057803468,0.2678227360308285,0.015414258188824663,0.0,Peak,Wednesday,January
2024-01-24 15:00:00,72,345,4,0,421,63,55,4,0,122,25.3,93,53,5.4,543,False,15,135,400,8,0,2024-01-24,False,False,False,0.7366482504604052,0.24861878453038674,0.014732965009208104,0.0,Peak,Wednesday,January
2024-01-24 16:00:00,70,330,4,0,404,35,32,4,0,71,26.4,86,51,15.6,475,False,16,105,362,8,0,2024-01-24,False,False,False,0.7621052631578947,0.22105263157894736,0.016842105263157894,0.0,Peak,Wednesday,January
2024-01-24 17:00:00,66,311,4,0,381,97,83,5,0,185,26.3,87,51,14.1,566,False,17,163,394,9,0,2024-01-24,False,False,False,0.696113074204947,0.2879858657243816,0.015901060070671377,0.0,Peak,Wednesday,January
2024-01-24 18:00:00,102,485,4,0,591,87,77,4,0,168,26.8,84,51,12.2,759,False,18,189,562,8,0,2024-01-24,False,False,False,0.7404479578392622,0.2490118577075099,0.010540184453227932,0.0,Peak,Wednesday,January
2024-01-24 19:00:00,53,236,4,0,293,104,92,6,0,202,26.5,86,3,13.0,495,False,19,157,328,10,0,2024-01-24,False,False,False,0.6626262626262627,0.31717171717171716,0.020202020202020204,0.0,Peak,Wednesday,January
2024-01-24 20:00:00,116,540,4,0,660,141,124,6,0,271,25.7,88,3,13.2,931,False,20,257,664,10,0,2024-01-24,False,False,False,0.7132116004296455,0.27604726100966703,0.010741138560687433,0.0,Shoulder,Wednesday,January
2024-01-24 21:00:00,67,300,5,0,372,110,98,6,0,214,25.1,93,3,16.3,586,False,21,177,398,11,0,2024-01-24,False,False,False,0.6791808873720137,0.30204778156996587,0.01877133105802048,0.0,Shoulder,Wednesday,January
2024-01-24 22:00:00,67,295,5,0,367,46,41,5,0,92,25.0,92,3,16.5,459,False,22,113,336,10,0,2024-01-24,False,False,False,0.7320261437908496,0.24618736383442266,0.02178649237472767,0.0,Shoulder,Wednesday,January
2024-01-24 23:00:00,66,301,4,0,371,74,64,6,0,144,24.9,93,3,13.9,515,False,23,140,365,10,0,2024-01-24,False,False,False,0.7087378640776699,0.27184466019417475,0.019417475728155338,0.0,Shoulder,Wednesday,January
2024-01-25 00:00:00,93,359,2,0,454,79,92,4,0,175,24.8,93,51,16.1,629,False,0,172,451,6,0,2024-01-25,False,True,False,0.7170111287758346,0.27344992050874406,0.009538950715421303,0.0,Off-Peak,Thursday,January
2024-01-25 01:00:00,42,148,4,0,194,44,50,4,0,98,24.5,94,51,15.5,292,False,1,86,198,8,0,2024-01-25,False,True,False,0.678082191780822,0.2945205479452055,0.0273972602739726,0.0,Off-Peak,Thursday,January
2024-01-25 02:00:00,42,155,3,0,200,140,162,6,0,308,24.3,95,51,16.6,508,False,2,182,317,9,0,2024-01-25,False,True,False,0.6240157480314961,0.35826771653543305,0.017716535433070866,0.0,Off-Peak,Thursday,January
2024-01-25 03:00:00,51,189,3,0,243,136,156,5,0,297,24.3,94,51,19.0,540,False,3,187,345,8,0,2024-01-25,False,True,False,0.6388888888888888,0.34629629629629627,0.014814814814814815,0.0,Off-Peak,Thursday,January
2024-01-25 04:00:00,148,578,3,0,729,51,59,5,0,115,24.3,94,3,17.8,844,False,4,199,637,8,0,2024-01-25,False,True,False,0.754739336492891,0.235781990521327,0.009478672985781991,0.0,Off-Peak,Thursday,January
2024-01-25 05:00:00,103,391,3,0,497,111,127,5,0,243,24.3,93,3,17.9,740,False,5,214,518,8,0,2024-01-25,False,True,False,0.7,0.2891891891891892,0.010810810810810811,0.0,Shoulder,Thursday,January
2024-01-25 06:00:00,169,654,4,0,827,100,116,4,0,220,24.3,92,3,17.3,1047,False,6,269,770,8,0,2024-01-25,False,True,False,0.7354345749761223,0.25692454632282713,0.007640878701050621,0.0,Shoulder,Thursday,January
2024-01-25 07:00:00,28,95,3,0,126,86,99,4,0,189,24.3,92,3,16.8,315,False,7,114,194,7,0,2024-01-25,False,True,False,0.6158730158730159,0.3619047619047619,0.022222222222222223,0.0,Peak,Thursday,January
2024-01-25 08:00:00,82,317,3,0,402,58,68,4,0,130,24.3,92,3,17.3,532,False,8,140,385,7,0,2024-01-25,False,True,False,0.7236842105263158,0.2631578947368421,0.013157894736842105,0.0,Peak,Thursday,January
2024-01-25 09:00:00,130,527,3,0,660,145,171,5,0,321,24.9,97,63,9.6,981,False,9,275,698,8,0,2024-01-25,False,True,False,0.7115188583078491,0.2803261977573904,0.00815494393476045,0.0,Shoulder,Thursday,January
2024-01-25 10:00:00,78,295,3,0,376,128,150,7,0,285,24.7,94,65,5.6,661,False,10,206,445,10,0,2024-01-25,False,True,False,0.6732223903177005,0.31164901664145234,0.015128593040847202,0.0,Shoulder,Thursday,January
2024-01-25 11:00:00,94,368,3,0,465,153,178,7,0,338,25.0,93,53,4.4,803,False,11,247,546,10,0,2024-01-25,False,True,False,0.6799501867995019,0.30759651307596514,0.012453300124533,0.0,Peak,Thursday,January
2024-01-25 12:00:00,111,421,3,0,535,219,256,7,0,482,27.0,87,53,9.6,1017,False,12,330,677,10,0,2024-01-25,False,True,False,0.6656833824975418,0.32448377581120946,0.00983284169124877,0.0,Peak,Thursday,January
2024-01-25 13:00:00,52,197,3,0,252,54,64,5,0,123,27.8,84,51,15.3,375,False,13,106,261,8,0,2024-01-25,False,True,False,0.696,0.2826666666666667,0.021333333333333333,0.0,Peak,Thursday,January
2024-01-25 14:00:00,140,529,3,0,672,121,142,5,0,268,27.9,82,53,11.5,940,False,14,261,671,8,0,2024-01-25,False,True,False,0.7138297872340426,0.2776595744680851,0.00851063829787234,0.0,Peak,Thursday,January
2024-01-25 15:00:00,173,671,3,0,847,84,99,5,0,188,28.9,78,51,11.8,1035,False,15,257,770,8,0,2024-01-25,False,True,False,0.7439613526570048,0.24830917874396136,0.007729468599033816,0.0,Peak,Thursday,January
2024-01-25 16:00:00,107,413,4,0,524,43,52,5,0,100,28.4,78,51,12.0,624,False,16,150,465,9,0,2024-01-25,False,True,False,0.7451923076923077,0.2403846153846154,0.014423076923076924,0.0,Peak,Thursday,January
2024-01-25 17:00:00,137,513,3,0,653,210,244,6,0,460,28.3,77,51,12.0,1113,False,17,347,757,9,0,2024-01-25,False,True,False,0.6801437556154537,0.31176999101527403,0.008086253369272238,0.0,Peak,Thursday,January
2024-01-25 18:00:00,115,436,3,0,554,38,43,5,0,86,27.3,81,55,14.6,640,False,18,153,479,8,0,2024-01-25,False,True,False,0.7484375,0.2390625,0.0125,0.0,Peak,Thursday,January
2024-01-25 19:00:00,123,473,3,0,599,202,234,7,0,443,26.2,86,3,17.3,1042,False,19,325,707,10,0,2024-01-25,False,True,False,0.6785028790786948,0.31190019193857965,0.009596928982725527,0.0,Peak,Thursday,January
2024-01-25 20:00:00,107,399,3,0,509,58,68,6,0,132,25.3,89,3,12.0,641,False,20,165,467,9,0,2024-01-25,False,True,False,0.7285491419656787,0.2574102964118565,0.014040561622464899,0.0,Shoulder,Thursday,January
2024-01-25 21:00:00,28,117,3,0,148,98,114,6,0,218,25.0,95,55,16.7,366,False,21,126,231,9,0,2024-01-25,False,True,False,0.6311475409836066,0.3442622950819672,0.02459016393442623,0.0,Shoulder,Thursday,January
2024-01-25 22:00:00,55,209,3,0,267,104,120,8,0,232,24.2,95,61,19.1,499,False,22,159,329,11,0,2024-01-25,False,True,False,0.6593186372745491,0.3186372745490982,0.022044088176352707,0.0,Shoulder,Thursday,January
2024-01-25 23:00:00,44,160,3,0,207,268,312,8,0,588,24.0,94,63,14.3,795,False,23,312,472,11,0,2024-01-25,False,True,False,0.5937106918238994,0.39245283018867927,0.013836477987421384,0.0,Shoulder,Thursday,January
2024-01-26 00:00:00,29,128,2,0,159,91,176,4,0,271,23.8,94,61,18.9,430,False,0,120,304,6,0,2024-01-26,False,False,False,0.7069767441860465,0.27906976744186046,0.013953488372093023,0.0,Off-Peak,Friday,January
2024-01-26 01:00:00,128,555,3,0,686,72,137,4,0,213,23.5,95,55,16.1,899,False,1,200,692,7,0,2024-01-26,False,False,False,0.7697441601779755,0.22246941045606228,0.00778642936596218,0.0,Off-Peak,Friday,January
2024-01-26 02:00:00,27,124,3,0,154,93,179,5,0,277,23.4,95,51,17.9,431,False,2,120,303,8,0,2024-01-26,False,False,False,0.703016241299304,0.27842227378190254,0.018561484918793503,0.0,Off-Peak,Friday,January
2024-01-26 03:00:00,63,276,3,0,342,78,150,4,0,232,23.5,96,53,17.6,574,False,3,141,426,7,0,2024-01-26,False,False,False,0.7421602787456446,0.2456445993031359,0.012195121951219513,0.0,Off-Peak,Friday,January
2024-01-26 04:00:00,79,340,4,0,423,86,162,4,0,252,23.5,96,53,17.4,675,False,4,165,502,8,0,2024-01-26,False,False,False,0.7437037037037038,0.24444444444444444,0.011851851851851851,0.0,Off-Peak,Friday,January
2024-01-26 05:00:00,135,589,3,0,727,30,57,4,0,91,23.6,95,53,18.2,818,False,5,165,646,7,0,2024-01-26,False,False,False,0.7897310513447433,0.2017114914425428,0.008557457212713936,0.0,Shoulder,Friday,January
2024-01-26 06:00:00,104,452,3,0,559,20,43,4,0,67,23.6,95,55,18.6,626,False,6,124,495,7,0,2024-01-26,False,False,False,0.7907348242811502,0.19808306709265175,0.011182108626198083,0.0,Shoulder,Friday,January
2024-01-26 07:00:00,109,470,3,0,582,88,169,4,0,261,23.5,95,53,16.3,843,False,7,197,639,7,0,2024-01-26,False,False,False,0.7580071174377224,0.23368920521945433,0.00830367734282325,0.0,Peak,Friday,January
2024-01-26 08:00:00,77,332,3,0,412,25,49,4,0,78,23.7,94,51,16.6,490,False,8,102,381,7,0,2024-01-26,False,False,False,0.7775510204081633,0.20816326530612245,0.014285714285714285,0.0,Peak,Friday,January
2024-01-26 09:00:00,43,188,3,0,234,33,60,5,0,98,26.1,88,55,21.9,332,False,9,76,248,8,0,2024-01-26,False,False,False,0.7469879518072289,0.2289156626506024,0.024096385542168676,0.0,Shoulder,Friday,January
2024-01-26 10:00:00,105,460,3,0,568,67,131,4,0,202,25.8,90,51,20.1,770,False,10,172,591,7,0,2024-01-26,False,False,False,0.7675324675324675,0.22337662337662337,0.00909090909090909,0.0,Shoulder,Friday,January
2024-01-26 11:00:00,33,146,3,0,182,38,70,5,0,113,25.9,88,53,16.1,295,False,11,71,216,8,0,2024-01-26,False,False,False,0.7322033898305085,0.24067796610169492,0.02711864406779661,0.0,Peak,Friday,January
2024-01-26 12:00:00,136,587,3,0,726,51,100,4,0,155,26.2,85,51,23.0,881,False,12,187,687,7,0,2024-01-26,False,False,False,0.7797956867196367,0.2122587968217934,0.007945516458569807,0.0,Peak,Friday,January
2024-01-26 13:00:00,89,383,4,0,476,83,156,4,0,243,27.4,81,51,18.9,719,False,13,172,539,8,0,2024-01-26,False,False,False,0.7496522948539638,0.23922114047287898,0.011126564673157162,0.0,Peak,Friday,January
2024-01-26 14:00:00,103,441,4,0,548,27,50,4,0,81,28.4,75,51,22.4,629,False,14,130,491,8,0,2024-01-26,False,False,False,0.78060413354531,0.2066772655007949,0.012718600953895072,0.0,Peak,Friday,January
2024-01-26 15:00:00,105,454,4,0,563,90,172,4,0,266,29.3,71,51,22.4,829,False,15,195,626,8,0,2024-01-26,False,False,False,0.7551266586248492,0.23522316043425814,0.009650180940892641,0.0,Peak,Friday,January
2024-01-26 16:00:00,34,143,4,0,181,66,126,4,0,196,29.8,69,51,21.7,377,False,16,100,269,8,0,2024-01-26,False,False,False,0.713527851458886,0.26525198938992045,0.021220159151193633,0.0,Peak,Friday,January
2024-01-26 17:00:00,39,167,5,0,211,18,38,4,0,60,29.3,71,3,18.9,271,False,17,57,205,9,0,2024-01-26,False,False,False,0.7564575645756457,0.21033210332103322,0.033210332103321034,0.0,Peak,Friday,January
2024-01-26 18:00:00,120,512,5,0,637,25,44,5,0,74,28.3,75,3,14.8,711,False,18,145,556,10,0,2024-01-26,False,False,False,0.7819971870604782,0.2039381153305204,0.014064697609001406,0.0,Peak,Friday,January
2024-01-26 19:00:00,146,632,4,0,782,83,159,6,0,248,27.4,80,3,13.0,1030,False,19,229,791,10,0,2024-01-26,False,False,False,0.7679611650485437,0.22233009708737864,0.009708737864077669,0.0,Peak,Friday,January
2024-01-26 20:00:00,95,403,4,0,502,59,107,5,0,171,26.9,82,3,14.1,673,False,20,154,510,9,0,2024-01-26,False,False,False,0.7578008915304606,0.2288261515601783,0.01337295690936107,0.0,Shoulder,Friday,January
2024-01-26 21:00:00,84,363,4,0,451,32,62,4,0,98,27.0,80,1,15.3,549,False,21,116,425,8,0,2024-01-26,False,False,False,0.7741347905282332,0.21129326047358835,0.014571948998178506,0.0,Shoulder,Friday,January
2024-01-26 22:00:00,53,223,4,0,280,25,48,4,0,77,26.6,83,1,19.9,357,False,22,78,271,8,0,2024-01-26,False,False,False,0.7591036414565826,0.2184873949579832,0.022408963585434174,0.0,Shoulder,Friday,January
2024-01-26 23:00:00,139,584,5,0,728,76,142,7,0,225,25.9,85,1,20.4,953,False,23,215,726,12,0,2024-01-26,False,False,False,0.7618048268625394,0.22560335781741866,0.012591815320041973,0.0,Shoulder,Friday,January
2024-01-27 00:00:00,66,308,3,0,377,52,49,3,0,104,25.4,87,3,20.9,481,True,0,118,357,6,0,2024-01-27,False,False,False,0.7422037422037422,0.24532224532224534,0.012474012474012475,0.0,Off-Peak,Saturday,January
2024-01-27 01:00:00,133,621,3,0,757,147,136,3,0,286,25.1,87,3,22.8,1043,True,1,280,757,6,0,2024-01-27,False,False,False,0.725790987535954,0.2684563758389262,0.005752636625119847,0.0,Off-Peak,Saturday,January
2024-01-27 02:00:00,137,641,3,0,781,85,80,4,0,169,24.9,87,3,23.0,950,True,2,222,721,7,0,2024-01-27,False,False,False,0.7589473684210526,0.2336842105263158,0.007368421052631579,0.0,Off-Peak,Saturday,January
2024-01-27 03:00:00,95,443,3,0,541,186,175,4,0,365,24.7,88,2,20.3,906,True,3,281,618,7,0,2024-01-27,False,False,False,0.6821192052980133,0.31015452538631344,0.00772626931567329,0.0,Off-Peak,Saturday,January
2024-01-27 04:00:00,45,205,3,0,253,57,52,4,0,113,24.5,88,2,15.6,366,True,4,102,257,7,0,2024-01-27,False,False,False,0.7021857923497268,0.2786885245901639,0.01912568306010929,0.0,Off-Peak,Saturday,January
2024-01-27 05:00:00,39,184,3,0,226,61,58,4,0,123,24.2,89,3,15.3,349,True,5,100,242,7,0,2024-01-27,False,False,False,0.6934097421203438,0.28653295128939826,0.02005730659025788,0.0,Shoulder,Saturday,January
2024-01-27 06:00:00,124,583,3,0,710,100,94,4,0,198,24.1,89,1,13.9,908,True,6,224,677,7,0,2024-01-27,False,False,False,0.7455947136563876,0.24669603524229075,0.007709251101321586,0.0,Shoulder,Saturday,January
2024-01-27 07:00:00,86,406,3,0,495,57,54,5,0,116,23.9,90,1,13.9,611,True,7,143,460,8,0,2024-01-27,False,False,False,0.7528641571194763,0.23404255319148937,0.01309328968903437,0.0,Peak,Saturday,January
2024-01-27 08:00:00,102,477,3,0,582,126,119,4,0,249,24.1,90,0,13.5,831,True,8,228,596,7,0,2024-01-27,False,False,False,0.717208182912154,0.2743682310469314,0.00842358604091456,0.0,Peak,Saturday,January
2024-01-27 09:00:00,40,185,3,0,228,78,73,4,0,155,26.7,82,1,17.1,383,True,9,118,258,7,0,2024-01-27,False,False,False,0.6736292428198434,0.30809399477806787,0.018276762402088774,0.0,Shoulder,Saturday,January
2024-01-27 10:00:00,76,346,4,0,426,173,160,4,0,337,28.0,76,3,25.5,763,True,10,249,506,8,0,2024-01-27,False,False,False,0.6631716906946264,0.32634338138925295,0.010484927916120577,0.0,Shoulder,Saturday,January
2024-01-27 11:00:00,74,339,4,0,417,84,78,5,0,167,29.1,71,2,21.9,584,True,11,158,417,9,0,2024-01-27,False,False,False,0.714041095890411,0.2705479452054795,0.015410958904109588,0.0,Peak,Saturday,January
2024-01-27 12:00:00,30,143,3,0,176,145,137,4,0,286,30.1,68,51,18.1,462,True,12,175,280,7,0,2024-01-27,False,False,False,0.6060606060606061,0.3787878787878788,0.015151515151515152,0.0,Peak,Saturday,January
2024-01-27 13:00:00,117,538,4,1,660,63,58,4,0,125,30.7,65,1,19.2,785,True,13,180,596,8,1,2024-01-27,False,False,False,0.759235668789809,0.22929936305732485,0.01019108280254777,0.0012738853503184713,Peak,Saturday,January
2024-01-27 14:00:00,105,475,3,0,583,189,179,4,0,372,30.6,69,51,17.3,955,True,14,294,654,7,0,2024-01-27,False,False,False,0.6848167539267016,0.3078534031413613,0.007329842931937173,0.0,Peak,Saturday,January
2024-01-27 15:00:00,61,280,3,0,344,125,118,4,0,247,31.2,65,1,17.8,591,True,15,186,398,7,0,2024-01-27,False,False,False,0.6734348561759729,0.3147208121827411,0.011844331641285956,0.0,Peak,Saturday,January
2024-01-27 16:00:00,108,499,3,0,610,77,71,4,0,152,29.9,70,53,19.1,762,True,16,185,570,7,0,2024-01-27,False,False,False,0.7480314960629921,0.24278215223097113,0.009186351706036745,0.0,Peak,Saturday,January
2024-01-27 17:00:00,118,551,3,0,672,107,99,4,0,210,29.5,71,3,18.9,882,True,17,225,650,7,0,2024-01-27,False,False,False,0.7369614512471655,0.25510204081632654,0.007936507936507936,0.0,Peak,Saturday,January
2024-01-27 18:00:00,109,501,3,0,613,72,67,4,0,143,29.2,69,51,18.3,756,True,18,181,568,7,0,2024-01-27,False,False,False,0.7513227513227513,0.23941798941798942,0.009259259259259259,0.0,Peak,Saturday,January
2024-01-27 19:00:00,31,136,3,0,170,83,78,4,0,165,28.3,74,3,14.0,335,True,19,114,214,7,0,2024-01-27,False,False,False,0.6388059701492538,0.3402985074626866,0.020895522388059702,0.0,Peak,Saturday,January
2024-01-27 20:00:00,19,83,4,1,107,96,91,4,0,191,27.5,77,3,14.8,298,True,20,115,174,8,1,2024-01-27,False,False,False,0.5838926174496645,0.3859060402684564,0.026845637583892617,0.003355704697986577,Shoulder,Saturday,January
2024-01-27 21:00:00,79,370,4,1,454,108,101,5,0,214,26.9,80,3,16.1,668,True,21,187,471,9,1,2024-01-27,False,False,False,0.7050898203592815,0.27994011976047906,0.01347305389221557,0.0014970059880239522,Shoulder,Saturday,January
2024-01-27 22:00:00,95,428,4,1,528,89,84,4,1,178,26.3,84,3,16.6,706,True,22,184,512,8,2,2024-01-27,False,False,False,0.7252124645892352,0.26062322946175637,0.0113314447592068,0.0028328611898017,Shoulder,Saturday,January
2024-01-27 23:00:00,110,505,4,1,620,85,79,5,2,171,26.1,86,3,17.9,791,True,23,195,584,9,3,2024-01-27,False,False,False,0.7383059418457648,0.24652338811630847,0.011378002528445006,0.0037926675094816687,Shoulder,Saturday,January
2024-01-28 00:00:00,138,704,2,0,844,124,154,1,0,279,25.5,87,3,19.0,1123,True,0,262,858,3,0,2024-01-28,False,False,False,0.7640249332146037,0.23330365093499555,0.0026714158504007124,0.0,Off-Peak,Sunday,January
2024-01-28 01:00:00,48,247,2,0,297,85,104,2,0,191,24.9,88,1,17.7,488,True,1,133,351,4,0,2024-01-28,False,False,False,0.7192622950819673,0.2725409836065574,0.00819672131147541,0.0,Off-Peak,Sunday,January
2024-01-28 02:00:00,70,369,2,0,441,75,94,2,0,171,24.6,88,0,16.8,612,True,2,145,463,4,0,2024-01-28,False,False,False,0.7565359477124183,0.2369281045751634,0.006535947712418301,0.0,Off-Peak,Sunday,January
2024-01-28 03:00:00,133,681,2,0,816,44,57,4,1,106,24.3,89,0,15.6,922,True,3,177,738,6,1,2024-01-28,False,False,False,0.8004338394793926,0.19197396963123645,0.006507592190889371,0.0010845986984815619,Off-Peak,Sunday,January
2024-01-28 04:00:00,131,683,3,0,817,24,30,2,0,56,24.2,88,3,15.1,873,True,4,155,713,5,0,2024-01-28,False,False,False,0.8167239404352806,0.1775486827033219,0.0057273768613974796,0.0,Off-Peak,Sunday,January
2024-01-28 05:00:00,45,232,2,0,279,118,145,2,0,265,24.0,89,3,13.0,544,True,5,163,377,4,0,2024-01-28,False,False,False,0.6930147058823529,0.29963235294117646,0.007352941176470588,0.0,Shoulder,Sunday,January
2024-01-28 06:00:00,106,548,2,0,656,104,129,2,0,235,23.8,90,3,13.3,891,True,6,210,677,4,0,2024-01-28,False,False,False,0.7598204264870931,0.2356902356902357,0.004489337822671156,0.0,Shoulder,Sunday,January
2024-01-28 07:00:00,85,430,2,0,517,99,123,3,0,225,23.7,90,3,12.9,742,True,7,184,553,5,0,2024-01-28,False,False,False,0.7452830188679245,0.24797843665768193,0.006738544474393531,0.0,Peak,Sunday,January
2024-01-28 08:00:00,65,330,2,0,397,103,126,2,0,231,23.9,90,3,14.1,628,True,8,168,456,4,0,2024-01-28,False,False,False,0.7261146496815286,0.267515923566879,0.006369426751592357,0.0,Peak,Sunday,January
2024-01-28 09:00:00,73,390,2,0,465,23,30,2,0,55,26.3,82,0,16.6,520,True,9,96,420,4,0,2024-01-28,False,False,False,0.8076923076923077,0.18461538461538463,0.007692307692307693,0.0,Shoulder,Sunday,January
2024-01-28 10:00:00,60,307,2,0,369,78,97,2,0,177,27.6,76,1,22.0,546,True,10,138,404,4,0,2024-01-28,False,False,False,0.73992673992674,0.25274725274725274,0.007326007326007326,0.0,Shoulder,Sunday,January
2024-01-28 11:00:00,45,227,2,0,274,80,99,2,0,181,28.6,72,0,21.3,455,True,11,125,326,4,0,2024-01-28,False,False,False,0.7164835164835165,0.27472527472527475,0.008791208791208791,0.0,Peak,Sunday,January
2024-01-28 12:00:00,60,294,2,0,356,95,118,2,0,215,29.7,68,51,20.2,571,True,12,155,412,4,0,2024-01-28,False,False,False,0.7215411558669002,0.2714535901926445,0.0070052539404553416,0.0,Peak,Sunday,January
2024-01-28 13:00:00,61,318,3,0,382,119,148,2,0,269,30.3,66,51,19.4,651,True,13,180,466,5,0,2024-01-28,False,False,False,0.7158218125960062,0.2764976958525346,0.007680491551459293,0.0,Peak,Sunday,January
2024-01-28 14:00:00,112,584,3,1,700,102,127,2,0,231,29.8,68,53,19.5,931,True,14,214,711,5,1,2024-01-28,False,False,False,0.7636949516648764,0.22986036519871106,0.0053705692803437165,0.0010741138560687433,Peak,Sunday,January
2024-01-28 15:00:00,57,290,3,1,351,116,143,2,0,261,30.1,70,53,15.9,612,True,15,173,433,5,1,2024-01-28,False,False,False,0.7075163398692811,0.2826797385620915,0.008169934640522876,0.0016339869281045752,Peak,Sunday,January
2024-01-28 16:00:00,77,404,3,1,485,99,123,2,1,225,30.3,68,51,17.1,710,True,16,176,527,5,2,2024-01-28,False,False,False,0.7422535211267606,0.24788732394366197,0.007042253521126761,0.0028169014084507044,Peak,Sunday,January
2024-01-28 17:00:00,61,324,3,1,389,22,27,2,1,52,28.4,75,51,14.0,441,True,17,83,351,5,2,2024-01-28,False,False,False,0.7959183673469388,0.18820861678004536,0.011337868480725623,0.0045351473922902496,Peak,Sunday,January
2024-01-28 18:00:00,106,535,3,1,645,100,124,2,1,227,28.6,74,3,14.8,872,True,18,206,659,5,2,2024-01-28,False,False,False,0.7557339449541285,0.23623853211009174,0.005733944954128441,0.0022935779816513763,Peak,Sunday,January
2024-01-28 19:00:00,96,485,4,1,586,48,59,3,1,111,27.8,75,3,16.0,697,True,19,144,544,7,2,2024-01-28,False,False,False,0.7804878048780488,0.2065997130559541,0.010043041606886656,0.0028694404591104736,Peak,Sunday,January
2024-01-28 20:00:00,47,242,3,1,293,116,142,3,1,262,26.9,78,3,15.0,555,True,20,163,384,6,2,2024-01-28,False,False,False,0.6918918918918919,0.2936936936936937,0.010810810810810811,0.0036036036036036037,Shoulder,Sunday,January
2024-01-28 21:00:00,69,355,4,2,430,69,87,3,1,160,26.5,81,3,15.8,590,True,21,138,442,7,3,2024-01-28,False,False,False,0.7491525423728813,0.23389830508474577,0.011864406779661017,0.005084745762711864,Shoulder,Sunday,January
2024-01-28 22:00:00,115,588,3,1,707,81,101,3,1,186,26.1,84,3,16.1,893,True,22,196,689,6,2,2024-01-28,False,False,False,0.7715565509518477,0.21948488241881298,0.006718924972004479,0.0022396416573348264,Shoulder,Sunday,January
2024-01-28 23:00:00,63,308,3,1,375,51,63,3,1,118,25.7,86,3,15.3,493,True,23,114,371,6,2,2024-01-28,False,False,False,0.7525354969574036,0.23123732251521298,0.012170385395537525,0.004056795131845842,Shoulder,Sunday,January
2024-01-29 00:00:00,74,427,0,0,501,66,136,0,0,202,25.3,87,3,15.4,703,False,0,140,563,0,0,2024-01-29,False,False,False,0.8008534850640113,0.19914651493598862,0.0,0.0,Off-Peak,Monday,January
2024-01-29 01:00:00,63,338,0,0,401,79,166,2,0,247,24.9,88,3,14.4,648,False,1,142,504,2,0,2024-01-29,False,False,False,0.7777777777777778,0.2191358024691358,0.0030864197530864196,0.0,Off-Peak,Monday,January
2024-01-29 02:00:00,17,101,0,0,118,46,95,1,0,142,24.4,90,3,14.8,260,False,2,63,196,1,0,2024-01-29,False,False,False,0.7538461538461538,0.2423076923076923,0.0038461538461538464,0.0,Off-Peak,Monday,January
2024-01-29 03:00:00,83,463,2,0,548,48,99,1,0,148,24.1,91,3,16.8,696,False,3,131,562,3,0,2024-01-29,False,False,False,0.8074712643678161,0.1882183908045977,0.004310344827586207,0.0,Off-Peak,Monday,January
2024-01-29 04:00:00,23,138,1,0,162,90,189,1,0,280,24.0,91,3,17.9,442,False,4,113,327,2,0,2024-01-29,False,False,False,0.7398190045248869,0.25565610859728505,0.004524886877828055,0.0,Off-Peak,Monday,January
2024-01-29 05:00:00,58,319,1,0,378,16,35,1,0,52,23.9,90,3,16.9,430,False,5,74,354,2,0,2024-01-29,False,False,False,0.8232558139534883,0.17209302325581396,0.004651162790697674,0.0,Shoulder,Monday,January
2024-01-29 06:00:00,33,191,1,0,225,90,186,1,0,277,23.7,91,3,16.1,502,False,6,123,377,2,0,2024-01-29,False,False,False,0.750996015936255,0.2450199203187251,0.00398406374501992,0.0,Shoulder,Monday,January
2024-01-29 07:00:00,57,320,1,0,378,34,71,1,0,106,23.5,91,3,15.6,484,False,7,91,391,2,0,2024-01-29,False,False,False,0.8078512396694215,0.18801652892561985,0.004132231404958678,0.0,Peak,Monday,January
2024-01-29 08:00:00,71,412,1,0,484,51,108,1,0,160,23.7,91,3,15.4,644,False,8,122,520,2,0,2024-01-29,False,False,False,0.8074534161490683,0.18944099378881987,0.003105590062111801,0.0,Peak,Monday,January
2024-01-29 09:00:00,58,316,1,0,375,61,126,1,0,188,26.1,86,3,17.4,563,False,9,119,442,2,0,2024-01-29,False,False,False,0.7850799289520426,0.2113676731793961,0.003552397868561279,0.0,Shoulder,Monday,January
2024-01-29 10:00:00,40,222,1,0,263,33,69,1,0,103,27.8,77,3,21.9,366,False,10,73,291,2,0,2024-01-29,False,False,False,0.7950819672131147,0.1994535519125683,0.00546448087431694,0.0,Shoulder,Monday,January
2024-01-29 11:00:00,39,228,1,0,268,18,38,1,0,57,28.9,73,3,20.1,325,False,11,57,266,2,0,2024-01-29,False,False,False,0.8184615384615385,0.1753846153846154,0.006153846153846154,0.0,Peak,Monday,January
2024-01-29 12:00:00,64,357,1,0,422,60,127,1,0,188,30.0,69,1,19.4,610,False,12,124,484,2,0,2024-01-29,False,False,False,0.7934426229508197,0.20327868852459016,0.003278688524590164,0.0,Peak,Monday,January
2024-01-29 13:00:00,106,602,1,0,709,90,187,1,0,278,29.1,69,53,21.8,987,False,13,196,789,2,0,2024-01-29,False,False,False,0.7993920972644377,0.19858156028368795,0.002026342451874367,0.0,Peak,Monday,January
2024-01-29 14:00:00,49,281,1,0,331,84,174,1,0,259,30.0,71,53,16.7,590,False,14,133,455,2,0,2024-01-29,False,False,False,0.7711864406779662,0.22542372881355932,0.003389830508474576,0.0,Peak,Monday,January
2024-01-29 15:00:00,105,578,1,0,684,57,118,1,0,176,29.4,69,51,16.9,860,False,15,162,696,2,0,2024-01-29,False,False,False,0.8093023255813954,0.1883720930232558,0.002325581395348837,0.0,Peak,Monday,January
2024-01-29 16:00:00,21,123,1,0,145,83,176,1,0,260,28.5,74,55,18.4,405,False,16,104,299,2,0,2024-01-29,False,False,False,0.7382716049382716,0.25679012345679014,0.0049382716049382715,0.0,Peak,Monday,January
2024-01-29 17:00:00,97,527,1,0,625,45,93,1,0,139,29.4,72,51,14.5,764,False,17,142,620,2,0,2024-01-29,False,False,False,0.8115183246073299,0.18586387434554974,0.002617801047120419,0.0,Peak,Monday,January
2024-01-29 18:00:00,47,255,1,0,303,68,140,1,0,209,28.7,69,51,17.3,512,False,18,115,395,2,0,2024-01-29,False,False,False,0.771484375,0.224609375,0.00390625,0.0,Peak,Monday,January
2024-01-29 19:00:00,73,396,1,0,470,57,120,1,0,178,27.3,79,1,13.6,648,False,19,130,516,2,0,2024-01-29,False,False,False,0.7962962962962963,0.2006172839506173,0.0030864197530864196,0.0,Peak,Monday,January
2024-01-29 20:00:00,87,479,1,0,567,23,49,1,0,73,26.3,81,1,12.8,640,False,20,110,528,2,0,2024-01-29,False,False,False,0.825,0.171875,0.003125,0.0,Shoulder,Monday,January
2024-01-29 21:00:00,71,384,1,0,456,65,134,1,0,200,26.3,81,0,10.6,656,False,21,136,518,2,0,2024-01-29,False,False,False,0.7896341463414634,0.2073170731707317,0.003048780487804878,0.0,Shoulder,Monday,January
2024-01-29 22:00:00,61,341,1,0,403,15,29,1,0,45,25.8,84,0,11.5,448,False,22,76,370,2,0,2024-01-29,False,False,False,0.8258928571428571,0.16964285714285715,0.004464285714285714,0.0,Shoulder,Monday,January
2024-01-29 23:00:00,29,154,1,0,184,53,105,1,0,159,25.4,85,0,14.1,343,False,23,82,259,2,0,2024-01-29,False,False,False,0.7551020408163265,0.239067055393586,0.0058309037900874635,0.0,Shoulder,Monday,January
2024-01-30 00:00:00,41,204,1,0,246,51,78,2,0,131,25.0,87,0,15.2,377,False,0,92,282,3,0,2024-01-30,False,False,False,0.7480106100795756,0.2440318302387268,0.007957559681697613,0.0,Off-Peak,Tuesday,January
2024-01-30 01:00:00,73,354,1,0,428,98,147,2,0,247,24.6,88,0,14.4,675,False,1,171,501,3,0,2024-01-30,False,False,False,0.7422222222222222,0.25333333333333335,0.0044444444444444444,0.0,Off-Peak,Tuesday,January
2024-01-30 02:00:00,100,485,2,0,587,37,58,2,0,97,24.2,90,2,14.1,684,False,2,137,543,4,0,2024-01-30,False,False,False,0.793859649122807,0.20029239766081872,0.005847953216374269,0.0,Off-Peak,Tuesday,January
2024-01-30 03:00:00,76,368,2,0,446,54,78,2,0,134,24.0,90,2,13.8,580,False,3,130,446,4,0,2024-01-30,False,False,False,0.7689655172413793,0.22413793103448276,0.006896551724137931,0.0,Off-Peak,Tuesday,January
2024-01-30 04:00:00,100,503,2,0,605,75,114,2,0,191,23.9,90,2,14.6,796,False,4,175,617,4,0,2024-01-30,False,False,False,0.7751256281407035,0.2198492462311558,0.005025125628140704,0.0,Off-Peak,Tuesday,January
2024-01-30 05:00:00,27,142,2,0,171,96,143,2,0,241,23.7,90,0,14.6,412,False,5,123,285,4,0,2024-01-30,False,False,False,0.691747572815534,0.29854368932038833,0.009708737864077669,0.0,Shoulder,Tuesday,January
2024-01-30 06:00:00,117,572,2,0,691,71,108,2,0,181,23.6,90,0,13.9,872,False,6,188,680,4,0,2024-01-30,False,False,False,0.7798165137614679,0.21559633027522937,0.0045871559633027525,0.0,Shoulder,Tuesday,January
2024-01-30 07:00:00,30,153,2,0,185,71,108,2,0,181,23.4,91,0,12.5,366,False,7,101,261,4,0,2024-01-30,False,False,False,0.7131147540983607,0.27595628415300544,0.01092896174863388,0.0,Peak,Tuesday,January
2024-01-30 08:00:00,106,523,2,0,631,97,147,2,0,246,23.5,92,1,12.2,877,False,8,203,670,4,0,2024-01-30,False,False,False,0.7639680729760547,0.2314709236031927,0.004561003420752566,0.0,Peak,Tuesday,January
2024-01-30 09:00:00,106,515,3,0,624,116,172,2,0,290,26.0,86,3,13.5,914,False,9,222,687,5,0,2024-01-30,False,False,False,0.7516411378555798,0.24288840262582057,0.005470459518599562,0.0,Shoulder,Tuesday,January
2024-01-30 10:00:00,87,429,2,0,518,24,35,2,0,61,27.7,79,1,15.3,579,False,10,111,464,4,0,2024-01-30,False,False,False,0.8013816925734024,0.19170984455958548,0.0069084628670120895,0.0,Shoulder,Tuesday,January
2024-01-30 11:00:00,78,387,2,0,467,120,178,2,0,300,29.4,71,0,18.0,767,False,11,198,565,4,0,2024-01-30,False,False,False,0.7366362451108214,0.258148631029987,0.005215123859191656,0.0,Peak,Tuesday,January
2024-01-30 12:00:00,48,236,2,0,286,30,44,2,0,76,30.8,66,0,16.4,362,False,12,78,280,4,0,2024-01-30,False,False,False,0.7734806629834254,0.2154696132596685,0.011049723756906077,0.0,Peak,Tuesday,January
2024-01-30 13:00:00,49,247,2,0,298,29,44,3,0,76,30.9,63,51,17.1,374,False,13,78,291,5,0,2024-01-30,False,False,False,0.7780748663101604,0.20855614973262032,0.013368983957219251,0.0,Peak,Tuesday,January
2024-01-30 14:00:00,39,170,2,0,211,113,170,2,0,285,28.4,77,61,13.5,496,False,14,152,340,4,0,2024-01-30,False,False,False,0.6854838709677419,0.3064516129032258,0.008064516129032258,0.0,Peak,Tuesday,January
2024-01-30 15:00:00,92,453,2,0,547,81,118,3,0,202,30.5,69,51,11.3,749,False,15,173,571,5,0,2024-01-30,False,False,False,0.7623497997329773,0.23097463284379172,0.006675567423230975,0.0,Peak,Tuesday,January
2024-01-30 16:00:00,118,563,2,0,683,70,101,2,0,173,28.1,76,61,15.0,856,False,16,188,664,4,0,2024-01-30,False,False,False,0.7757009345794392,0.21962616822429906,0.004672897196261682,0.0,Peak,Tuesday,January
2024-01-30 17:00:00,88,423,2,0,513,100,147,2,0,249,28.9,75,53,6.4,762,False,17,188,570,4,0,2024-01-30,False,False,False,0.7480314960629921,0.24671916010498687,0.005249343832020997,0.0,Peak,Tuesday,January
2024-01-30 18:00:00,94,460,2,0,556,53,78,2,0,133,28.8,71,51,13.2,689,False,18,147,538,4,0,2024-01-30,False,False,False,0.7808417997097242,0.21335268505079827,0.005805515239477504,0.0,Peak,Tuesday,January
2024-01-30 19:00:00,80,390,2,0,472,48,69,2,0,119,26.9,82,53,12.2,591,False,19,128,459,4,0,2024-01-30,False,False,False,0.7766497461928934,0.21658206429780033,0.00676818950930626,0.0,Peak,Tuesday,January
2024-01-30 20:00:00,26,110,3,0,139,30,45,2,0,77,26.2,84,3,10.5,216,False,20,56,155,5,0,2024-01-30,False,False,False,0.7175925925925926,0.25925925925925924,0.023148148148148147,0.0,Shoulder,Tuesday,January
2024-01-30 21:00:00,79,374,2,0,455,129,191,2,0,322,26.6,90,51,5.6,777,False,21,208,565,4,0,2024-01-30,False,False,False,0.7271557271557272,0.2676962676962677,0.005148005148005148,0.0,Shoulder,Tuesday,January
2024-01-30 22:00:00,69,334,2,0,405,81,121,2,0,204,26.4,87,51,11.2,609,False,22,150,455,4,0,2024-01-30,False,False,False,0.7471264367816092,0.24630541871921183,0.006568144499178982,0.0,Shoulder,Tuesday,January
2024-01-30 23:00:00,73,337,2,0,412,43,63,2,0,108,25.7,89,0,12.9,520,False,23,116,400,4,0,2024-01-30,False,False,False,0.7692307692307693,0.2230769230769231,0.007692307692307693,0.0,Shoulder,Tuesday,January
2024-01-31 00:00:00,20,56,0,0,76,56,85,0,0,141,25.0,90,0,12.7,217,False,0,76,141,0,0,2024-01-31,False,False,False,0.6497695852534562,0.35023041474654376,0.0,0.0,Off-Peak,Wednesday,January
2024-01-31 01:00:00,82,249,0,0,331,148,225,0,0,373,24.6,91,0,12.5,704,False,1,230,474,0,0,2024-01-31,False,False,False,0.6732954545454546,0.32670454545454547,0.0,0.0,Off-Peak,Wednesday,January
2024-01-31 02:00:00,63,191,0,0,254,177,264,0,0,441,24.3,92,0,13.0,695,False,2,240,455,0,0,2024-01-31,False,False,False,0.6546762589928058,0.34532374100719426,0.0,0.0,Off-Peak,Wednesday,January
2024-01-31 03:00:00,40,119,0,0,159,63,96,0,0,159,24.1,93,0,13.7,318,False,3,103,215,0,0,2024-01-31,False,False,False,0.6761006289308176,0.3238993710691824,0.0,0.0,Off-Peak,Wednesday,January
2024-01-31 04:00:00,75,232,0,0,307,82,122,0,0,204,23.9,92,2,13.6,511,False,4,157,354,0,0,2024-01-31,False,False,False,0.6927592954990215,0.30724070450097846,0.0,0.0,Off-Peak,Wednesday,January
2024-01-31 05:00:00,33,101,0,0,134,146,215,0,0,361,23.7,92,3,14.1,495,False,5,179,316,0,0,2024-01-31,False,False,False,0.6383838383838384,0.3616161616161616,0.0,0.0,Shoulder,Wednesday,January
2024-01-31 06:00:00,15,42,0,0,57,143,213,0,0,356,23.6,92,3,14.2,413,False,6,158,255,0,0,2024-01-31,False,False,False,0.6174334140435835,0.38256658595641646,0.0,0.0,Shoulder,Wednesday,January
2024-01-31 07:00:00,28,88,0,0,116,149,221,0,0,370,23.2,94,3,12.1,486,False,7,177,309,0,0,2024-01-31,False,False,False,0.6358024691358025,0.36419753086419754,0.0,0.0,Peak,Wednesday,January
2024-01-31 08:00:00,78,233,0,0,311,132,198,0,0,330,23.5,92,3,13.8,641,False,8,210,431,0,0,2024-01-31,False,False,False,0.672386895475819,0.32761310452418096,0.0,0.0,Peak,Wednesday,January
2024-01-31 09:00:00,51,152,0,0,203,101,152,0,0,253,25.5,87,3,12.2,456,False,9,152,304,0,0,2024-01-31,False,False,False,0.6666666666666666,0.3333333333333333,0.0,0.0,Shoulder,Wednesday,January
2024-01-31 10:00:00,54,159,1,0,214,80,119,1,0,200,27.5,77,3,13.7,414,False,10,134,278,2,0,2024-01-31,False,False,False,0.6714975845410628,0.32367149758454106,0.004830917874396135,0.0,Shoulder,Wednesday,January
2024-01-31 11:00:00,24,74,0,0,98,110,165,1,0,276,29.4,69,1,16.9,374,False,11,134,239,1,0,2024-01-31,False,False,False,0.6390374331550802,0.3582887700534759,0.00267379679144385,0.0,Peak,Wednesday,January
2024-01-31 12:00:00,68,204,0,0,272,148,219,1,0,368,30.9,63,3,16.1,640,False,12,216,423,1,0,2024-01-31,False,False,False,0.6609375,0.3375,0.0015625,0.0,Peak,Wednesday,January
2024-01-31 13:00:00,51,159,1,0,211,58,87,2,0,147,30.9,66,3,15.8,358,False,13,109,246,3,0,2024-01-31,False,False,False,0.6871508379888268,0.30446927374301674,0.008379888268156424,0.0,Peak,Wednesday,January
2024-01-31 14:00:00,34,103,1,0,138,61,90,1,0,152,30.2,72,61,10.5,290,False,14,95,193,2,0,2024-01-31,False,False,False,0.6655172413793103,0.3275862068965517,0.006896551724137931,0.0,Peak,Wednesday,January
2024-01-31 15:00:00,15,44,1,0,60,135,199,1,0,335,31.3,65,51,8.7,395,False,15,150,243,2,0,2024-01-31,False,False,False,0.6151898734177215,0.379746835443038,0.005063291139240506,0.0,Peak,Wednesday,January
2024-01-31 16:00:00,55,162,1,0,218,45,67,1,0,113,30.1,66,55,12.2,331,False,16,100,229,2,0,2024-01-31,False,False,False,0.6918429003021148,0.3021148036253776,0.006042296072507553,0.0,Peak,Wednesday,January
2024-01-31 17:00:00,78,233,1,0,312,104,154,1,0,259,28.3,76,51,11.1,571,False,17,182,387,2,0,2024-01-31,False,False,False,0.6777583187390543,0.318739054290718,0.0035026269702276708,0.0,Peak,Wednesday,January
2024-01-31 18:00:00,19,58,1,0,78,68,103,1,0,172,29.0,74,51,10.6,250,False,18,87,161,2,0,2024-01-31,False,False,False,0.644,0.348,0.008,0.0,Peak,Wednesday,January
2024-01-31 19:00:00,50,153,1,0,204,97,143,1,0,241,28.2,76,3,10.2,445,False,19,147,296,2,0,2024-01-31,False,False,False,0.6651685393258427,0.3303370786516854,0.0044943820224719105,0.0,Peak,Wednesday,January
2024-01-31 20:00:00,88,266,1,0,355,47,67,1,0,115,27.5,79,3,8.7,470,False,20,135,333,2,0,2024-01-31,False,False,False,0.7085106382978723,0.2872340425531915,0.00425531914893617,0.0,Shoulder,Wednesday,January
2024-01-31 21:00:00,64,194,1,0,259,163,243,1,0,407,27.1,77,3,7.0,666,False,21,227,437,2,0,2024-01-31,False,False,False,0.6561561561561562,0.3408408408408408,0.003003003003003003,0.0,Shoulder,Wednesday,January
2024-01-31 22:00:00,34,105,1,0,140,89,136,1,0,226,26.6,79,3,8.3,366,False,22,123,241,2,0,2024-01-31,False,False,False,0.6584699453551912,0.3360655737704918,0.00546448087431694,0.0,Shoulder,Wednesday,January
2024-01-31 23:00:00,84,247,1,0,332,63,92,1,0,156,26.2,82,3,9.4,488,False,23,147,339,2,0,2024-01-31,False,False,False,0.694672131147541,0.3012295081967213,0.004098360655737705,0.0,Shoulder,Wednesday,January
2024-02-01 00:00:00,7,52,1,0,60,24,70,7,0,101,25.7,85,3,10.2,161,False,0,31,122,8,0,2024-02-01,False,True,False,0.7577639751552795,0.19254658385093168,0.049689440993788817,0.0,Off-Peak,Thursday,February
2024-02-01 01:00:00,5,33,3,0,41,45,108,9,1,163,25.4,87,3,10.9,204,False,1,50,141,12,1,2024-02-01,False,True,False,0.6911764705882353,0.24509803921568626,0.058823529411764705,0.004901960784313725,Off-Peak,Thursday,February
2024-02-01 02:00:00,11,67,2,0,80,20,144,3,0,167,25.1,88,3,13.7,247,False,2,31,211,5,0,2024-02-01,False,True,False,0.854251012145749,0.12550607287449392,0.020242914979757085,0.0,Off-Peak,Thursday,February
2024-02-01 03:00:00,21,81,2,0,104,50,154,7,1,212,24.9,90,0,15.3,316,False,3,71,235,9,1,2024-02-01,False,True,False,0.7436708860759493,0.22468354430379747,0.028481012658227847,0.0031645569620253164,Off-Peak,Thursday,February
2024-02-01 04:00:00,22,103,3,0,128,52,171,2,0,225,24.6,92,2,13.8,353,False,4,74,274,5,0,2024-02-01,False,True,False,0.7762039660056658,0.2096317280453258,0.014164305949008499,0.0,Off-Peak,Thursday,February
2024-02-01 05:00:00,20,144,1,0,165,77,251,3,1,332,24.4,93,2,13.2,497,False,5,97,395,4,1,2024-02-01,False,True,False,0.7947686116700201,0.19517102615694165,0.008048289738430584,0.002012072434607646,Shoulder,Thursday,February
2024-02-01 06:00:00,29,103,2,0,134,98,200,9,1,308,24.3,93,3,12.8,442,False,6,127,303,11,1,2024-02-01,False,True,False,0.6855203619909502,0.2873303167420814,0.024886877828054297,0.0022624434389140274,Shoulder,Thursday,February
2024-02-01 07:00:00,37,166,1,0,204,54,229,8,0,291,24.2,94,3,12.0,495,False,7,91,395,9,0,2024-02-01,False,True,False,0.797979797979798,0.18383838383838383,0.01818181818181818,0.0,Peak,Thursday,February
2024-02-01 08:00:00,31,192,2,0,225,91,262,3,0,356,24.8,91,3,13.5,581,False,8,122,454,5,0,2024-02-01,False,True,False,0.7814113597246127,0.2099827882960413,0.008605851979345954,0.0,Peak,Thursday,February
2024-02-01 09:00:00,52,286,3,0,341,52,355,4,1,412,27.0,88,51,16.8,753,False,9,104,641,7,1,2024-02-01,False,True,False,0.851261620185923,0.13811420982735723,0.009296148738379814,0.0013280212483399733,Shoulder,Thursday,February
2024-02-01 10:00:00,104,290,1,1,396,65,279,5,2,351,28.0,84,51,14.8,747,False,10,169,569,6,3,2024-02-01,False,True,False,0.7617135207496654,0.22623828647925034,0.008032128514056224,0.004016064257028112,Shoulder,Thursday,February
2024-02-01 11:00:00,78,355,2,0,435,73,268,3,1,345,29.0,78,51,14.1,780,False,11,151,623,5,1,2024-02-01,False,True,False,0.7987179487179488,0.1935897435897436,0.00641025641025641,0.001282051282051282,Peak,Thursday,February
2024-02-01 12:00:00,83,393,4,0,480,79,327,7,1,414,29.9,72,3,14.3,894,False,12,162,720,11,1,2024-02-01,False,True,False,0.8053691275167785,0.18120805369127516,0.012304250559284116,0.0011185682326621924,Peak,Thursday,February
2024-02-01 13:00:00,78,548,2,0,628,85,263,2,0,350,31.1,69,51,13.2,978,False,13,163,811,4,0,2024-02-01,False,True,False,0.8292433537832311,0.16666666666666666,0.00408997955010225,0.0,Peak,Thursday,February
2024-02-01 14:00:00,63,502,2,0,567,158,607,5,3,773,28.9,74,63,17.1,1340,False,14,221,1109,7,3,2024-02-01,False,True,False,0.8276119402985075,0.16492537313432837,0.0052238805970149255,0.002238805970149254,Peak,Thursday,February
2024-02-01 15:00:00,44,534,1,1,580,151,417,0,1,569,29.1,76,51,10.3,1149,False,15,195,951,1,2,2024-02-01,False,True,False,0.8276762402088773,0.16971279373368145,0.0008703220191470844,0.0017406440382941688,Peak,Thursday,February
2024-02-01 16:00:00,99,402,1,1,503,201,474,6,1,682,30.1,71,3,12.6,1185,False,16,300,876,7,2,2024-02-01,False,True,False,0.739240506329114,0.25316455696202533,0.00590717299578059,0.0016877637130801688,Peak,Thursday,February
2024-02-01 17:00:00,181,514,4,0,699,161,437,2,1,601,28.1,79,53,12.7,1300,False,17,342,951,6,1,2024-02-01,False,True,False,0.7315384615384616,0.2630769230769231,0.004615384615384616,0.0007692307692307692,Peak,Thursday,February
2024-02-01 18:00:00,66,611,4,1,682,179,548,8,3,738,27.5,82,3,11.2,1420,False,18,245,1159,12,4,2024-02-01,False,True,True,0.8161971830985916,0.17253521126760563,0.008450704225352112,0.0028169014084507044,Peak,Thursday,February
2024-02-01 19:00:00,78,425,2,0,505,163,463,2,4,632,27.0,84,3,9.5,1137,False,19,241,888,4,4,2024-02-01,False,True,False,0.7810026385224275,0.2119613016710642,0.003518029903254178,0.003518029903254178,Peak,Thursday,February
2024-02-01 20:00:00,66,532,3,0,601,128,349,2,5,484,26.4,87,3,10.8,1085,False,20,194,881,5,5,2024-02-01,False,True,False,0.8119815668202764,0.17880184331797236,0.004608294930875576,0.004608294930875576,Shoulder,Thursday,February
2024-02-01 21:00:00,33,566,1,2,602,152,389,21,4,566,26.0,93,53,8.2,1168,False,21,185,955,22,6,2024-02-01,False,True,False,0.8176369863013698,0.1583904109589041,0.018835616438356163,0.005136986301369863,Shoulder,Thursday,February
2024-02-01 22:00:00,38,423,3,3,467,108,339,15,3,465,25.9,94,3,10.9,932,False,22,146,762,18,6,2024-02-01,False,True,False,0.8175965665236051,0.15665236051502146,0.019313304721030045,0.006437768240343348,Shoulder,Thursday,February
2024-02-01 23:00:00,33,161,4,0,198,92,379,9,1,481,25.4,94,3,10.3,679,False,23,125,540,13,1,2024-02-01,False,True,False,0.7952871870397643,0.18409425625920472,0.01914580265095729,0.0014727540500736377,Shoulder,Thursday,February
2024-02-02 00:00:00,5,71,3,0,79,7,177,1,1,186,25.1,94,3,7.7,265,False,0,12,248,4,1,2024-02-02,False,False,False,0.9358490566037736,0.045283018867924525,0.01509433962264151,0.0037735849056603774,Off-Peak,Friday,February
2024-02-02 01:00:00,6,112,1,0,119,8,177,6,0,191,25.0,94,3,9.7,310,False,1,14,289,7,0,2024-02-02,False,False,False,0.932258064516129,0.04516129032258064,0.02258064516129032,0.0,Off-Peak,Friday,February
2024-02-02 02:00:00,5,235,1,0,241,10,224,16,1,251,24.9,94,3,10.7,492,False,2,15,459,17,1,2024-02-02,False,False,False,0.9329268292682927,0.03048780487804878,0.034552845528455285,0.0020325203252032522,Off-Peak,Friday,February
2024-02-02 03:00:00,16,241,3,0,260,22,234,14,1,271,24.8,93,3,12.2,531,False,3,38,475,17,1,2024-02-02,False,False,False,0.8945386064030132,0.07156308851224105,0.032015065913371,0.0018832391713747645,Off-Peak,Friday,February
2024-02-02 04:00:00,20,268,3,0,291,56,279,15,1,351,24.6,92,3,12.5,642,False,4,76,547,18,1,2024-02-02,False,False,False,0.8520249221183801,0.11838006230529595,0.028037383177570093,0.001557632398753894,Off-Peak,Friday,February
2024-02-02 05:00:00,22,283,2,1,308,71,206,14,1,292,24.4,93,3,11.5,600,False,5,93,489,16,2,2024-02-02,False,False,False,0.815,0.155,0.02666666666666667,0.0033333333333333335,Shoulder,Friday,February
2024-02-02 06:00:00,14,285,2,0,301,55,259,10,0,324,24.2,94,3,11.3,625,False,6,69,544,12,0,2024-02-02,False,False,False,0.8704,0.1104,0.0192,0.0,Shoulder,Friday,February
2024-02-02 07:00:00,21,316,0,0,337,58,202,15,0,275,24.1,95,3,11.8,612,False,7,79,518,15,0,2024-02-02,False,False,False,0.8464052287581699,0.12908496732026145,0.024509803921568627,0.0,Peak,Friday,February
2024-02-02 08:00:00,33,500,5,1,539,79,366,4,1,450,24.3,95,3,11.8,989,False,8,112,866,9,2,2024-02-02,False,False,False,0.8756319514661274,0.11324570273003033,0.00910010111223458,0.0020222446916076846,Peak,Friday,February
2024-02-02 09:00:00,49,424,5,1,479,133,549,9,1,692,26.8,87,3,10.8,1171,False,9,182,973,14,2,2024-02-02,False,False,False,0.8309137489325363,0.15542271562766866,0.011955593509820665,0.0017079419299743809,Shoulder,Friday,February
2024-02-02 10:00:00,64,619,2,0,685,129,642,9,1,781,28.3,80,3,13.6,1466,False,10,193,1261,11,1,2024-02-02,False,False,True,0.8601637107776262,0.13165075034106413,0.007503410641200546,0.0006821282401091405,Shoulder,Friday,February
2024-02-02 11:00:00,73,794,2,2,871,102,691,11,1,805,29.1,71,3,15.9,1676,False,11,175,1485,13,3,2024-02-02,False,False,True,0.886038186157518,0.10441527446300716,0.007756563245823389,0.0017899761336515514,Peak,Friday,February
2024-02-02 12:00:00,86,800,1,0,887,159,676,8,0,843,29.8,68,3,16.8,1730,False,12,245,1476,9,0,2024-02-02,False,False,True,0.8531791907514451,0.1416184971098266,0.005202312138728324,0.0,Peak,Friday,February
2024-02-02 13:00:00,96,372,4,0,472,185,779,13,1,978,29.9,64,3,16.8,1450,False,13,281,1151,17,1,2024-02-02,False,False,True,0.7937931034482759,0.19379310344827586,0.011724137931034483,0.000689655172413793,Peak,Friday,February
2024-02-02 14:00:00,87,292,2,1,382,185,834,10,0,1029,30.7,61,3,15.1,1411,False,14,272,1126,12,1,2024-02-02,False,False,True,0.7980155917788803,0.1927710843373494,0.008504606661941885,0.0007087172218284905,Peak,Friday,February
2024-02-02 15:00:00,77,353,3,2,435,227,697,9,0,933,31.3,62,3,11.8,1368,False,15,304,1050,12,2,2024-02-02,False,False,False,0.7675438596491229,0.2222222222222222,0.008771929824561403,0.0014619883040935672,Peak,Friday,February
2024-02-02 16:00:00,87,597,3,0,687,228,734,7,0,969,31.3,63,51,9.7,1656,False,16,315,1331,10,0,2024-02-02,False,False,True,0.803743961352657,0.19021739130434784,0.006038647342995169,0.0,Peak,Friday,February
2024-02-02 17:00:00,91,760,2,0,853,271,1074,4,3,1352,27.4,81,63,12.0,2205,False,17,362,1834,6,3,2024-02-02,False,False,True,0.8317460317460318,0.16417233560090702,0.0027210884353741495,0.0013605442176870747,Peak,Friday,February
2024-02-02 18:00:00,51,980,0,1,1032,230,730,2,0,962,26.8,84,61,4.8,1994,False,18,281,1710,2,1,2024-02-02,False,False,True,0.8575727181544633,0.14092276830491474,0.0010030090270812437,0.0005015045135406219,Peak,Friday,February
2024-02-02 19:00:00,39,685,7,1,732,251,575,3,2,831,27.2,87,3,5.5,1563,False,19,290,1260,10,3,2024-02-02,False,False,True,0.8061420345489443,0.1855406269993602,0.006397952655150352,0.0019193857965451055,Peak,Friday,February
2024-02-02 20:00:00,32,555,6,4,597,189,211,3,1,404,26.5,90,3,8.3,1001,False,20,221,766,9,5,2024-02-02,False,False,False,0.7652347652347652,0.22077922077922077,0.008991008991008992,0.004995004995004995,Shoulder,Friday,February
2024-02-02 21:00:00,34,521,0,1,556,196,194,8,2,400,26.0,94,53,4.2,956,False,21,230,715,8,3,2024-02-02,False,False,False,0.747907949790795,0.2405857740585774,0.008368200836820083,0.0031380753138075313,Shoulder,Friday,February
2024-02-02 22:00:00,27,353,7,2,389,179,174,13,1,367,24.8,91,61,11.6,756,False,22,206,527,20,3,2024-02-02,False,False,False,0.6970899470899471,0.2724867724867725,0.026455026455026454,0.003968253968253968,Shoulder,Friday,February
2024-02-02 23:00:00,22,368,4,0,394,163,100,14,5,282,24.1,96,61,5.9,676,False,23,185,468,18,5,2024-02-02,False,False,False,0.6923076923076923,0.27366863905325445,0.026627218934911243,0.0073964497041420114,Shoulder,Friday,February
2024-02-03 00:00:00,26,168,1,0,195,22,103,7,0,132,24.1,97,51,6.4,327,True,0,48,271,8,0,2024-02-03,False,False,False,0.8287461773700305,0.14678899082568808,0.024464831804281346,0.0,Off-Peak,Saturday,February
2024-02-03 01:00:00,24,184,2,0,210,36,182,1,1,220,24.0,98,51,2.4,430,True,1,60,366,3,1,2024-02-03,False,False,False,0.8511627906976744,0.13953488372093023,0.0069767441860465115,0.002325581395348837,Off-Peak,Saturday,February
2024-02-03 02:00:00,5,159,3,0,167,40,200,9,0,249,23.8,99,3,2.7,416,True,2,45,359,12,0,2024-02-03,False,False,False,0.8629807692307693,0.10817307692307693,0.028846153846153848,0.0,Off-Peak,Saturday,February
2024-02-03 03:00:00,13,128,1,0,142,36,217,5,2,260,24.1,96,3,3.8,402,True,3,49,345,6,2,2024-02-03,False,False,False,0.8582089552238806,0.12189054726368159,0.014925373134328358,0.004975124378109453,Off-Peak,Saturday,February
2024-02-03 04:00:00,26,106,3,0,135,31,174,8,0,213,24.0,97,3,4.7,348,True,4,57,280,11,0,2024-02-03,False,False,False,0.8045977011494253,0.16379310344827586,0.031609195402298854,0.0,Off-Peak,Saturday,February
2024-02-03 05:00:00,17,184,1,1,203,41,220,13,1,275,24.2,96,3,7.6,478,True,5,58,404,14,2,2024-02-03,False,False,False,0.8451882845188284,0.12133891213389121,0.029288702928870293,0.0041841004184100415,Shoulder,Saturday,February
2024-02-03 06:00:00,15,241,1,0,257,37,237,11,0,285,24.0,97,3,5.4,542,True,6,52,478,12,0,2024-02-03,False,False,False,0.8819188191881919,0.0959409594095941,0.02214022140221402,0.0,Shoulder,Saturday,February
2024-02-03 07:00:00,38,284,3,0,325,52,251,9,2,314,23.7,98,3,6.4,639,True,7,90,535,12,2,2024-02-03,False,False,False,0.837245696400626,0.14084507042253522,0.018779342723004695,0.003129890453834116,Peak,Saturday,February
2024-02-03 08:00:00,45,321,0,1,367,53,261,9,0,323,23.8,98,3,5.4,690,True,8,98,582,9,1,2024-02-03,False,False,False,0.8434782608695652,0.14202898550724638,0.013043478260869565,0.0014492753623188406,Peak,Saturday,February
2024-02-03 09:00:00,57,398,1,0,456,46,296,6,1,349,26.4,90,3,8.7,805,True,9,103,694,7,1,2024-02-03,False,False,False,0.8621118012422361,0.12795031055900621,0.008695652173913044,0.0012422360248447205,Shoulder,Saturday,February
2024-02-03 10:00:00,77,317,0,0,394,137,355,3,1,496,28.1,83,3,10.5,890,True,10,214,672,3,1,2024-02-03,False,False,False,0.755056179775281,0.24044943820224718,0.0033707865168539327,0.0011235955056179776,Shoulder,Saturday,February
2024-02-03 11:00:00,91,418,2,0,511,132,304,7,1,444,28.8,78,51,7.8,955,True,11,223,722,9,1,2024-02-03,False,False,False,0.7560209424083769,0.23350785340314137,0.009424083769633508,0.0010471204188481676,Peak,Saturday,February
2024-02-03 12:00:00,93,492,4,1,590,247,458,1,0,706,28.8,78,51,1.3,1296,True,12,340,950,5,1,2024-02-03,False,False,False,0.7330246913580247,0.2623456790123457,0.0038580246913580245,0.0007716049382716049,Peak,Saturday,February
2024-02-03 13:00:00,47,767,0,0,814,325,451,9,1,786,28.2,81,63,4.2,1600,True,13,372,1218,9,1,2024-02-03,False,False,True,0.76125,0.2325,0.005625,0.000625,Peak,Saturday,February
2024-02-03 14:00:00,57,773,2,1,833,121,496,5,1,623,27.4,83,51,14.0,1456,True,14,178,1269,7,2,2024-02-03,False,False,True,0.8715659340659341,0.12225274725274725,0.004807692307692308,0.0013736263736263737,Peak,Saturday,February
2024-02-03 15:00:00,78,555,5,1,639,173,712,6,0,891,26.9,86,55,10.5,1530,True,15,251,1267,11,1,2024-02-03,False,False,True,0.8281045751633986,0.16405228758169935,0.00718954248366013,0.00065359477124183,Peak,Saturday,February
2024-02-03 16:00:00,69,597,3,0,669,277,673,5,0,955,27.4,81,53,10.2,1624,True,16,346,1270,8,0,2024-02-03,False,False,True,0.7820197044334976,0.21305418719211822,0.0049261083743842365,0.0,Peak,Saturday,February
2024-02-03 17:00:00,84,672,3,0,759,329,748,2,0,1079,28.9,77,3,9.9,1838,True,17,413,1420,5,0,2024-02-03,False,False,True,0.7725788900979326,0.22470076169749728,0.002720348204570185,0.0,Peak,Saturday,February
2024-02-03 18:00:00,63,617,4,1,685,207,609,5,0,821,28.8,77,3,8.5,1506,True,18,270,1226,9,1,2024-02-03,False,False,True,0.8140770252324038,0.17928286852589642,0.00597609561752988,0.0006640106241699867,Peak,Saturday,February
2024-02-03 19:00:00,57,416,3,1,477,202,578,5,3,788,28.2,81,3,5.6,1265,True,19,259,994,8,4,2024-02-03,False,False,False,0.7857707509881423,0.20474308300395258,0.006324110671936759,0.0031620553359683794,Peak,Saturday,February
2024-02-03 20:00:00,37,325,1,3,366,165,596,7,0,768,27.0,87,53,6.9,1134,True,20,202,921,8,3,2024-02-03,False,False,False,0.8121693121693122,0.1781305114638448,0.007054673721340388,0.0026455026455026454,Shoulder,Saturday,February
2024-02-03 21:00:00,40,416,4,1,461,274,333,4,1,612,24.4,97,63,13.7,1073,True,21,314,749,8,2,2024-02-03,False,False,False,0.6980428704566636,0.29263746505125815,0.007455731593662628,0.001863932898415657,Shoulder,Saturday,February
2024-02-03 22:00:00,35,342,1,1,379,124,401,3,3,531,24.1,97,51,11.9,910,True,22,159,743,4,4,2024-02-03,False,False,False,0.8164835164835165,0.17472527472527472,0.004395604395604396,0.004395604395604396,Shoulder,Saturday,February
2024-02-03 23:00:00,38,353,3,1,395,167,378,5,3,553,23.8,98,63,8.3,948,True,23,205,731,8,4,2024-02-03,False,False,False,0.7710970464135021,0.21624472573839662,0.008438818565400843,0.004219409282700422,Shoulder,Saturday,February
2024-02-04 00:00:00,28,127,4,0,159,26,171,6,0,203,23.9,96,65,7.3,362,True,0,54,298,10,0,2024-02-04,False,False,False,0.8232044198895028,0.14917127071823205,0.027624309392265192,0.0,Off-Peak,Sunday,February
2024-02-04 01:00:00,20,111,0,0,131,24,201,3,0,228,23.9,97,63,7.0,359,True,1,44,312,3,0,2024-02-04,False,False,False,0.8690807799442897,0.12256267409470752,0.008356545961002786,0.0,Off-Peak,Sunday,February
2024-02-04 02:00:00,21,123,2,0,146,19,223,5,0,247,23.6,97,53,12.0,393,True,2,40,346,7,0,2024-02-04,False,False,False,0.8804071246819338,0.10178117048346055,0.017811704834605598,0.0,Off-Peak,Sunday,February
2024-02-04 03:00:00,13,182,1,1,197,23,117,4,0,144,23.4,96,3,8.3,341,True,3,36,299,5,1,2024-02-04,False,False,False,0.8768328445747801,0.10557184750733138,0.01466275659824047,0.002932551319648094,Off-Peak,Sunday,February
2024-02-04 04:00:00,29,156,1,0,186,36,149,9,1,195,23.3,96,3,6.0,381,True,4,65,305,10,1,2024-02-04,False,False,False,0.800524934383202,0.17060367454068243,0.026246719160104987,0.0026246719160104987,Off-Peak,Sunday,February
2024-02-04 05:00:00,31,231,3,0,265,27,130,1,0,158,23.5,95,3,9.4,423,True,5,58,361,4,0,2024-02-04,False,False,False,0.8534278959810875,0.13711583924349882,0.009456264775413711,0.0,Shoulder,Sunday,February
2024-02-04 06:00:00,48,291,1,0,340,32,181,3,1,217,23.6,94,3,12.0,557,True,6,80,472,4,1,2024-02-04,False,False,False,0.8473967684021544,0.1436265709156194,0.00718132854578097,0.0017953321364452424,Shoulder,Sunday,February
2024-02-04 07:00:00,62,293,1,0,356,38,238,7,1,284,23.7,94,3,11.5,640,True,7,100,531,8,1,2024-02-04,False,False,False,0.8296875,0.15625,0.0125,0.0015625,Peak,Sunday,February
2024-02-04 08:00:00,50,229,1,0,280,63,357,9,0,429,23.9,94,3,13.3,709,True,8,113,586,10,0,2024-02-04,False,False,False,0.8265162200282088,0.15937940761636107,0.014104372355430184,0.0,Peak,Sunday,February
2024-02-04 09:00:00,48,284,2,0,334,90,503,7,0,600,26.4,88,3,14.1,934,True,9,138,787,9,0,2024-02-04,False,False,False,0.8426124197002142,0.14775160599571735,0.009635974304068522,0.0,Shoulder,Sunday,February
2024-02-04 10:00:00,51,434,1,0,486,74,393,6,0,473,27.6,85,3,13.1,959,True,10,125,827,7,0,2024-02-04,False,False,False,0.862356621480709,0.13034410844629823,0.0072992700729927005,0.0,Shoulder,Sunday,February
2024-02-04 11:00:00,57,406,0,1,464,83,448,4,1,536,29.1,77,3,10.3,1000,True,11,140,854,4,2,2024-02-04,False,False,False,0.854,0.14,0.004,0.002,Peak,Sunday,February
2024-02-04 12:00:00,66,579,0,0,645,74,575,5,1,655,30.2,73,51,7.9,1300,True,12,140,1154,5,1,2024-02-04,False,False,False,0.8876923076923077,0.1076923076923077,0.0038461538461538464,0.0007692307692307692,Peak,Sunday,February
2024-02-04 13:00:00,89,816,0,2,907,90,714,3,1,808,30.8,71,51,6.6,1715,True,13,179,1530,3,3,2024-02-04,False,False,True,0.892128279883382,0.1043731778425656,0.001749271137026239,0.001749271137026239,Peak,Sunday,February
2024-02-04 14:00:00,97,709,4,0,810,219,668,5,1,893,30.8,70,51,8.5,1703,True,14,316,1377,9,1,2024-02-04,False,False,True,0.8085731062830299,0.18555490311215503,0.005284791544333529,0.0005871990604815032,Peak,Sunday,February
2024-02-04 15:00:00,40,697,4,0,741,102,454,3,0,559,30.4,74,51,10.1,1300,True,15,142,1151,7,0,2024-02-04,False,False,False,0.8853846153846154,0.10923076923076923,0.005384615384615384,0.0,Peak,Sunday,February
2024-02-04 16:00:00,56,611,1,1,669,341,522,3,0,866,30.2,75,53,10.8,1535,True,16,397,1133,4,1,2024-02-04,False,False,True,0.7381107491856678,0.2586319218241042,0.0026058631921824105,0.0006514657980456026,Peak,Sunday,February
2024-02-04 17:00:00,78,738,2,1,819,333,537,7,3,880,29.6,79,3,12.6,1699,True,17,411,1275,9,4,2024-02-04,False,False,True,0.7504414361389052,0.24190700412007063,0.00529723366686286,0.002354326074161271,Peak,Sunday,February
2024-02-04 18:00:00,38,723,6,1,768,303,630,4,1,938,29.3,80,3,12.3,1706,True,18,341,1353,10,2,2024-02-04,False,False,True,0.7930832356389215,0.19988276670574442,0.005861664712778429,0.0011723329425556857,Peak,Sunday,February
2024-02-04 19:00:00,39,576,0,0,615,153,560,6,1,720,28.7,82,3,13.1,1335,True,19,192,1136,6,1,2024-02-04,False,False,False,0.850936329588015,0.14382022471910114,0.0044943820224719105,0.000749063670411985,Peak,Sunday,February
2024-02-04 20:00:00,23,369,4,0,396,154,460,4,1,619,27.8,85,51,7.7,1015,True,20,177,829,8,1,2024-02-04,False,False,False,0.8167487684729065,0.17438423645320197,0.007881773399014778,0.0009852216748768472,Shoulder,Sunday,February
2024-02-04 21:00:00,31,342,1,2,376,180,524,6,0,710,25.8,93,1,10.5,1086,True,21,211,866,7,2,2024-02-04,False,False,False,0.7974217311233885,0.19429097605893186,0.006445672191528545,0.001841620626151013,Shoulder,Sunday,February
2024-02-04 22:00:00,26,253,4,0,283,325,359,6,7,697,25.5,94,1,6.2,980,True,22,351,612,10,7,2024-02-04,False,False,False,0.6244897959183674,0.35816326530612247,0.01020408163265306,0.007142857142857143,Shoulder,Sunday,February
2024-02-04 23:00:00,12,220,1,0,233,285,386,2,3,676,25.3,96,2,9.5,909,True,23,297,606,3,3,2024-02-04,False,False,False,0.6666666666666666,0.32673267326732675,0.0033003300330033004,0.0033003300330033004,Shoulder,Sunday,February
2024-02-05 00:00:00,37,70,0,0,107,39,85,2,2,128,25.4,94,1,9.8,235,False,0,76,155,2,2,2024-02-05,False,False,False,0.6595744680851063,0.32340425531914896,0.00851063829787234,0.00851063829787234,Off-Peak,Monday,February
2024-02-05 01:00:00,21,25,1,0,47,29,59,0,0,88,25.7,89,0,11.4,135,False,1,50,84,1,0,2024-02-05,False,False,False,0.6222222222222222,0.37037037037037035,0.007407407407407408,0.0,Off-Peak,Monday,February
2024-02-05 02:00:00,15,52,3,0,70,18,29,4,1,52,25.2,88,1,10.3,122,False,2,33,81,7,1,2024-02-05,False,False,False,0.6639344262295082,0.27049180327868855,0.05737704918032787,0.00819672131147541,Off-Peak,Monday,February
2024-02-05 03:00:00,10,201,3,2,216,2,43,11,1,57,24.7,88,1,10.5,273,False,3,12,244,14,3,2024-02-05,False,False,False,0.8937728937728938,0.04395604395604396,0.05128205128205128,0.01098901098901099,Off-Peak,Monday,February
2024-02-05 04:00:00,12,167,1,1,181,13,84,9,0,106,24.3,89,0,12.1,287,False,4,25,251,10,1,2024-02-05,False,False,False,0.8745644599303136,0.08710801393728224,0.03484320557491289,0.003484320557491289,Off-Peak,Monday,February
2024-02-05 05:00:00,11,207,6,1,225,41,82,14,0,137,24.1,90,0,11.2,362,False,5,52,289,20,1,2024-02-05,False,False,False,0.7983425414364641,0.143646408839779,0.055248618784530384,0.0027624309392265192,Shoulder,Monday,February
2024-02-05 06:00:00,51,219,3,1,274,81,108,8,0,197,23.6,91,3,9.0,471,False,6,132,327,11,1,2024-02-05,False,False,False,0.6942675159235668,0.2802547770700637,0.02335456475583864,0.0021231422505307855,Shoulder,Monday,February
2024-02-05 07:00:00,39,147,6,0,192,79,177,7,0,263,23.3,93,3,7.0,455,False,7,118,324,13,0,2024-02-05,False,False,False,0.7120879120879121,0.25934065934065936,0.02857142857142857,0.0,Peak,Monday,February
2024-02-05 08:00:00,33,506,6,0,545,96,194,23,1,314,23.6,92,3,7.0,859,False,8,129,700,29,1,2024-02-05,False,False,False,0.8149010477299186,0.15017462165308498,0.033760186263096625,0.0011641443538998836,Peak,Monday,February
2024-02-05 09:00:00,45,499,2,0,546,197,156,9,1,363,26.2,86,3,8.9,909,False,9,242,655,11,1,2024-02-05,False,False,False,0.7205720572057206,0.2662266226622662,0.0121012101210121,0.0011001100110011,Shoulder,Monday,February
2024-02-05 10:00:00,43,528,1,0,572,141,504,10,1,656,28.1,79,1,8.7,1228,False,10,184,1032,11,1,2024-02-05,False,False,False,0.8403908794788274,0.1498371335504886,0.008957654723127036,0.0008143322475570033,Shoulder,Monday,February
2024-02-05 11:00:00,40,591,1,1,633,241,677,8,2,928,30.0,68,51,8.0,1561,False,11,281,1268,9,3,2024-02-05,False,False,True,0.8122998078155029,0.1800128122998078,0.005765534913516977,0.0019218449711723255,Peak,Monday,February
2024-02-05 12:00:00,79,540,3,0,622,225,896,11,1,1133,31.1,63,51,6.8,1755,False,12,304,1436,14,1,2024-02-05,False,False,True,0.8182336182336183,0.17321937321937322,0.007977207977207978,0.0005698005698005698,Peak,Monday,February
2024-02-05 13:00:00,74,806,0,0,880,198,1042,7,1,1248,31.1,65,51,6.2,2128,False,13,272,1848,7,1,2024-02-05,False,False,True,0.868421052631579,0.12781954887218044,0.003289473684210526,0.00046992481203007516,Peak,Monday,February
2024-02-05 14:00:00,70,793,1,0,864,144,1063,3,1,1211,31.2,68,3,5.9,2075,False,14,214,1856,4,1,2024-02-05,False,False,True,0.8944578313253012,0.10313253012048193,0.0019277108433734939,0.00048192771084337347,Peak,Monday,February
2024-02-05 15:00:00,66,666,1,1,734,256,986,0,1,1243,30.9,70,3,7.4,1977,False,15,322,1652,1,2,2024-02-05,False,False,True,0.8356095093576126,0.16287303995953464,0.0005058168942842691,0.0010116337885685382,Peak,Monday,February
2024-02-05 16:00:00,74,854,2,0,930,202,894,12,2,1110,29.1,77,53,9.9,2040,False,16,276,1748,14,2,2024-02-05,False,False,True,0.8568627450980392,0.13529411764705881,0.006862745098039216,0.000980392156862745,Peak,Monday,February
2024-02-05 17:00:00,73,741,0,0,814,184,991,11,3,1189,28.0,83,61,9.8,2003,False,17,257,1732,11,3,2024-02-05,False,False,True,0.8647029455816275,0.12830753869196207,0.0054917623564653024,0.0014977533699450823,Peak,Monday,February
2024-02-05 18:00:00,66,843,2,0,911,150,632,1,3,786,28.2,81,51,3.9,1697,False,18,216,1475,3,3,2024-02-05,False,False,True,0.869180907483795,0.12728344136711844,0.0017678255745433118,0.0017678255745433118,Peak,Monday,February
2024-02-05 19:00:00,52,618,2,0,672,265,936,2,0,1203,27.8,82,2,6.3,1875,False,19,317,1554,4,0,2024-02-05,False,False,True,0.8288,0.16906666666666667,0.0021333333333333334,0.0,Peak,Monday,February
2024-02-05 20:00:00,65,247,0,0,312,157,416,4,0,577,27.0,85,2,9.1,889,False,20,222,663,4,0,2024-02-05,False,False,False,0.7457817772778402,0.24971878515185603,0.0044994375703037125,0.0,Shoulder,Monday,February
2024-02-05 21:00:00,49,255,3,2,309,186,252,10,3,451,25.7,90,51,7.1,760,False,21,235,507,13,5,2024-02-05,False,False,False,0.6671052631578948,0.3092105263157895,0.017105263157894738,0.006578947368421052,Shoulder,Monday,February
2024-02-05 22:00:00,57,598,3,0,658,110,262,0,1,373,25.3,92,3,6.6,1031,False,22,167,860,3,1,2024-02-05,False,False,False,0.8341416100872939,0.16197866149369544,0.002909796314258002,0.0009699321047526673,Shoulder,Monday,February
2024-02-05 23:00:00,24,547,3,0,574,142,152,1,4,299,25.1,93,3,9.7,873,False,23,166,699,4,4,2024-02-05,False,False,False,0.8006872852233677,0.19014891179839633,0.004581901489117984,0.004581901489117984,Shoulder,Monday,February
2024-02-06 00:00:00,10,142,1,1,154,86,142,2,1,231,24.6,95,3,4.5,385,False,0,96,284,3,2,2024-02-06,False,False,False,0.7376623376623377,0.24935064935064935,0.007792207792207792,0.005194805194805195,Off-Peak,Tuesday,February
2024-02-06 01:00:00,7,133,10,0,150,34,133,15,0,182,24.3,96,3,4.2,332,False,1,41,266,25,0,2024-02-06,False,False,False,0.8012048192771084,0.12349397590361445,0.07530120481927711,0.0,Off-Peak,Tuesday,February
2024-02-06 02:00:00,1,66,4,1,72,74,66,11,0,151,24.6,94,3,7.7,223,False,2,75,132,15,1,2024-02-06,False,False,False,0.5919282511210763,0.336322869955157,0.06726457399103139,0.004484304932735426,Off-Peak,Tuesday,February
2024-02-06 03:00:00,6,66,2,0,74,9,66,12,0,87,24.8,87,3,8.9,161,False,3,15,132,14,0,2024-02-06,False,False,False,0.8198757763975155,0.09316770186335403,0.08695652173913043,0.0,Off-Peak,Tuesday,February
2024-02-06 04:00:00,2,80,1,0,83,13,80,15,0,108,24.4,89,3,7.7,191,False,4,15,160,16,0,2024-02-06,False,False,False,0.837696335078534,0.07853403141361257,0.08376963350785341,0.0,Off-Peak,Tuesday,February
2024-02-06 05:00:00,16,88,6,0,110,55,88,14,0,157,24.2,91,3,8.2,267,False,5,71,176,20,0,2024-02-06,False,False,False,0.6591760299625468,0.26591760299625467,0.0749063670411985,0.0,Shoulder,Tuesday,February
2024-02-06 06:00:00,74,178,3,0,255,68,178,13,0,259,24.0,93,3,9.6,514,False,6,142,356,16,0,2024-02-06,False,False,False,0.6926070038910506,0.27626459143968873,0.0311284046692607,0.0,Shoulder,Tuesday,February
2024-02-06 07:00:00,108,218,1,1,328,83,218,13,1,315,23.8,94,3,8.4,643,False,7,191,436,14,2,2024-02-06,False,False,False,0.6780715396578538,0.29704510108864696,0.02177293934681182,0.003110419906687403,Peak,Tuesday,February
2024-02-06 08:00:00,83,185,1,1,270,80,185,10,0,275,24.1,93,3,5.9,545,False,8,163,370,11,1,2024-02-06,False,False,False,0.6788990825688074,0.29908256880733947,0.02018348623853211,0.001834862385321101,Peak,Tuesday,February
2024-02-06 09:00:00,28,281,0,0,309,129,281,10,0,420,26.7,82,3,6.4,729,False,9,157,562,10,0,2024-02-06,False,False,False,0.7709190672153635,0.21536351165980797,0.013717421124828532,0.0,Shoulder,Tuesday,February
2024-02-06 10:00:00,48,214,0,0,262,136,214,13,1,364,28.6,78,3,7.9,626,False,10,184,428,13,1,2024-02-06,False,False,False,0.6837060702875399,0.2939297124600639,0.020766773162939296,0.001597444089456869,Shoulder,Tuesday,February
2024-02-06 11:00:00,57,179,2,1,239,108,179,8,1,296,29.5,72,3,7.8,535,False,11,165,358,10,2,2024-02-06,False,False,False,0.6691588785046729,0.308411214953271,0.018691588785046728,0.003738317757009346,Peak,Tuesday,February
2024-02-06 12:00:00,69,1659,0,1,1729,538,1659,4,0,2201,30.9,66,3,6.3,3930,False,12,607,3318,4,1,2024-02-06,False,False,True,0.8442748091603054,0.1544529262086514,0.0010178117048346056,0.0002544529262086514,Peak,Tuesday,February
2024-02-06 13:00:00,68,1312,1,0,1381,429,1312,5,1,1747,32.0,60,51,5.8,3128,False,13,497,2624,6,1,2024-02-06,False,False,True,0.8388746803069054,0.15888746803069054,0.0019181585677749361,0.00031969309462915604,Peak,Tuesday,February
2024-02-06 14:00:00,58,309,2,2,371,154,309,7,1,471,32.3,62,51,8.6,842,False,14,212,618,9,3,2024-02-06,False,False,False,0.7339667458432304,0.2517814726840855,0.010688836104513063,0.0035629453681710215,Peak,Tuesday,February
2024-02-06 15:00:00,67,417,0,1,485,147,417,7,0,571,31.2,68,63,11.7,1056,False,15,214,834,7,1,2024-02-06,False,False,False,0.7897727272727273,0.20265151515151514,0.006628787878787879,0.000946969696969697,Peak,Tuesday,February
2024-02-06 16:00:00,43,589,2,1,635,141,589,6,1,737,28.8,77,63,9.9,1372,False,16,184,1178,8,2,2024-02-06,False,False,False,0.858600583090379,0.13411078717201166,0.0058309037900874635,0.0014577259475218659,Peak,Tuesday,February
2024-02-06 17:00:00,73,1307,3,0,1383,114,1307,5,0,1426,29.9,71,51,7.9,2809,False,17,187,2614,8,0,2024-02-06,False,False,True,0.9305802776788893,0.06657173371306514,0.002847988608045568,0.0,Peak,Tuesday,February
2024-02-06 18:00:00,90,1301,0,0,1391,405,1301,8,0,1714,30.1,71,3,8.4,3105,False,18,495,2602,8,0,2024-02-06,False,False,True,0.8380032206119162,0.15942028985507245,0.0025764895330112722,0.0,Peak,Tuesday,February
2024-02-06 19:00:00,79,671,6,1,757,344,671,4,2,1021,29.2,76,3,6.0,1778,False,19,423,1342,10,3,2024-02-06,False,False,True,0.7547806524184477,0.23790776152980878,0.00562429696287964,0.001687289088863892,Peak,Tuesday,February
2024-02-06 20:00:00,51,439,0,1,491,111,439,7,3,560,28.0,84,3,4.5,1051,False,20,162,878,7,4,2024-02-06,False,False,False,0.8353948620361561,0.15413891531874405,0.006660323501427212,0.003805899143672693,Shoulder,Tuesday,February
2024-02-06 21:00:00,70,577,4,1,652,127,577,6,2,712,27.6,85,3,4.0,1364,False,21,197,1154,10,3,2024-02-06,False,False,False,0.8460410557184751,0.14442815249266863,0.007331378299120235,0.0021994134897360706,Shoulder,Tuesday,February
2024-02-06 22:00:00,69,346,4,1,420,17,346,10,4,377,27.0,85,3,13.2,797,False,22,86,692,14,5,2024-02-06,False,False,False,0.8682559598494354,0.10790464240903387,0.01756587202007528,0.006273525721455458,Shoulder,Tuesday,February
2024-02-06 23:00:00,13,400,11,0,424,30,400,11,0,441,25.5,87,3,14.9,865,False,23,43,800,22,0,2024-02-06,False,False,False,0.9248554913294798,0.04971098265895954,0.025433526011560695,0.0,Shoulder,Tuesday,February
2024-02-07 00:00:00,49,122,0,0,171,31,122,5,1,159,25.0,86,51,14.0,330,False,0,80,244,5,1,2024-02-07,False,False,False,0.7393939393939394,0.24242424242424243,0.015151515151515152,0.0030303030303030303,Off-Peak,Wednesday,February
2024-02-07 01:00:00,15,170,0,0,185,21,170,8,0,199,25.0,88,51,3.8,384,False,1,36,340,8,0,2024-02-07,False,False,False,0.8854166666666666,0.09375,0.020833333333333332,0.0,Off-Peak,Wednesday,February
2024-02-07 02:00:00,14,70,1,0,85,22,70,5,1,98,25.0,89,51,9.5,183,False,2,36,140,6,1,2024-02-07,False,False,False,0.7650273224043715,0.19672131147540983,0.03278688524590164,0.00546448087431694,Off-Peak,Wednesday,February
2024-02-07 03:00:00,7,72,1,1,81,24,72,4,0,100,24.7,90,3,9.3,181,False,3,31,144,5,1,2024-02-07,False,False,False,0.7955801104972375,0.1712707182320442,0.027624309392265192,0.0055248618784530384,Off-Peak,Wednesday,February
2024-02-07 04:00:00,12,103,1,1,117,63,103,7,0,173,24.5,90,3,10.1,290,False,4,75,206,8,1,2024-02-07,False,False,False,0.7103448275862069,0.25862068965517243,0.027586206896551724,0.0034482758620689655,Off-Peak,Wednesday,February
2024-02-07 05:00:00,21,107,1,0,129,82,107,2,1,192,24.8,89,3,12.4,321,False,5,103,214,3,1,2024-02-07,False,False,False,0.6666666666666666,0.32087227414330216,0.009345794392523364,0.003115264797507788,Shoulder,Wednesday,February
2024-02-07 06:00:00,60,301,1,0,362,41,301,1,1,344,24.4,91,3,11.4,706,False,6,101,602,2,1,2024-02-07,False,False,False,0.8526912181303116,0.14305949008498584,0.0028328611898017,0.00141643059490085,Shoulder,Wednesday,February
2024-02-07 07:00:00,39,504,1,0,544,275,504,3,0,782,24.4,91,3,10.8,1326,False,7,314,1008,4,0,2024-02-07,False,False,False,0.7601809954751131,0.2368024132730015,0.0030165912518853697,0.0,Peak,Wednesday,February
2024-02-07 08:00:00,40,791,0,0,831,248,791,7,0,1046,24.7,91,3,11.5,1877,False,8,288,1582,7,0,2024-02-07,False,False,True,0.8428343100692595,0.15343633457645178,0.0037293553542887587,0.0,Peak,Wednesday,February
2024-02-07 09:00:00,43,747,0,0,790,163,747,2,1,913,27.1,88,3,7.9,1703,False,9,206,1494,2,1,2024-02-07,False,False,True,0.8772753963593658,0.12096300645918967,0.0011743981209630064,0.0005871990604815032,Shoulder,Wednesday,February
2024-02-07 10:00:00,46,578,0,0,624,117,578,1,0,696,28.1,82,51,7.4,1320,False,10,163,1156,1,0,2024-02-07,False,False,False,0.8757575757575757,0.12348484848484849,0.0007575757575757576,0.0,Shoulder,Wednesday,February
2024-02-07 11:00:00,47,426,1,0,474,164,426,2,1,593,29.6,75,3,6.1,1067,False,11,211,852,3,1,2024-02-07,False,False,False,0.7985004686035614,0.19775070290534208,0.0028116213683223993,0.0009372071227741331,Peak,Wednesday,February
2024-02-07 12:00:00,44,542,1,0,587,153,542,0,1,696,31.5,65,3,8.5,1283,False,12,197,1084,1,1,2024-02-07,False,False,False,0.8448947778643804,0.15354637568199533,0.000779423226812159,0.000779423226812159,Peak,Wednesday,February
2024-02-07 13:00:00,151,1227,3,0,1381,396,1227,3,1,1627,32.3,63,51,7.2,3008,False,13,547,2454,6,1,2024-02-07,False,False,True,0.8158244680851063,0.18184840425531915,0.0019946808510638296,0.0003324468085106383,Peak,Wednesday,February
2024-02-07 14:00:00,98,994,4,1,1097,350,994,3,1,1348,32.1,63,3,6.4,2445,False,14,448,1988,7,2,2024-02-07,False,False,True,0.8130879345603272,0.18323108384458078,0.0028629856850715747,0.0008179959100204499,Peak,Wednesday,February
2024-02-07 15:00:00,49,480,2,1,532,174,480,9,0,663,30.7,69,51,5.2,1195,False,15,223,960,11,1,2024-02-07,False,False,False,0.803347280334728,0.18661087866108786,0.009205020920502092,0.0008368200836820083,Peak,Wednesday,February
2024-02-07 16:00:00,167,395,3,1,566,130,395,9,1,535,30.9,71,3,6.6,1101,False,16,297,790,12,2,2024-02-07,False,False,False,0.7175295186194369,0.26975476839237056,0.010899182561307902,0.0018165304268846503,Peak,Wednesday,February
2024-02-07 17:00:00,135,988,3,1,1127,244,988,6,0,1238,27.7,86,63,10.9,2365,False,17,379,1976,9,1,2024-02-07,False,False,True,0.8355179704016913,0.1602536997885835,0.0038054968287526427,0.00042283298097251583,Peak,Wednesday,February
2024-02-07 18:00:00,128,654,0,1,783,342,654,5,2,1003,26.9,87,51,8.2,1786,False,18,470,1308,5,3,2024-02-07,False,False,True,0.7323628219484882,0.2631578947368421,0.002799552071668533,0.0016797312430011197,Peak,Wednesday,February
2024-02-07 19:00:00,23,488,1,0,512,148,488,11,1,648,26.8,88,51,3.8,1160,False,19,171,976,12,1,2024-02-07,False,False,False,0.8413793103448276,0.14741379310344827,0.010344827586206896,0.0008620689655172414,Peak,Wednesday,February
2024-02-07 20:00:00,30,370,4,0,404,171,370,8,1,550,26.0,94,3,2.1,954,False,20,201,740,12,1,2024-02-07,False,False,False,0.7756813417190775,0.21069182389937108,0.012578616352201259,0.0010482180293501049,Shoulder,Wednesday,February
2024-02-07 21:00:00,24,286,3,2,315,146,286,3,3,438,25.5,91,51,12.9,753,False,21,170,572,6,5,2024-02-07,False,False,False,0.7596281540504648,0.22576361221779548,0.00796812749003984,0.006640106241699867,Shoulder,Wednesday,February
2024-02-07 22:00:00,29,237,0,2,268,131,237,3,2,373,25.4,90,51,9.8,641,False,22,160,474,3,4,2024-02-07,False,False,False,0.7394695787831513,0.24960998439937598,0.0046801872074883,0.0062402496099844,Shoulder,Wednesday,February
2024-02-07 23:00:00,18,149,3,0,170,71,149,8,1,229,24.8,93,51,11.3,399,False,23,89,298,11,1,2024-02-07,False,False,False,0.7468671679197995,0.22305764411027568,0.02756892230576441,0.002506265664160401,Shoulder,Wednesday,February
2024-02-08 00:00:00,9,76,0,0,85,39,223,5,0,267,24.7,91,51,13.0,352,False,0,48,299,5,0,2024-02-08,False,True,False,0.8494318181818182,0.13636363636363635,0.014204545454545454,0.0,Off-Peak,Thursday,February
2024-02-08 01:00:00,12,59,0,0,71,35,213,4,0,252,24.2,91,51,11.9,323,False,1,47,272,4,0,2024-02-08,False,True,False,0.8421052631578947,0.14551083591331268,0.01238390092879257,0.0,Off-Peak,Thursday,February
2024-02-08 02:00:00,8,16,1,0,25,27,231,1,0,259,24.3,91,51,8.2,284,False,2,35,247,2,0,2024-02-08,False,True,False,0.8697183098591549,0.12323943661971831,0.007042253521126761,0.0,Off-Peak,Thursday,February
2024-02-08 03:00:00,13,31,0,0,44,12,101,2,0,115,24.1,92,51,13.3,159,False,3,25,132,2,0,2024-02-08,False,True,False,0.8301886792452831,0.15723270440251572,0.012578616352201259,0.0,Off-Peak,Thursday,February
2024-02-08 04:00:00,28,58,0,0,86,18,33,0,0,51,24.0,92,2,10.9,137,False,4,46,91,0,0,2024-02-08,False,True,False,0.6642335766423357,0.3357664233576642,0.0,0.0,Off-Peak,Thursday,February
2024-02-08 05:00:00,49,142,1,0,192,67,45,6,0,118,24.1,92,2,9.2,310,False,5,116,187,7,0,2024-02-08,False,True,False,0.603225806451613,0.3741935483870968,0.02258064516129032,0.0,Shoulder,Thursday,February
2024-02-08 06:00:00,78,266,0,0,344,147,152,5,1,305,24.3,92,3,8.5,649,False,6,225,418,5,1,2024-02-08,False,True,False,0.6440677966101694,0.34668721109399075,0.007704160246533128,0.0015408320493066256,Shoulder,Thursday,February
2024-02-08 07:00:00,76,515,1,0,592,213,52,7,0,272,24.2,92,3,9.3,864,False,7,289,567,8,0,2024-02-08,False,True,False,0.65625,0.33449074074074076,0.009259259259259259,0.0,Peak,Thursday,February
2024-02-08 08:00:00,22,745,0,0,767,110,124,5,2,241,24.4,92,3,11.5,1008,False,8,132,869,5,2,2024-02-08,False,True,False,0.8621031746031746,0.13095238095238096,0.00496031746031746,0.001984126984126984,Peak,Thursday,February
2024-02-08 09:00:00,29,379,0,0,408,43,477,3,0,523,26.5,90,51,9.4,931,False,9,72,856,3,0,2024-02-08,False,True,False,0.9194414607948442,0.07733619763694952,0.00322234156820623,0.0,Shoulder,Thursday,February
2024-02-08 10:00:00,37,359,1,2,399,88,470,5,2,565,27.8,85,51,10.4,964,False,10,125,829,6,4,2024-02-08,False,True,False,0.8599585062240664,0.12966804979253113,0.006224066390041493,0.004149377593360996,Shoulder,Thursday,February
2024-02-08 11:00:00,78,735,0,2,815,125,651,1,1,778,29.7,77,51,6.6,1593,False,11,203,1386,1,3,2024-02-08,False,True,True,0.8700564971751412,0.12743251726302574,0.0006277463904582549,0.0018832391713747645,Peak,Thursday,February
2024-02-08 12:00:00,84,940,1,0,1025,297,500,5,0,802,30.6,73,51,4.7,1827,False,12,381,1440,6,0,2024-02-08,False,True,True,0.7881773399014779,0.20853858784893267,0.003284072249589491,0.0,Peak,Thursday,February
2024-02-08 13:00:00,41,850,0,0,891,320,1294,3,0,1617,31.3,70,51,5.0,2508,False,13,361,2144,3,0,2024-02-08,False,True,True,0.8548644338118022,0.14393939393939395,0.0011961722488038277,0.0,Peak,Thursday,February
2024-02-08 14:00:00,25,390,2,0,417,107,843,3,1,954,31.5,69,51,5.2,1371,False,14,132,1233,5,1,2024-02-08,False,True,False,0.899343544857768,0.0962800875273523,0.0036469730123997084,0.0007293946024799417,Peak,Thursday,February
2024-02-08 15:00:00,36,426,1,1,464,120,539,2,2,663,31.7,69,51,6.6,1127,False,15,156,965,3,3,2024-02-08,False,True,False,0.8562555456965395,0.13842058562555457,0.0026619343389529724,0.0026619343389529724,Peak,Thursday,February
2024-02-08 16:00:00,47,753,2,2,804,106,336,4,0,446,29.0,74,63,10.2,1250,False,16,153,1089,6,2,2024-02-08,False,True,False,0.8712,0.1224,0.0048,0.0016,Peak,Thursday,February
2024-02-08 17:00:00,67,1067,1,1,1136,276,827,1,0,1104,28.7,79,61,7.4,2240,False,17,343,1894,2,1,2024-02-08,False,True,True,0.8455357142857143,0.153125,0.0008928571428571428,0.0004464285714285714,Peak,Thursday,February
2024-02-08 18:00:00,92,455,1,0,548,189,1350,2,1,1542,28.3,78,51,8.7,2090,False,18,281,1805,3,1,2024-02-08,False,True,True,0.8636363636363636,0.13444976076555024,0.0014354066985645933,0.0004784688995215311,Peak,Thursday,February
2024-02-08 19:00:00,51,321,2,1,375,123,429,7,0,559,28.0,81,3,4.6,934,False,19,174,750,9,1,2024-02-08,False,True,False,0.8029978586723768,0.18629550321199143,0.009635974304068522,0.0010706638115631692,Peak,Thursday,February
2024-02-08 20:00:00,12,313,3,2,330,114,206,6,3,329,27.1,86,3,3.6,659,False,20,126,519,9,5,2024-02-08,False,True,False,0.787556904400607,0.19119878603945373,0.013657056145675266,0.007587253414264037,Shoulder,Thursday,February
2024-02-08 21:00:00,12,306,5,1,324,162,395,5,0,562,26.3,91,3,6.3,886,False,21,174,701,10,1,2024-02-08,False,True,False,0.791196388261851,0.1963882618510158,0.011286681715575621,0.001128668171557562,Shoulder,Thursday,February
2024-02-08 22:00:00,31,325,3,3,362,74,106,9,3,192,25.7,93,3,12.2,554,False,22,105,431,12,6,2024-02-08,False,True,False,0.7779783393501805,0.18953068592057762,0.021660649819494584,0.010830324909747292,Shoulder,Thursday,February
2024-02-08 23:00:00,13,212,3,0,228,72,142,5,2,221,25.3,93,3,5.4,449,False,23,85,354,8,2,2024-02-08,False,True,False,0.7884187082405345,0.18930957683741648,0.017817371937639197,0.004454342984409799,Shoulder,Thursday,February
2024-02-09 00:00:00,13,65,0,0,78,30,65,3,0,98,25.2,93,3,5.8,176,False,0,43,130,3,0,2024-02-09,False,False,False,0.7386363636363636,0.24431818181818182,0.017045454545454544,0.0,Off-Peak,Friday,February
2024-02-09 01:00:00,21,23,0,0,44,37,23,3,1,64,25.0,94,3,6.5,108,False,1,58,46,3,1,2024-02-09,False,False,False,0.42592592592592593,0.5370370370370371,0.027777777777777776,0.009259259259259259,Off-Peak,Friday,February
2024-02-09 02:00:00,6,41,1,1,49,11,41,1,0,53,24.6,96,3,5.4,102,False,2,17,82,2,1,2024-02-09,False,False,False,0.803921568627451,0.16666666666666666,0.0196078431372549,0.00980392156862745,Off-Peak,Friday,February
2024-02-09 03:00:00,4,15,0,0,19,6,15,2,1,24,24.5,96,3,4.0,43,False,3,10,30,2,1,2024-02-09,False,False,False,0.6976744186046512,0.23255813953488372,0.046511627906976744,0.023255813953488372,Off-Peak,Friday,February
2024-02-09 04:00:00,13,57,0,0,70,33,57,5,0,95,24.5,96,3,5.0,165,False,4,46,114,5,0,2024-02-09,False,False,False,0.6909090909090909,0.2787878787878788,0.030303030303030304,0.0,Off-Peak,Friday,February
2024-02-09 05:00:00,15,63,0,0,78,55,63,3,1,122,24.8,94,3,4.4,200,False,5,70,126,3,1,2024-02-09,False,False,False,0.63,0.35,0.015,0.005,Shoulder,Friday,February
2024-02-09 06:00:00,102,208,0,0,310,111,208,3,0,322,25.0,93,3,7.9,632,False,6,213,416,3,0,2024-02-09,False,False,False,0.6582278481012658,0.3370253164556962,0.004746835443037975,0.0,Shoulder,Friday,February
2024-02-09 07:00:00,155,773,0,0,928,280,773,0,0,1053,24.9,94,3,6.9,1981,False,7,435,1546,0,0,2024-02-09,False,False,True,0.7804139323573952,0.21958606764260474,0.0,0.0,Peak,Friday,February
2024-02-09 08:00:00,28,869,1,1,899,292,869,2,1,1164,25.0,95,3,8.2,2063,False,8,320,1738,3,2,2024-02-09,False,False,True,0.842462433349491,0.15511391177896267,0.001454192922927775,0.0009694619486185168,Peak,Friday,February
2024-02-09 09:00:00,20,351,1,1,373,97,351,3,0,451,26.6,93,61,6.6,824,False,9,117,702,4,1,2024-02-09,False,False,False,0.8519417475728155,0.14199029126213591,0.0048543689320388345,0.0012135922330097086,Shoulder,Friday,February
2024-02-09 10:00:00,25,339,1,2,367,95,339,3,0,437,26.7,91,51,7.4,804,False,10,120,678,4,2,2024-02-09,False,False,False,0.8432835820895522,0.14925373134328357,0.004975124378109453,0.0024875621890547263,Shoulder,Friday,February
2024-02-09 11:00:00,21,393,1,1,416,36,393,3,1,433,26.6,87,51,8.8,849,False,11,57,786,4,2,2024-02-09,False,False,False,0.9257950530035336,0.06713780918727916,0.004711425206124852,0.002355712603062426,Peak,Friday,February
2024-02-09 12:00:00,132,1286,1,1,1420,440,1286,5,0,1731,28.2,80,51,4.1,3151,False,12,572,2572,6,1,2024-02-09,False,False,True,0.8162488099016185,0.18152967311964455,0.001904157410345922,0.00031735956839098697,Peak,Friday,February
2024-02-09 13:00:00,122,1309,1,1,1433,462,1309,4,1,1776,30.3,73,3,5.5,3209,False,13,584,2618,5,2,2024-02-09,False,False,True,0.8158304767840449,0.18198815830476783,0.0015581177937052041,0.0006232471174820816,Peak,Friday,February
2024-02-09 14:00:00,21,292,0,0,313,106,292,8,0,406,31.6,65,51,6.4,719,False,14,127,584,8,0,2024-02-09,False,False,False,0.8122392211404729,0.17663421418636996,0.011126564673157162,0.0,Peak,Friday,February
2024-02-09 15:00:00,36,324,2,2,364,96,324,2,2,424,32.6,53,51,7.3,788,False,15,132,648,4,4,2024-02-09,False,False,False,0.8223350253807107,0.16751269035532995,0.005076142131979695,0.005076142131979695,Peak,Friday,February
2024-02-09 16:00:00,27,154,1,1,183,90,154,4,4,252,33.3,47,1,5.5,435,False,16,117,308,5,5,2024-02-09,False,False,False,0.7080459770114943,0.2689655172413793,0.011494252873563218,0.011494252873563218,Peak,Friday,February
2024-02-09 17:00:00,114,1481,1,1,1597,110,1481,2,2,1595,32.8,48,2,3.1,3192,False,17,224,2962,3,3,2024-02-09,False,False,True,0.9279448621553885,0.07017543859649122,0.0009398496240601503,0.0009398496240601503,Peak,Friday,February
2024-02-09 18:00:00,103,1057,1,1,1162,297,1057,2,0,1356,30.5,68,51,8.4,2518,False,18,400,2114,3,1,2024-02-09,False,False,True,0.8395552025416998,0.15885623510722796,0.0011914217633042098,0.0003971405877680699,Peak,Friday,February
2024-02-09 19:00:00,18,354,1,1,374,314,354,3,3,674,28.8,80,51,8.9,1048,False,19,332,708,4,4,2024-02-09,False,False,False,0.6755725190839694,0.31679389312977096,0.003816793893129771,0.003816793893129771,Peak,Friday,February
2024-02-09 20:00:00,26,190,2,2,220,79,190,4,3,276,28.0,83,51,5.6,496,False,20,105,380,6,5,2024-02-09,False,False,False,0.7661290322580645,0.21169354838709678,0.012096774193548387,0.010080645161290322,Shoulder,Friday,February
2024-02-09 21:00:00,22,184,2,2,210,32,184,1,1,218,28.0,69,3,6.1,428,False,21,54,368,3,3,2024-02-09,False,False,False,0.8598130841121495,0.1261682242990654,0.007009345794392523,0.007009345794392523,Shoulder,Friday,February
2024-02-09 22:00:00,22,199,0,0,221,9,199,4,3,215,27.9,66,51,6.2,436,False,22,31,398,4,3,2024-02-09,False,False,False,0.9128440366972477,0.07110091743119266,0.009174311926605505,0.006880733944954129,Shoulder,Friday,February
2024-02-09 23:00:00,26,135,0,0,161,10,135,1,4,150,27.5,73,3,11.3,311,False,23,36,270,1,4,2024-02-09,False,False,False,0.8681672025723473,0.1157556270096463,0.003215434083601286,0.012861736334405145,Shoulder,Friday,February
2024-02-10 00:00:00,9,55,1,0,65,17,55,6,0,78,26.3,79,3,12.7,143,True,0,26,110,7,0,2024-02-10,True,True,False,0.7692307692307693,0.18181818181818182,0.04895104895104895,0.0,Off-Peak,Saturday,February
2024-02-10 01:00:00,19,34,1,0,54,26,34,2,1,63,25.9,78,3,14.2,117,True,1,45,68,3,1,2024-02-10,True,True,False,0.5811965811965812,0.38461538461538464,0.02564102564102564,0.008547008547008548,Off-Peak,Saturday,February
2024-02-10 02:00:00,2,174,0,0,176,40,174,5,1,220,25.5,78,3,17.0,396,True,2,42,348,5,1,2024-02-10,True,True,False,0.8787878787878788,0.10606060606060606,0.012626262626262626,0.0025252525252525255,Off-Peak,Saturday,February
2024-02-10 03:00:00,14,107,1,1,123,49,107,7,0,163,25.0,76,3,19.5,286,True,3,63,214,8,1,2024-02-10,True,True,False,0.7482517482517482,0.2202797202797203,0.027972027972027972,0.0034965034965034965,Off-Peak,Saturday,February
2024-02-10 04:00:00,24,219,2,0,245,71,219,7,0,297,24.5,77,3,18.0,542,True,4,95,438,9,0,2024-02-10,True,True,False,0.8081180811808119,0.1752767527675277,0.016605166051660517,0.0,Off-Peak,Saturday,February
2024-02-10 05:00:00,40,265,0,0,305,57,265,4,0,326,24.0,77,3,17.9,631,True,5,97,530,4,0,2024-02-10,True,True,False,0.8399366085578447,0.1537242472266244,0.006339144215530904,0.0,Shoulder,Saturday,February
2024-02-10 06:00:00,57,327,0,1,385,273,327,3,0,603,23.4,79,3,15.9,988,True,6,330,654,3,1,2024-02-10,True,True,False,0.6619433198380567,0.3340080971659919,0.003036437246963563,0.0010121457489878543,Shoulder,Saturday,February
2024-02-10 07:00:00,87,659,1,1,748,286,659,1,0,946,23.0,81,3,13.3,1694,True,7,373,1318,2,1,2024-02-10,True,True,True,0.7780401416765053,0.22018890200708383,0.0011806375442739079,0.0005903187721369539,Peak,Saturday,February
2024-02-10 08:00:00,93,710,1,2,806,79,710,2,3,794,23.0,81,3,13.5,1600,True,8,172,1420,3,5,2024-02-10,True,True,True,0.8875,0.1075,0.001875,0.003125,Peak,Saturday,February
2024-02-10 09:00:00,47,465,2,0,514,158,465,1,0,624,25.8,73,3,9.1,1138,True,9,205,930,3,0,2024-02-10,True,True,False,0.8172231985940246,0.18014059753954306,0.0026362038664323375,0.0,Shoulder,Saturday,February
2024-02-10 10:00:00,64,295,5,0,364,302,295,9,2,608,28.1,66,3,9.2,972,True,10,366,590,14,2,2024-02-10,True,True,False,0.6069958847736625,0.3765432098765432,0.01440329218106996,0.00205761316872428,Shoulder,Saturday,February
2024-02-10 11:00:00,37,402,0,1,440,324,402,6,1,733,30.1,61,3,12.7,1173,True,11,361,804,6,2,2024-02-10,True,True,False,0.6854219948849105,0.30775788576300084,0.005115089514066497,0.0017050298380221654,Peak,Saturday,February
2024-02-10 12:00:00,99,749,1,1,850,439,749,5,4,1197,31.7,56,3,18.7,2047,True,12,538,1498,6,5,2024-02-10,True,True,True,0.7318026380068393,0.2628236443575965,0.0029311187103077674,0.002442598925256473,Peak,Saturday,February
2024-02-10 13:00:00,127,786,0,1,914,92,786,3,0,881,32.4,53,51,16.1,1795,True,13,219,1572,3,1,2024-02-10,True,True,True,0.875766016713092,0.12200557103064066,0.001671309192200557,0.0005571030640668524,Peak,Saturday,February
2024-02-10 14:00:00,36,427,3,1,467,143,427,1,1,572,32.0,57,51,13.3,1039,True,14,179,854,4,2,2024-02-10,True,True,False,0.821944177093359,0.17228103946102022,0.0038498556304138597,0.0019249278152069298,Peak,Saturday,February
2024-02-10 15:00:00,33,230,2,1,266,198,230,9,3,440,31.9,58,51,8.9,706,True,15,231,460,11,4,2024-02-10,True,True,False,0.6515580736543909,0.3271954674220963,0.015580736543909348,0.0056657223796034,Peak,Saturday,February
2024-02-10 16:00:00,38,388,1,0,427,233,388,6,2,629,29.3,68,53,12.0,1056,True,16,271,776,7,2,2024-02-10,True,True,False,0.7348484848484849,0.2566287878787879,0.006628787878787879,0.001893939393939394,Peak,Saturday,February
2024-02-10 17:00:00,107,881,2,0,990,283,881,5,2,1171,29.7,66,51,16.2,2161,True,17,390,1762,7,2,2024-02-10,True,True,True,0.8153632577510412,0.18047200370198982,0.003239241092086997,0.0009254974548819991,Peak,Saturday,February
2024-02-10 18:00:00,124,925,3,1,1053,127,925,7,0,1059,29.4,68,53,13.3,2112,True,18,251,1850,10,1,2024-02-10,True,True,True,0.8759469696969697,0.11884469696969698,0.004734848484848485,0.0004734848484848485,Peak,Saturday,February
2024-02-10 19:00:00,53,400,1,2,456,170,400,6,5,581,27.7,75,51,11.6,1037,True,19,223,800,7,7,2024-02-10,True,True,False,0.7714561234329798,0.21504339440694312,0.006750241080038573,0.006750241080038573,Peak,Saturday,February
2024-02-10 20:00:00,35,400,1,3,439,132,400,7,3,542,26.9,79,1,14.6,981,True,20,167,800,8,6,2024-02-10,True,True,False,0.8154943934760448,0.17023445463812437,0.00815494393476045,0.0061162079510703364,Shoulder,Saturday,February
2024-02-10 21:00:00,49,302,0,1,352,67,302,4,2,375,25.5,90,3,8.7,727,True,21,116,604,4,3,2024-02-10,True,True,False,0.8308115543328748,0.15955983493810177,0.005502063273727648,0.0041265474552957355,Shoulder,Saturday,February
2024-02-10 22:00:00,36,200,1,2,239,72,200,0,3,275,25.6,90,1,14.3,514,True,22,108,400,1,5,2024-02-10,True,True,False,0.7782101167315175,0.21011673151750973,0.0019455252918287938,0.009727626459143969,Shoulder,Saturday,February
2024-02-10 23:00:00,44,119,0,3,166,38,119,0,4,161,25.1,89,3,13.0,327,True,23,82,238,0,7,2024-02-10,True,True,False,0.72782874617737,0.25076452599388377,0.0,0.021406727828746176,Shoulder,Saturday,February
2024-02-11 00:00:00,19,68,2,1,90,65,68,6,0,139,25.0,89,1,12.7,229,True,0,84,136,8,1,2024-02-11,True,True,False,0.5938864628820961,0.36681222707423583,0.034934497816593885,0.004366812227074236,Off-Peak,Sunday,February
2024-02-11 01:00:00,10,318,0,0,328,38,318,3,0,359,25.0,89,0,13.2,687,True,1,48,636,3,0,2024-02-11,True,True,False,0.925764192139738,0.06986899563318777,0.004366812227074236,0.0,Off-Peak,Sunday,February
2024-02-11 02:00:00,15,119,1,0,135,50,119,2,1,172,24.8,89,1,13.8,307,True,2,65,238,3,1,2024-02-11,True,True,False,0.7752442996742671,0.21172638436482086,0.009771986970684038,0.003257328990228013,Off-Peak,Sunday,February
2024-02-11 03:00:00,11,252,2,1,266,56,252,1,0,309,24.3,89,0,15.3,575,True,3,67,504,3,1,2024-02-11,True,True,False,0.8765217391304347,0.11652173913043479,0.0052173913043478265,0.0017391304347826088,Off-Peak,Sunday,February
2024-02-11 04:00:00,26,208,1,0,235,65,208,8,0,281,24.1,89,0,15.3,516,True,4,91,416,9,0,2024-02-11,True,True,False,0.8062015503875969,0.17635658914728683,0.01744186046511628,0.0,Off-Peak,Sunday,February
2024-02-11 05:00:00,15,112,0,0,127,103,112,1,1,217,23.7,90,3,14.6,344,True,5,118,224,1,1,2024-02-11,True,True,False,0.6511627906976745,0.3430232558139535,0.0029069767441860465,0.0029069767441860465,Shoulder,Sunday,February
2024-02-11 06:00:00,45,479,0,1,525,178,479,5,2,664,23.8,89,3,14.6,1189,True,6,223,958,5,3,2024-02-11,True,True,False,0.8057190916736754,0.18755256518082422,0.004205214465937763,0.002523128679562658,Shoulder,Sunday,February
2024-02-11 07:00:00,66,474,0,0,540,215,474,4,1,694,23.6,90,3,13.8,1234,True,7,281,948,4,1,2024-02-11,True,True,False,0.7682333873581848,0.22771474878444084,0.0032414910858995136,0.0008103727714748784,Peak,Sunday,February
2024-02-11 08:00:00,71,659,1,0,731,117,659,5,0,781,23.8,89,3,13.0,1512,True,8,188,1318,6,0,2024-02-11,True,True,True,0.8716931216931217,0.12433862433862433,0.003968253968253968,0.0,Peak,Sunday,February
2024-02-11 09:00:00,45,96,1,0,142,121,96,7,2,226,26.5,81,3,12.8,368,True,9,166,192,8,2,2024-02-11,True,True,False,0.5217391304347826,0.45108695652173914,0.021739130434782608,0.005434782608695652,Shoulder,Sunday,February
2024-02-11 10:00:00,15,278,3,0,296,128,278,1,1,408,28.1,74,2,19.4,704,True,10,143,556,4,1,2024-02-11,True,True,False,0.7897727272727273,0.203125,0.005681818181818182,0.0014204545454545455,Shoulder,Sunday,February
2024-02-11 11:00:00,34,642,1,0,677,83,642,7,1,733,29.0,67,51,23.0,1410,True,11,117,1284,8,1,2024-02-11,True,True,True,0.9106382978723404,0.08297872340425531,0.005673758865248227,0.0007092198581560284,Peak,Sunday,February
2024-02-11 12:00:00,68,737,2,1,808,233,737,1,1,972,29.6,65,53,24.2,1780,True,12,301,1474,3,2,2024-02-11,True,True,True,0.8280898876404494,0.1691011235955056,0.0016853932584269663,0.0011235955056179776,Peak,Sunday,February
2024-02-11 13:00:00,70,685,4,0,759,284,685,7,1,977,30.3,62,51,21.0,1736,True,13,354,1370,11,1,2024-02-11,True,True,True,0.7891705069124424,0.20391705069124424,0.006336405529953917,0.000576036866359447,Peak,Sunday,February
2024-02-11 14:00:00,42,198,1,1,242,89,198,2,0,289,31.9,54,3,21.0,531,True,14,131,396,3,1,2024-02-11,True,True,False,0.7457627118644068,0.24670433145009416,0.005649717514124294,0.0018832391713747645,Peak,Sunday,February
2024-02-11 15:00:00,37,211,1,0,249,93,211,4,0,308,31.8,54,51,20.2,557,True,15,130,422,5,0,2024-02-11,True,True,False,0.7576301615798923,0.2333931777378815,0.008976660682226212,0.0,Peak,Sunday,February
2024-02-11 16:00:00,99,470,3,1,573,82,470,4,3,559,32.0,52,2,20.7,1132,True,16,181,940,7,4,2024-02-11,True,True,False,0.8303886925795053,0.1598939929328622,0.006183745583038869,0.0035335689045936395,Peak,Sunday,February
2024-02-11 17:00:00,108,315,0,0,423,292,315,2,1,610,31.0,53,51,21.1,1033,True,17,400,630,2,1,2024-02-11,True,True,False,0.6098741529525653,0.3872216844143272,0.001936108422071636,0.000968054211035818,Peak,Sunday,February
2024-02-11 18:00:00,105,1094,3,2,1204,307,1094,10,2,1413,30.5,57,51,17.1,2617,True,18,412,2188,13,4,2024-02-11,True,True,True,0.8360718379824226,0.15743217424531908,0.004967520061138708,0.0015284677111196026,Peak,Sunday,February
2024-02-11 19:00:00,22,1240,1,0,1263,94,1240,9,0,1343,29.3,60,0,17.1,2606,True,19,116,2480,10,0,2024-02-11,True,True,True,0.9516500383729855,0.044512663085188024,0.003837298541826554,0.0,Peak,Sunday,February
2024-02-11 20:00:00,18,390,4,1,413,74,390,7,1,472,28.2,66,0,19.1,885,True,20,92,780,11,2,2024-02-11,True,True,False,0.8813559322033898,0.103954802259887,0.012429378531073447,0.0022598870056497176,Shoulder,Sunday,February
2024-02-11 21:00:00,15,216,2,2,235,84,216,4,3,307,27.7,67,0,19.1,542,True,21,99,432,6,5,2024-02-11,True,True,False,0.7970479704797048,0.18265682656826568,0.01107011070110701,0.00922509225092251,Shoulder,Sunday,February
2024-02-11 22:00:00,11,331,2,3,347,92,331,5,0,428,26.9,72,0,19.7,775,True,22,103,662,7,3,2024-02-11,True,True,False,0.8541935483870968,0.1329032258064516,0.00903225806451613,0.003870967741935484,Shoulder,Sunday,February
2024-02-11 23:00:00,9,186,0,8,203,75,186,8,0,269,26.5,73,0,18.2,472,True,23,84,372,8,8,2024-02-11,True,True,False,0.788135593220339,0.17796610169491525,0.01694915254237288,0.01694915254237288,Shoulder,Sunday,February
2024-02-12 00:00:00,6,105,1,0,112,16,105,3,1,125,26.0,75,0,16.8,237,False,0,22,210,4,1,2024-02-12,True,True,False,0.8860759493670886,0.09282700421940929,0.016877637130801686,0.004219409282700422,Off-Peak,Monday,February
2024-02-12 01:00:00,21,135,0,0,156,13,135,3,1,152,25.7,76,0,17.4,308,False,1,34,270,3,1,2024-02-12,True,True,False,0.8766233766233766,0.11038961038961038,0.00974025974025974,0.003246753246753247,Off-Peak,Monday,February
2024-02-12 02:00:00,2,28,1,0,31,43,28,7,1,79,25.4,77,0,18.0,110,False,2,45,56,8,1,2024-02-12,True,True,False,0.509090909090909,0.4090909090909091,0.07272727272727272,0.00909090909090909,Off-Peak,Monday,February
2024-02-12 03:00:00,8,51,1,1,61,54,51,5,2,112,25.1,79,1,17.3,173,False,3,62,102,6,3,2024-02-12,True,True,False,0.5895953757225434,0.3583815028901734,0.03468208092485549,0.017341040462427744,Off-Peak,Monday,February
2024-02-12 04:00:00,3,234,1,0,238,86,234,5,2,327,24.8,79,1,16.0,565,False,4,89,468,6,2,2024-02-12,True,True,False,0.8283185840707965,0.15752212389380532,0.010619469026548672,0.0035398230088495575,Off-Peak,Monday,February
2024-02-12 05:00:00,9,267,3,1,280,78,267,5,1,351,24.5,81,1,14.6,631,False,5,87,534,8,2,2024-02-12,True,True,False,0.8462757527733756,0.13787638668779714,0.012678288431061807,0.003169572107765452,Shoulder,Monday,February
2024-02-12 06:00:00,57,467,1,0,525,116,467,4,1,588,24.5,80,1,14.7,1113,False,6,173,934,5,1,2024-02-12,True,True,False,0.839173405211141,0.1554357592093441,0.004492362982929021,0.0008984725965858042,Shoulder,Monday,February
2024-02-12 07:00:00,73,575,0,2,650,179,575,4,1,759,24.4,79,0,15.5,1409,False,7,252,1150,4,3,2024-02-12,True,True,True,0.8161816891412349,0.17885024840312277,0.0028388928317956,0.0021291696238466998,Peak,Monday,February
2024-02-12 08:00:00,86,725,1,0,812,217,725,4,1,947,24.6,79,3,15.2,1759,False,8,303,1450,5,1,2024-02-12,True,True,True,0.824332006822058,0.17225696418419556,0.0028425241614553724,0.0005685048322910744,Peak,Monday,February
2024-02-12 09:00:00,56,158,1,0,215,156,158,6,1,321,26.7,74,3,15.9,536,False,9,212,316,7,1,2024-02-12,True,True,False,0.5895522388059702,0.39552238805970147,0.013059701492537313,0.0018656716417910447,Shoulder,Monday,February
2024-02-12 10:00:00,66,413,1,1,481,100,413,4,2,519,27.3,72,3,21.9,1000,False,10,166,826,5,3,2024-02-12,True,True,False,0.826,0.166,0.005,0.003,Shoulder,Monday,February
2024-02-12 11:00:00,64,494,1,1,560,81,494,5,2,582,28.6,65,3,21.5,1142,False,11,145,988,6,3,2024-02-12,True,True,False,0.8651488616462347,0.12697022767075306,0.005253940455341506,0.002626970227670753,Peak,Monday,February
2024-02-12 12:00:00,98,880,0,1,979,91,880,5,2,978,30.6,59,2,19.0,1957,False,12,189,1760,5,3,2024-02-12,True,True,True,0.8993357179356157,0.0965763924374042,0.0025549310168625446,0.0015329586101175269,Peak,Monday,February
2024-02-12 13:00:00,90,979,0,0,1069,241,979,3,3,1226,31.8,55,1,18.6,2295,False,13,331,1958,3,3,2024-02-12,True,True,True,0.8531590413943355,0.14422657952069717,0.00130718954248366,0.00130718954248366,Peak,Monday,February
2024-02-12 14:00:00,35,321,2,1,359,338,321,6,2,667,32.5,52,2,21.0,1026,False,14,373,642,8,3,2024-02-12,True,True,False,0.6257309941520468,0.3635477582846004,0.007797270955165692,0.0029239766081871343,Peak,Monday,February
2024-02-12 15:00:00,28,229,2,1,260,228,229,3,3,463,33.1,50,2,21.2,723,False,15,256,458,5,4,2024-02-12,True,True,False,0.6334716459197787,0.35408022130013833,0.006915629322268326,0.005532503457814661,Peak,Monday,February
2024-02-12 16:00:00,34,484,2,2,522,160,484,3,2,649,32.7,50,51,22.9,1171,False,16,194,968,5,4,2024-02-12,True,True,False,0.8266438941076003,0.16567036720751493,0.004269854824935952,0.0034158838599487617,Peak,Monday,February
2024-02-12 17:00:00,91,933,2,1,1027,132,933,5,2,1072,31.5,54,51,21.9,2099,False,17,223,1866,7,3,2024-02-12,True,True,True,0.8889947594092424,0.10624106717484516,0.0033349213911386373,0.0014292520247737017,Peak,Monday,February
2024-02-12 18:00:00,95,1001,2,2,1100,213,1001,7,1,1222,30.8,56,3,22.4,2322,False,18,308,2002,9,3,2024-02-12,True,True,True,0.8621877691645133,0.1326442721791559,0.003875968992248062,0.0012919896640826874,Peak,Monday,February
2024-02-12 19:00:00,25,318,4,1,348,419,318,6,1,744,29.5,62,3,19.1,1092,False,19,444,636,10,2,2024-02-12,True,True,False,0.5824175824175825,0.4065934065934066,0.009157509157509158,0.0018315018315018315,Peak,Monday,February
2024-02-12 20:00:00,42,333,0,1,376,156,333,7,2,498,28.0,69,3,16.0,874,False,20,198,666,7,3,2024-02-12,True,True,False,0.7620137299771167,0.22654462242562928,0.008009153318077803,0.003432494279176201,Shoulder,Monday,February
2024-02-12 21:00:00,37,357,4,2,400,53,357,5,1,416,27.6,74,3,18.9,816,False,21,90,714,9,3,2024-02-12,True,True,False,0.875,0.11029411764705882,0.011029411764705883,0.003676470588235294,Shoulder,Monday,February
2024-02-12 22:00:00,30,359,0,2,391,12,359,7,3,381,27.4,74,3,19.6,772,False,22,42,718,7,5,2024-02-12,True,True,False,0.9300518134715026,0.054404145077720206,0.009067357512953367,0.006476683937823834,Shoulder,Monday,February
2024-02-12 23:00:00,10,340,1,2,353,32,340,7,2,381,27.0,74,3,20.1,734,False,23,42,680,8,4,2024-02-12,True,True,False,0.9264305177111717,0.05722070844686648,0.010899182561307902,0.005449591280653951,Shoulder,Monday,February
2024-02-13 00:00:00,6,105,1,0,112,21,69,7,0,97,26.8,75,3,19.4,209,False,0,27,174,8,0,2024-02-13,False,False,False,0.8325358851674641,0.1291866028708134,0.03827751196172249,0.0,Off-Peak,Tuesday,February
2024-02-13 01:00:00,21,135,3,0,159,8,38,6,0,52,26.5,75,3,18.8,211,False,1,29,173,9,0,2024-02-13,False,False,False,0.8199052132701422,0.13744075829383887,0.04265402843601896,0.0,Off-Peak,Tuesday,February
2024-02-13 02:00:00,2,28,2,0,32,30,70,10,0,110,26.2,77,3,18.4,142,False,2,32,98,12,0,2024-02-13,False,False,False,0.6901408450704225,0.22535211267605634,0.08450704225352113,0.0,Off-Peak,Tuesday,February
2024-02-13 03:00:00,8,51,2,0,61,52,75,7,0,134,26.0,78,3,18.1,195,False,3,60,126,9,0,2024-02-13,False,False,False,0.6461538461538462,0.3076923076923077,0.046153846153846156,0.0,Off-Peak,Tuesday,February
2024-02-13 04:00:00,3,234,1,0,238,69,51,5,1,126,25.7,79,3,17.9,364,False,4,72,285,6,1,2024-02-13,False,False,False,0.782967032967033,0.1978021978021978,0.016483516483516484,0.0027472527472527475,Off-Peak,Tuesday,February
2024-02-13 05:00:00,9,267,3,0,279,126,233,0,1,360,25.4,80,3,18.2,639,False,5,135,500,3,1,2024-02-13,False,False,False,0.7824726134585289,0.2112676056338028,0.004694835680751174,0.001564945226917058,Shoulder,Tuesday,February
2024-02-13 06:00:00,57,467,2,0,526,193,558,5,1,757,25.2,81,3,17.3,1283,False,6,250,1025,7,1,2024-02-13,False,False,False,0.798908807482463,0.19485580670303976,0.005455962587685113,0.000779423226812159,Shoulder,Tuesday,February
2024-02-13 07:00:00,73,575,3,2,653,233,592,6,1,832,25.0,82,1,15.4,1485,False,7,306,1167,9,3,2024-02-13,False,False,True,0.7858585858585858,0.20606060606060606,0.006060606060606061,0.00202020202020202,Peak,Tuesday,February
2024-02-13 08:00:00,86,725,2,0,813,76,271,9,0,356,25.0,83,3,16.1,1169,False,8,162,996,11,0,2024-02-13,False,False,False,0.8520102651839179,0.13857998289136014,0.009409751924721984,0.0,Peak,Tuesday,February
2024-02-13 09:00:00,56,147,4,1,208,152,269,9,1,431,26.5,81,3,15.6,639,False,9,208,416,13,2,2024-02-13,False,False,False,0.651017214397496,0.325508607198748,0.02034428794992175,0.003129890453834116,Shoulder,Tuesday,February
2024-02-13 10:00:00,66,413,1,2,482,134,269,5,1,409,27.7,75,3,21.2,891,False,10,200,682,6,3,2024-02-13,False,False,False,0.7654320987654321,0.2244668911335578,0.006734006734006734,0.003367003367003367,Shoulder,Tuesday,February
2024-02-13 11:00:00,64,474,3,0,541,142,1083,5,0,1230,29.3,67,3,22.8,1771,False,11,206,1557,8,0,2024-02-13,False,False,True,0.8791643139469226,0.1163184641445511,0.004517221908526256,0.0,Peak,Tuesday,February
2024-02-13 12:00:00,68,880,1,0,949,269,1252,10,0,1531,31.1,58,3,23.7,2480,False,12,337,2132,11,0,2024-02-13,False,False,True,0.8596774193548387,0.13588709677419356,0.004435483870967742,0.0,Peak,Tuesday,February
2024-02-13 13:00:00,90,973,4,1,1068,266,407,16,2,691,32.3,55,2,20.7,1759,False,13,356,1380,20,3,2024-02-13,False,False,True,0.7845366685616828,0.20238772029562252,0.01137009664582149,0.0017055144968732233,Peak,Tuesday,February
2024-02-13 14:00:00,35,1321,2,0,1358,142,834,11,0,987,32.1,56,51,25.5,2345,False,14,177,2155,13,0,2024-02-13,False,False,True,0.9189765458422174,0.07547974413646055,0.005543710021321962,0.0,Peak,Tuesday,February
2024-02-13 15:00:00,28,229,5,1,263,110,269,7,1,387,32.7,54,2,24.0,650,False,15,138,498,12,2,2024-02-13,False,False,False,0.7661538461538462,0.2123076923076923,0.018461538461538463,0.003076923076923077,Peak,Tuesday,February
2024-02-13 16:00:00,34,484,4,1,523,110,534,15,1,660,31.7,57,53,21.3,1183,False,16,144,1018,19,2,2024-02-13,False,False,False,0.8605240912933221,0.12172442941673711,0.016060862214708368,0.0016906170752324597,Peak,Tuesday,February
2024-02-13 17:00:00,91,103,0,0,194,233,354,11,3,601,31.3,59,51,20.2,795,False,17,324,457,11,3,2024-02-13,False,False,False,0.5748427672955975,0.4075471698113208,0.013836477987421384,0.0037735849056603774,Peak,Tuesday,February
2024-02-13 18:00:00,95,1036,6,0,1137,342,711,10,2,1065,30.3,63,2,19.2,2202,False,18,437,1747,16,2,2024-02-13,False,False,True,0.793369663941871,0.19845594913714804,0.007266121707538601,0.0009082652134423251,Peak,Tuesday,February
2024-02-13 19:00:00,25,318,3,1,347,57,881,7,1,946,29.6,66,51,17.6,1293,False,19,82,1199,10,2,2024-02-13,False,False,False,0.9273008507347255,0.0634184068058778,0.007733952049497293,0.0015467904098994587,Peak,Tuesday,February
2024-02-13 20:00:00,42,333,3,0,378,112,414,6,2,534,28.6,71,3,14.9,912,False,20,154,747,9,2,2024-02-13,False,False,False,0.819078947368421,0.16885964912280702,0.009868421052631578,0.0021929824561403508,Shoulder,Tuesday,February
2024-02-13 21:00:00,35,356,6,0,397,63,324,12,1,400,27.9,77,3,17.9,797,False,21,98,680,18,1,2024-02-13,False,False,False,0.8531994981179423,0.12296110414052698,0.02258469259723965,0.0012547051442910915,Shoulder,Tuesday,February
2024-02-13 22:00:00,30,259,0,0,289,65,367,5,2,439,27.3,79,3,17.1,728,False,22,95,626,5,2,2024-02-13,False,False,False,0.8598901098901099,0.1304945054945055,0.006868131868131868,0.0027472527472527475,Shoulder,Tuesday,February
2024-02-13 23:00:00,10,240,0,0,250,66,228,5,0,299,27.0,80,3,17.8,549,False,23,76,468,5,0,2024-02-13,False,False,False,0.8524590163934426,0.1384335154826958,0.009107468123861567,0.0,Shoulder,Tuesday,February
2024-02-14 00:00:00,6,122,1,0,129,26,122,1,1,150,26.6,82,3,17.6,279,False,0,32,244,2,1,2024-02-14,False,False,False,0.8745519713261649,0.11469534050179211,0.007168458781362007,0.0035842293906810036,Off-Peak,Wednesday,February
2024-02-14 01:00:00,21,170,3,0,194,24,170,1,0,195,26.2,84,3,15.3,389,False,1,45,340,4,0,2024-02-14,False,False,False,0.8740359897172236,0.11568123393316196,0.010282776349614395,0.0,Off-Peak,Wednesday,February
2024-02-14 02:00:00,2,70,2,0,74,19,70,2,2,93,25.9,85,3,14.8,167,False,2,21,140,4,2,2024-02-14,False,False,False,0.8383233532934131,0.12574850299401197,0.023952095808383235,0.011976047904191617,Off-Peak,Wednesday,February
2024-02-14 03:00:00,8,72,2,0,82,23,72,3,1,99,25.5,86,3,14.3,181,False,3,31,144,5,1,2024-02-14,False,False,False,0.7955801104972375,0.1712707182320442,0.027624309392265192,0.0055248618784530384,Off-Peak,Wednesday,February
2024-02-14 04:00:00,3,103,1,1,108,36,103,7,0,146,25.4,87,3,14.0,254,False,4,39,206,8,1,2024-02-14,False,False,False,0.8110236220472441,0.15354330708661418,0.031496062992125984,0.003937007874015748,Off-Peak,Wednesday,February
2024-02-14 05:00:00,8,107,3,1,119,27,107,1,0,135,25.3,87,1,15.3,254,False,5,35,214,4,1,2024-02-14,False,False,False,0.84251968503937,0.1377952755905512,0.015748031496062992,0.003937007874015748,Shoulder,Wednesday,February
2024-02-14 06:00:00,57,301,2,1,361,32,301,0,1,334,25.2,87,0,15.9,695,False,6,89,602,2,2,2024-02-14,False,False,False,0.8661870503597122,0.12805755395683452,0.0028776978417266188,0.0028776978417266188,Shoulder,Wednesday,February
2024-02-14 07:00:00,73,504,3,1,581,38,504,4,0,546,25.1,88,0,16.2,1127,False,7,111,1008,7,1,2024-02-14,False,False,False,0.8944099378881988,0.09849157054125998,0.006211180124223602,0.0008873114463176575,Peak,Wednesday,February
2024-02-14 08:00:00,86,791,2,0,879,63,791,1,1,856,25.2,87,2,15.9,1735,False,8,149,1582,3,1,2024-02-14,False,False,True,0.9118155619596542,0.08587896253602305,0.001729106628242075,0.0005763688760806917,Peak,Wednesday,February
2024-02-14 09:00:00,56,747,0,1,804,90,747,3,1,841,27.1,82,51,20.7,1645,False,9,146,1494,3,2,2024-02-14,False,False,True,0.9082066869300912,0.08875379939209727,0.00182370820668693,0.0012158054711246201,Shoulder,Wednesday,February
2024-02-14 10:00:00,66,578,1,1,646,74,578,4,0,656,28.3,76,51,19.4,1302,False,10,140,1156,5,1,2024-02-14,False,False,False,0.8878648233486943,0.10752688172043011,0.0038402457757296467,0.0007680491551459293,Shoulder,Wednesday,February
2024-02-14 11:00:00,64,426,3,0,493,83,426,13,0,522,30.2,67,1,18.3,1015,False,11,147,852,16,0,2024-02-14,False,False,False,0.8394088669950739,0.14482758620689656,0.015763546798029555,0.0,Peak,Wednesday,February
2024-02-14 12:00:00,68,542,1,0,611,74,542,8,1,625,31.8,60,1,19.6,1236,False,12,142,1084,9,1,2024-02-14,False,False,False,0.8770226537216829,0.11488673139158576,0.007281553398058253,0.0008090614886731392,Peak,Wednesday,February
2024-02-14 13:00:00,90,1227,2,2,1321,90,1227,1,0,1318,32.1,62,3,16.6,2639,False,13,180,2454,3,2,2024-02-14,False,False,True,0.9298976885183782,0.06820765441455097,0.0011367942402425162,0.0007578628268283441,Peak,Wednesday,February
2024-02-14 14:00:00,35,994,2,0,1031,219,994,5,1,1219,30.4,68,53,16.8,2250,False,14,254,1988,7,1,2024-02-14,False,False,True,0.8835555555555555,0.11288888888888889,0.003111111111111111,0.00044444444444444447,Peak,Wednesday,February
2024-02-14 15:00:00,28,480,2,1,511,102,480,14,1,597,32.1,59,51,20.2,1108,False,15,130,960,16,2,2024-02-14,False,False,False,0.8664259927797834,0.11732851985559567,0.01444043321299639,0.0018050541516245488,Peak,Wednesday,February
2024-02-14 16:00:00,34,395,3,1,433,341,395,12,0,748,30.8,62,51,14.7,1181,False,16,375,790,15,1,2024-02-14,False,False,False,0.6689246401354784,0.31752751905165116,0.012701100762066046,0.000846740050804403,Peak,Wednesday,February
2024-02-14 17:00:00,91,988,0,3,1082,333,988,4,2,1327,30.8,64,51,14.0,2409,False,17,424,1976,4,5,2024-02-14,False,False,True,0.8202573682025737,0.17600664176006642,0.0016604400166044002,0.0020755500207555004,Peak,Wednesday,February
2024-02-14 18:00:00,95,674,3,2,774,303,674,6,2,985,31.0,61,51,12.0,1759,False,18,398,1348,9,4,2024-02-14,False,False,True,0.7663445139283684,0.22626492325184763,0.00511654349061967,0.0022740193291642978,Peak,Wednesday,February
2024-02-14 19:00:00,25,488,2,1,516,123,488,12,1,624,30.4,61,2,10.3,1140,False,19,148,976,14,2,2024-02-14,False,False,False,0.856140350877193,0.12982456140350876,0.012280701754385965,0.0017543859649122807,Peak,Wednesday,February
2024-02-14 20:00:00,42,375,1,2,420,154,375,10,4,543,29.3,65,2,11.0,963,False,20,196,750,11,6,2024-02-14,False,False,False,0.778816199376947,0.2035306334371755,0.01142263759086189,0.006230529595015576,Shoulder,Wednesday,February
2024-02-14 21:00:00,35,286,2,1,324,180,286,1,3,470,28.1,73,3,14.0,794,False,21,215,572,3,4,2024-02-14,False,False,False,0.7204030226700252,0.2707808564231738,0.003778337531486146,0.005037783375314861,Shoulder,Wednesday,February
2024-02-14 22:00:00,30,137,0,2,169,322,137,10,1,470,27.3,77,3,12.3,639,False,22,352,274,10,3,2024-02-14,False,False,False,0.4287949921752739,0.5508607198748043,0.01564945226917058,0.004694835680751174,Shoulder,Wednesday,February
2024-02-14 23:00:00,10,128,0,0,138,285,128,13,1,427,26.8,79,3,13.3,565,False,23,295,256,13,1,2024-02-14,False,False,False,0.45309734513274336,0.5221238938053098,0.023008849557522124,0.0017699115044247787,Shoulder,Wednesday,February
2024-02-15 00:00:00,19,55,1,0,75,39,55,1,0,95,26.4,82,3,14.8,170,False,0,58,110,2,0,2024-02-15,False,False,False,0.6470588235294118,0.3411764705882353,0.011764705882352941,0.0,Off-Peak,Thursday,February
2024-02-15 01:00:00,10,34,3,0,47,35,34,8,0,77,26.0,85,3,15.3,124,False,1,45,68,11,0,2024-02-15,False,False,False,0.5483870967741935,0.3629032258064516,0.08870967741935484,0.0,Off-Peak,Thursday,February
2024-02-15 02:00:00,15,174,2,0,191,27,174,1,0,202,25.7,86,3,15.1,393,False,2,42,348,3,0,2024-02-15,False,False,False,0.8854961832061069,0.10687022900763359,0.007633587786259542,0.0,Off-Peak,Thursday,February
2024-02-15 03:00:00,11,107,2,0,120,12,107,3,0,122,25.7,86,3,16.5,242,False,3,23,214,5,0,2024-02-15,False,False,False,0.8842975206611571,0.09504132231404959,0.02066115702479339,0.0,Off-Peak,Thursday,February
2024-02-15 04:00:00,26,219,1,0,246,18,219,2,1,240,25.7,85,0,16.7,486,False,4,44,438,3,1,2024-02-15,False,False,False,0.9012345679012346,0.09053497942386832,0.006172839506172839,0.00205761316872428,Off-Peak,Thursday,February
2024-02-15 05:00:00,15,265,3,0,283,67,265,4,1,337,25.4,86,3,16.1,620,False,5,82,530,7,1,2024-02-15,False,False,False,0.8548387096774194,0.13225806451612904,0.01129032258064516,0.0016129032258064516,Shoulder,Thursday,February
2024-02-15 06:00:00,45,327,2,1,375,147,327,8,1,483,25.2,86,3,15.0,858,False,6,192,654,10,2,2024-02-15,False,False,False,0.7622377622377622,0.22377622377622378,0.011655011655011656,0.002331002331002331,Shoulder,Thursday,February
2024-02-15 07:00:00,66,659,3,0,728,213,659,3,1,876,25.2,85,3,13.5,1604,False,7,279,1318,6,1,2024-02-15,False,False,True,0.8216957605985037,0.17394014962593515,0.003740648379052369,0.0006234413965087282,Peak,Thursday,February
2024-02-15 08:00:00,71,710,2,3,786,110,710,6,0,826,25.5,83,3,13.8,1612,False,8,181,1420,8,3,2024-02-15,False,False,True,0.8808933002481389,0.11228287841191067,0.004962779156327543,0.0018610421836228288,Peak,Thursday,February
2024-02-15 09:00:00,45,465,0,0,510,43,465,4,1,513,27.1,80,3,18.1,1023,False,9,88,930,4,1,2024-02-15,False,False,False,0.9090909090909091,0.08602150537634409,0.0039100684261974585,0.0009775171065493646,Shoulder,Thursday,February
2024-02-15 10:00:00,15,295,1,0,311,88,295,5,1,389,28.9,72,51,21.9,700,False,10,103,590,6,1,2024-02-15,False,False,False,0.8428571428571429,0.14714285714285713,0.008571428571428572,0.0014285714285714286,Shoulder,Thursday,February
2024-02-15 11:00:00,34,402,3,1,440,125,402,5,0,532,30.0,68,2,21.7,972,False,11,159,804,8,1,2024-02-15,False,False,False,0.8271604938271605,0.16358024691358025,0.00823045267489712,0.00102880658436214,Peak,Thursday,February
2024-02-15 12:00:00,68,749,1,1,819,297,749,9,0,1055,31.2,63,3,19.6,1874,False,12,365,1498,10,1,2024-02-15,False,False,True,0.7993596584845251,0.19477054429028814,0.005336179295624333,0.0005336179295624333,Peak,Thursday,February
2024-02-15 13:00:00,70,786,2,2,860,320,786,5,2,1113,28.9,75,61,20.5,1973,False,13,390,1572,7,4,2024-02-15,False,False,True,0.7967562088190573,0.19766852508869742,0.0035478966041561076,0.0020273694880892043,Peak,Thursday,February
2024-02-15 14:00:00,42,427,2,0,471,107,427,6,0,540,30.8,65,3,21.2,1011,False,14,149,854,8,0,2024-02-15,False,False,False,0.8447082096933729,0.14737883283877348,0.00791295746785361,0.0,Peak,Thursday,February
2024-02-15 15:00:00,37,230,2,0,269,120,230,7,1,358,30.5,65,51,18.6,627,False,15,157,460,9,1,2024-02-15,False,False,False,0.733652312599681,0.2503987240829346,0.014354066985645933,0.001594896331738437,Peak,Thursday,February
2024-02-15 16:00:00,99,348,3,2,452,206,348,11,1,566,30.4,64,51,19.9,1018,False,16,305,696,14,3,2024-02-15,False,False,False,0.6836935166994106,0.29960707269155207,0.0137524557956778,0.0029469548133595285,Peak,Thursday,February
2024-02-15 17:00:00,108,887,0,1,996,276,887,7,3,1173,30.5,64,51,15.6,2169,False,17,384,1774,7,4,2024-02-15,False,False,True,0.817888427846934,0.17704011065006917,0.003227293683725219,0.0018441678192715537,Peak,Thursday,February
2024-02-15 18:00:00,105,945,3,0,1053,139,945,9,2,1095,30.6,59,3,14.4,2148,False,18,244,1890,12,2,2024-02-15,False,False,True,0.8798882681564246,0.11359404096834265,0.00558659217877095,0.000931098696461825,Peak,Thursday,February
2024-02-15 19:00:00,22,400,2,0,424,175,400,7,1,583,30.1,58,3,12.9,1007,False,19,197,800,9,1,2024-02-15,False,False,False,0.7944389275074478,0.19563058589870905,0.00893743793445879,0.0009930486593843098,Peak,Thursday,February
2024-02-15 20:00:00,28,400,1,0,429,114,400,7,2,523,29.2,60,3,11.0,952,False,20,142,800,8,2,2024-02-15,False,False,False,0.8403361344537815,0.14915966386554622,0.008403361344537815,0.0021008403361344537,Shoulder,Thursday,February
2024-02-15 21:00:00,11,338,2,1,352,162,338,2,1,503,27.9,63,3,14.8,855,False,21,173,676,4,2,2024-02-15,False,False,False,0.7906432748538011,0.2023391812865497,0.004678362573099415,0.0023391812865497076,Shoulder,Thursday,February
2024-02-15 22:00:00,11,200,0,0,211,74,200,5,2,281,27.7,65,3,14.1,492,False,22,85,400,5,2,2024-02-15,False,False,False,0.8130081300813008,0.17276422764227642,0.01016260162601626,0.0040650406504065045,Shoulder,Thursday,February
2024-02-15 23:00:00,19,214,0,0,233,75,214,10,0,299,27.2,68,3,10.2,532,False,23,94,428,10,0,2024-02-15,False,False,False,0.8045112781954887,0.17669172932330826,0.018796992481203006,0.0,Shoulder,Thursday,February
2024-02-16 00:00:00,19,55,1,0,75,39,223,6,0,268,26.7,71,3,13.2,343,False,0,58,278,7,0,2024-02-16,False,False,False,0.8104956268221575,0.16909620991253643,0.02040816326530612,0.0,Off-Peak,Friday,February
2024-02-16 01:00:00,10,34,0,2,46,35,213,2,0,250,26.2,76,3,14.5,296,False,1,45,247,2,2,2024-02-16,False,False,False,0.8344594594594594,0.15202702702702703,0.006756756756756757,0.006756756756756757,Off-Peak,Friday,February
2024-02-16 02:00:00,15,174,1,0,190,27,231,5,0,263,25.8,79,3,13.6,453,False,2,42,405,6,0,2024-02-16,False,False,False,0.8940397350993378,0.09271523178807947,0.013245033112582781,0.0,Off-Peak,Friday,February
2024-02-16 03:00:00,11,107,1,0,119,12,101,7,0,120,25.7,80,3,13.6,239,False,3,23,208,8,0,2024-02-16,False,False,False,0.8702928870292888,0.09623430962343096,0.03347280334728033,0.0,Off-Peak,Friday,February
2024-02-16 04:00:00,26,219,1,0,246,18,33,7,1,59,25.6,81,3,12.2,305,False,4,44,252,8,1,2024-02-16,False,False,False,0.8262295081967214,0.14426229508196722,0.02622950819672131,0.003278688524590164,Off-Peak,Friday,February
2024-02-16 05:00:00,15,265,3,0,283,67,45,4,1,117,25.3,81,1,11.8,400,False,5,82,310,7,1,2024-02-16,False,False,False,0.775,0.205,0.0175,0.0025,Shoulder,Friday,February
2024-02-16 06:00:00,45,327,1,0,373,147,152,3,1,303,25.0,82,3,12.3,676,False,6,192,479,4,1,2024-02-16,False,False,False,0.7085798816568047,0.28402366863905326,0.005917159763313609,0.0014792899408284023,Shoulder,Friday,February
2024-02-16 07:00:00,66,659,0,1,726,213,52,1,1,267,24.9,83,3,11.0,993,False,7,279,711,1,2,2024-02-16,False,False,False,0.716012084592145,0.2809667673716012,0.0010070493454179255,0.002014098690835851,Peak,Friday,February
2024-02-16 08:00:00,71,710,1,0,782,110,124,2,0,236,25.1,82,2,11.1,1018,False,8,181,834,3,0,2024-02-16,False,False,False,0.8192534381139489,0.17779960707269155,0.0029469548133595285,0.0,Peak,Friday,February
2024-02-16 09:00:00,45,465,1,0,511,43,477,1,1,522,27.4,74,3,14.0,1033,False,9,88,942,2,1,2024-02-16,False,False,False,0.9119070667957405,0.08518877057115198,0.001936108422071636,0.000968054211035818,Shoulder,Friday,February
2024-02-16 10:00:00,15,295,1,0,311,88,470,9,1,568,29.1,66,3,18.7,879,False,10,103,765,10,1,2024-02-16,False,False,False,0.8703071672354948,0.11717861205915814,0.011376564277588168,0.0011376564277588168,Shoulder,Friday,February
2024-02-16 11:00:00,34,402,1,0,437,125,651,6,0,782,30.3,61,3,19.2,1219,False,11,159,1053,7,0,2024-02-16,False,False,False,0.8638228055783429,0.13043478260869565,0.005742411812961444,0.0,Peak,Friday,February
2024-02-16 12:00:00,68,749,0,3,820,297,500,5,0,802,32.0,55,3,18.4,1622,False,12,365,1249,5,3,2024-02-16,False,False,True,0.7700369913686806,0.22503082614056721,0.0030826140567200987,0.0018495684340320592,Peak,Friday,February
2024-02-16 13:00:00,70,786,0,0,856,320,1294,3,2,1619,32.7,54,3,17.4,2475,False,13,390,2080,3,2,2024-02-16,False,False,True,0.8404040404040404,0.15757575757575756,0.0012121212121212121,0.0008080808080808081,Peak,Friday,February
2024-02-16 14:00:00,42,427,2,1,472,107,843,1,0,951,33.7,51,3,16.1,1423,False,14,149,1270,3,1,2024-02-16,False,False,True,0.8924806746310612,0.10470836261419536,0.0021082220660576245,0.0007027406886858749,Peak,Friday,February
2024-02-16 15:00:00,37,230,2,0,269,120,539,9,1,669,30.3,63,61,21.2,938,False,15,157,769,11,1,2024-02-16,False,False,False,0.8198294243070362,0.1673773987206823,0.011727078891257996,0.0010660980810234541,Peak,Friday,February
2024-02-16 16:00:00,89,448,2,0,539,106,336,6,1,449,30.1,65,51,15.9,988,False,16,195,784,8,1,2024-02-16,False,False,False,0.7935222672064778,0.19736842105263158,0.008097165991902834,0.0010121457489878543,Peak,Friday,February
2024-02-16 17:00:00,98,887,2,0,987,276,827,5,3,1111,31.2,61,51,18.6,2098,False,17,374,1714,7,3,2024-02-16,False,False,True,0.8169685414680649,0.1782650142993327,0.003336510962821735,0.0014299332697807435,Peak,Friday,February
2024-02-16 18:00:00,94,945,2,0,1041,152,1350,7,2,1511,30.5,61,2,19.9,2552,False,18,246,2295,9,2,2024-02-16,False,False,True,0.899294670846395,0.09639498432601881,0.0035266457680250786,0.0007836990595611285,Peak,Friday,February
2024-02-16 19:00:00,22,458,4,1,485,123,434,6,1,564,29.5,66,3,14.5,1049,False,19,145,892,10,2,2024-02-16,False,False,False,0.8503336510962822,0.13822688274547187,0.009532888465204958,0.0019065776930409914,Peak,Friday,February
2024-02-16 20:00:00,28,400,0,0,428,114,206,5,2,327,28.6,70,1,11.7,755,False,20,142,606,5,2,2024-02-16,False,False,False,0.8026490066225166,0.1880794701986755,0.006622516556291391,0.0026490066225165563,Shoulder,Friday,February
2024-02-16 21:00:00,11,338,4,0,353,162,395,2,1,560,26.9,78,0,12.8,913,False,21,173,733,6,1,2024-02-16,False,False,False,0.8028477546549836,0.18948521358159912,0.0065717415115005475,0.001095290251916758,Shoulder,Friday,February
2024-02-16 22:00:00,11,200,2,0,213,74,156,0,2,232,26.4,80,0,11.5,445,False,22,85,356,2,2,2024-02-16,False,False,False,0.8,0.19101123595505617,0.0044943820224719105,0.0044943820224719105,Shoulder,Friday,February
2024-02-16 23:00:00,19,214,1,0,234,72,142,0,1,215,26.0,81,0,11.7,449,False,23,91,356,1,1,2024-02-16,False,False,False,0.7928730512249443,0.2026726057906459,0.0022271714922048997,0.0022271714922048997,Shoulder,Friday,February
2024-02-17 00:00:00,6,122,1,0,129,26,122,1,0,149,25.6,83,2,12.5,278,True,0,32,244,2,0,2024-02-17,False,False,False,0.8776978417266187,0.11510791366906475,0.007194244604316547,0.0,Off-Peak,Saturday,February
2024-02-17 01:00:00,21,170,3,2,196,24,170,8,0,202,25.4,84,1,12.0,398,True,1,45,340,11,2,2024-02-17,False,False,False,0.8542713567839196,0.11306532663316583,0.02763819095477387,0.005025125628140704,Off-Peak,Saturday,February
2024-02-17 02:00:00,2,70,2,0,74,19,70,1,0,90,25.1,85,0,12.0,164,True,2,21,140,3,0,2024-02-17,False,False,False,0.8536585365853658,0.12804878048780488,0.018292682926829267,0.0,Off-Peak,Saturday,February
2024-02-17 03:00:00,8,72,2,4,86,23,72,3,0,98,25.0,86,2,12.0,184,True,3,31,144,5,4,2024-02-17,False,False,False,0.782608695652174,0.16847826086956522,0.02717391304347826,0.021739130434782608,Off-Peak,Saturday,February
2024-02-17 04:00:00,3,103,1,1,108,36,103,2,1,142,24.8,87,0,11.5,250,True,4,39,206,3,2,2024-02-17,False,False,False,0.824,0.156,0.012,0.008,Off-Peak,Saturday,February
2024-02-17 05:00:00,8,107,3,1,119,27,107,4,1,139,24.6,88,0,11.8,258,True,5,35,214,7,2,2024-02-17,False,False,False,0.8294573643410853,0.13565891472868216,0.027131782945736434,0.007751937984496124,Shoulder,Saturday,February
2024-02-17 06:00:00,57,301,2,0,360,32,301,8,1,342,24.6,88,3,12.7,702,True,6,89,602,10,1,2024-02-17,False,False,False,0.8575498575498576,0.1267806267806268,0.014245014245014245,0.0014245014245014246,Shoulder,Saturday,February
2024-02-17 07:00:00,73,482,3,0,558,38,482,3,1,524,24.5,89,3,12.7,1082,True,7,111,964,6,1,2024-02-17,False,False,False,0.8909426987060998,0.10258780036968576,0.005545286506469501,0.0009242144177449168,Peak,Saturday,February
2024-02-17 08:00:00,86,791,2,0,879,63,791,6,0,860,24.8,88,3,13.2,1739,True,8,149,1582,8,0,2024-02-17,False,False,True,0.909718228867165,0.08568142610695802,0.004600345025876941,0.0,Peak,Saturday,February
2024-02-17 09:00:00,56,747,0,0,803,90,747,4,1,842,26.8,79,3,15.6,1645,True,9,146,1494,4,1,2024-02-17,False,False,True,0.9082066869300912,0.08875379939209727,0.0024316109422492403,0.0006079027355623101,Shoulder,Saturday,February
2024-02-17 10:00:00,66,578,1,2,647,74,578,7,1,660,28.7,70,3,17.6,1307,True,10,140,1156,8,3,2024-02-17,False,False,False,0.8844682478959449,0.10711553175210406,0.00612088752869166,0.0022953328232593728,Shoulder,Saturday,February
2024-02-17 11:00:00,64,426,3,0,493,83,426,5,2,516,30.2,63,3,20.2,1009,True,11,147,852,8,2,2024-02-17,False,False,False,0.844400396432111,0.14568880079286423,0.007928642220019821,0.0019821605550049554,Peak,Saturday,February
2024-02-17 12:00:00,68,549,1,0,618,74,549,9,0,632,31.1,58,3,20.2,1250,True,12,142,1098,10,0,2024-02-17,False,False,False,0.8784,0.1136,0.008,0.0,Peak,Saturday,February
2024-02-17 13:00:00,90,1127,2,1,1220,90,1127,5,2,1224,31.9,56,51,18.6,2444,True,13,180,2254,7,3,2024-02-17,False,False,True,0.9222585924713584,0.07364975450081833,0.0028641571194762683,0.0012274959083469722,Peak,Saturday,February
2024-02-17 14:00:00,35,994,2,0,1031,219,994,10,0,1223,32.0,55,51,16.3,2254,True,14,254,1988,12,0,2024-02-17,False,False,True,0.8819875776397516,0.1126885536823425,0.005323868677905945,0.0,Peak,Saturday,February
2024-02-17 15:00:00,28,480,2,0,510,102,480,7,0,589,32.0,53,51,13.7,1099,True,15,130,960,9,0,2024-02-17,False,False,False,0.8735213830755232,0.11828935395814377,0.00818926296633303,0.0,Peak,Saturday,February
2024-02-17 16:00:00,34,395,3,0,432,341,395,11,1,748,31.9,53,51,13.9,1180,True,16,375,790,14,1,2024-02-17,False,False,False,0.6694915254237288,0.3177966101694915,0.011864406779661017,0.000847457627118644,Peak,Saturday,February
2024-02-17 17:00:00,91,988,0,1,1080,333,988,7,6,1334,30.3,62,53,14.5,2414,True,17,424,1976,7,7,2024-02-17,False,False,True,0.8185584092792046,0.1756420878210439,0.002899751449875725,0.002899751449875725,Peak,Saturday,February
2024-02-17 18:00:00,95,674,3,2,774,303,674,9,2,988,30.5,60,51,12.3,1762,True,18,398,1348,12,4,2024-02-17,False,False,True,0.7650397275822929,0.22587968217934165,0.00681044267877412,0.0022701475595913734,Peak,Saturday,February
2024-02-17 19:00:00,53,488,2,0,543,123,488,7,1,619,29.8,63,51,9.5,1162,True,19,176,976,9,1,2024-02-17,False,False,False,0.8399311531841652,0.1514629948364888,0.00774526678141136,0.0008605851979345956,Peak,Saturday,February
2024-02-17 20:00:00,42,375,1,0,418,154,375,7,2,538,29.1,65,3,11.8,956,True,20,196,750,8,2,2024-02-17,False,False,False,0.7845188284518828,0.20502092050209206,0.008368200836820083,0.0020920502092050207,Shoulder,Saturday,February
2024-02-17 21:00:00,35,286,3,0,324,180,286,7,1,474,27.9,78,3,6.6,798,True,21,215,572,10,1,2024-02-17,False,False,False,0.7167919799498746,0.2694235588972431,0.012531328320802004,0.0012531328320802004,Shoulder,Saturday,February
2024-02-17 22:00:00,30,167,0,0,197,341,167,5,2,515,27.4,80,3,10.6,712,True,22,371,334,5,2,2024-02-17,False,False,False,0.4691011235955056,0.5210674157303371,0.007022471910112359,0.0028089887640449437,Shoulder,Saturday,February
2024-02-17 23:00:00,10,137,0,0,147,285,137,10,0,432,26.8,80,3,12.1,579,True,23,295,274,10,0,2024-02-17,False,False,False,0.47322970639032813,0.5094991364421416,0.017271157167530225,0.0,Shoulder,Saturday,February
2024-02-18 00:00:00,9,223,1,0,233,31,223,7,0,261,26.3,81,1,12.0,494,True,0,40,446,8,0,2024-02-18,False,False,False,0.902834008097166,0.08097165991902834,0.016194331983805668,0.0,Off-Peak,Sunday,February
2024-02-18 01:00:00,19,213,0,0,232,21,213,6,0,240,25.7,84,1,10.7,472,True,1,40,426,6,0,2024-02-18,False,False,False,0.902542372881356,0.0847457627118644,0.012711864406779662,0.0,Off-Peak,Sunday,February
2024-02-18 02:00:00,2,231,1,0,234,22,231,0,0,253,25.4,86,3,12.2,487,True,2,24,462,1,0,2024-02-18,False,False,False,0.9486652977412731,0.049281314168377825,0.002053388090349076,0.0,Off-Peak,Sunday,February
2024-02-18 03:00:00,14,101,1,0,116,24,101,7,0,132,25.2,88,3,12.7,248,True,3,38,202,8,0,2024-02-18,False,False,False,0.8145161290322581,0.1532258064516129,0.03225806451612903,0.0,Off-Peak,Sunday,February
2024-02-18 04:00:00,24,33,1,1,59,63,33,5,1,102,25.0,89,3,13.3,161,True,4,87,66,6,2,2024-02-18,False,False,False,0.40993788819875776,0.5403726708074534,0.037267080745341616,0.012422360248447204,Off-Peak,Sunday,February
2024-02-18 05:00:00,40,45,3,1,89,82,45,0,1,128,24.9,90,3,13.0,217,True,5,122,90,3,2,2024-02-18,False,False,False,0.4147465437788018,0.5622119815668203,0.013824884792626729,0.009216589861751152,Shoulder,Sunday,February
2024-02-18 06:00:00,57,152,1,1,211,41,152,5,1,199,24.7,91,3,13.2,410,True,6,98,304,6,2,2024-02-18,False,False,False,0.7414634146341463,0.23902439024390243,0.014634146341463415,0.004878048780487805,Shoulder,Sunday,February
2024-02-18 07:00:00,87,52,0,0,139,275,52,6,1,334,24.6,91,3,14.8,473,True,7,362,104,6,1,2024-02-18,False,False,False,0.21987315010570824,0.7653276955602537,0.012684989429175475,0.0021141649048625794,Peak,Sunday,February
2024-02-18 08:00:00,93,124,1,0,218,248,124,9,0,381,24.9,89,2,15.8,599,True,8,341,248,10,0,2024-02-18,False,False,False,0.41402337228714525,0.5692821368948247,0.01669449081803005,0.0,Peak,Sunday,February
2024-02-18 09:00:00,47,477,1,1,526,163,477,9,1,650,27.3,84,3,12.8,1176,True,9,210,954,10,2,2024-02-18,False,False,False,0.8112244897959183,0.17857142857142858,0.008503401360544218,0.0017006802721088435,Shoulder,Sunday,February
2024-02-18 10:00:00,64,470,1,1,536,117,470,5,1,593,29.1,73,3,14.1,1129,True,10,181,940,6,2,2024-02-18,False,False,False,0.8325952170062002,0.16031886625332153,0.005314437555358724,0.001771479185119575,Shoulder,Sunday,February
2024-02-18 11:00:00,37,651,1,0,689,164,651,5,0,820,31.1,63,3,12.7,1509,True,11,201,1302,6,0,2024-02-18,False,False,True,0.8628230616302187,0.13320079522862824,0.003976143141153081,0.0,Peak,Sunday,February
2024-02-18 12:00:00,99,500,0,0,599,153,500,6,0,659,32.5,57,3,10.1,1258,True,12,252,1000,6,0,2024-02-18,False,False,False,0.794912559618442,0.20031796502384738,0.0047694753577106515,0.0,Peak,Sunday,February
2024-02-18 13:00:00,127,1242,7,1,1377,396,1242,5,2,1645,33.3,54,51,7.9,3022,True,13,523,2484,12,3,2024-02-18,False,False,True,0.8219722038385175,0.17306419589675712,0.003970880211780278,0.0009927200529450694,Peak,Sunday,February
2024-02-18 14:00:00,36,843,2,0,881,350,843,6,0,1199,33.3,55,51,3.4,2080,True,14,386,1686,8,0,2024-02-18,False,False,True,0.8105769230769231,0.18557692307692308,0.0038461538461538464,0.0,Peak,Sunday,February
2024-02-18 15:00:00,33,539,2,1,575,174,539,7,1,721,32.3,61,3,10.8,1296,True,15,207,1078,9,2,2024-02-18,False,False,False,0.8317901234567902,0.1597222222222222,0.006944444444444444,0.0015432098765432098,Peak,Sunday,February
2024-02-18 16:00:00,38,436,2,1,477,134,436,15,1,586,29.2,75,63,8.5,1063,True,16,172,872,17,2,2024-02-18,False,False,False,0.8203198494825964,0.16180620884289745,0.01599247412982126,0.0018814675446848542,Peak,Sunday,February
2024-02-18 17:00:00,107,927,2,0,1036,258,927,11,3,1199,29.6,74,51,8.1,2235,True,17,365,1854,13,3,2024-02-18,False,False,True,0.8295302013422818,0.16331096196868009,0.0058165548098434005,0.0013422818791946308,Peak,Sunday,February
2024-02-18 18:00:00,76,1350,2,2,1430,142,1350,10,2,1504,28.0,81,63,8.4,2934,True,18,218,2700,12,4,2024-02-18,False,False,True,0.9202453987730062,0.07430129516019086,0.00408997955010225,0.0013633265167007499,Peak,Sunday,February
2024-02-18 19:00:00,52,434,4,1,491,148,434,7,1,590,27.2,86,61,0.7,1081,True,19,200,868,11,2,2024-02-18,False,False,False,0.8029602220166513,0.18501387604070305,0.010175763182238668,0.0018501387604070306,Peak,Sunday,February
2024-02-18 20:00:00,35,206,0,2,243,171,206,6,2,385,26.4,91,51,3.3,628,True,20,206,412,6,4,2024-02-18,False,False,False,0.6560509554140127,0.32802547770700635,0.009554140127388535,0.006369426751592357,Shoulder,Sunday,February
2024-02-18 21:00:00,49,395,4,1,449,146,395,12,1,554,27.8,82,3,7.1,1003,True,21,195,790,16,2,2024-02-18,False,False,False,0.7876370887337986,0.19441674975074777,0.015952143569292122,0.0019940179461615153,Shoulder,Sunday,February
2024-02-18 22:00:00,36,156,2,2,196,131,156,5,2,294,27.4,80,3,9.9,490,True,22,167,312,7,4,2024-02-18,False,False,False,0.636734693877551,0.3408163265306122,0.014285714285714285,0.00816326530612245,Shoulder,Sunday,February
2024-02-18 23:00:00,44,142,1,1,188,71,142,5,1,219,26.9,77,3,10.5,407,True,23,115,284,6,2,2024-02-18,False,False,False,0.6977886977886978,0.28255528255528256,0.014742014742014743,0.004914004914004914,Shoulder,Sunday,February
2024-02-19 00:00:00,9,122,1,1,133,16,122,7,0,145,26.4,77,3,12.5,278,False,0,25,244,8,1,2024-02-19,False,False,False,0.8776978417266187,0.08992805755395683,0.02877697841726619,0.0035971223021582736,Off-Peak,Monday,February
2024-02-19 01:00:00,19,170,0,0,189,13,170,6,0,189,25.8,81,3,12.5,378,False,1,32,340,6,0,2024-02-19,False,False,False,0.8994708994708994,0.08465608465608465,0.015873015873015872,0.0,Off-Peak,Monday,February
2024-02-19 02:00:00,2,70,1,0,73,43,70,10,1,124,25.4,83,3,14.3,197,False,2,45,140,11,1,2024-02-19,False,False,False,0.7106598984771574,0.22842639593908629,0.05583756345177665,0.005076142131979695,Off-Peak,Monday,February
2024-02-19 03:00:00,14,72,1,0,87,54,72,7,0,133,25.2,86,2,14.0,220,False,3,68,144,8,0,2024-02-19,False,False,False,0.6545454545454545,0.3090909090909091,0.03636363636363636,0.0,Off-Peak,Monday,February
2024-02-19 04:00:00,24,103,1,0,128,86,103,5,0,194,24.9,87,3,13.8,322,False,4,110,206,6,0,2024-02-19,False,False,False,0.639751552795031,0.3416149068322981,0.018633540372670808,0.0,Off-Peak,Monday,February
2024-02-19 05:00:00,40,107,3,0,150,78,107,0,0,185,24.9,88,3,14.3,335,False,5,118,214,3,0,2024-02-19,False,False,False,0.6388059701492538,0.3522388059701492,0.008955223880597015,0.0,Shoulder,Monday,February
2024-02-19 06:00:00,57,301,1,1,360,116,301,5,0,422,24.7,89,3,15.3,782,False,6,173,602,6,1,2024-02-19,False,False,False,0.7698209718670077,0.22122762148337596,0.0076726342710997444,0.0012787723785166241,Shoulder,Monday,February
2024-02-19 07:00:00,87,482,3,0,572,179,482,6,0,667,24.7,89,1,15.3,1239,False,7,266,964,9,0,2024-02-19,False,False,False,0.778046811945117,0.21468926553672316,0.007263922518159807,0.0,Peak,Monday,February
2024-02-19 08:00:00,93,791,1,3,888,217,791,9,3,1020,25.1,88,0,15.1,1908,False,8,310,1582,10,6,2024-02-19,False,False,True,0.8291404612159329,0.16247379454926625,0.005241090146750524,0.0031446540880503146,Peak,Monday,February
2024-02-19 09:00:00,47,747,1,0,795,156,747,9,0,912,27.6,82,3,14.8,1707,False,9,203,1494,10,0,2024-02-19,False,False,True,0.875219683655536,0.11892208553016989,0.005858230814294083,0.0,Shoulder,Monday,February
2024-02-19 10:00:00,64,578,1,0,643,100,578,5,2,685,29.7,71,3,15.5,1328,False,10,164,1156,6,2,2024-02-19,False,False,False,0.8704819277108434,0.12349397590361445,0.004518072289156626,0.0015060240963855422,Shoulder,Monday,February
2024-02-19 11:00:00,37,426,1,1,465,81,426,5,1,513,31.3,61,3,14.3,978,False,11,118,852,6,2,2024-02-19,False,False,False,0.8711656441717791,0.12065439672801637,0.006134969325153374,0.002044989775051125,Peak,Monday,February
2024-02-19 12:00:00,99,549,3,1,652,91,549,10,4,654,32.5,55,51,12.2,1306,False,12,190,1098,13,5,2024-02-19,False,False,False,0.8407350689127105,0.14548238897396631,0.009954058192955589,0.0038284839203675345,Peak,Monday,February
2024-02-19 13:00:00,27,1162,7,2,1198,241,1162,16,0,1419,28.9,76,63,17.1,2617,False,13,268,2324,23,2,2024-02-19,False,False,True,0.8880397401604891,0.10240733664501338,0.008788689338937715,0.0007642338555598013,Peak,Monday,February
2024-02-19 14:00:00,36,994,2,0,1032,338,994,11,1,1344,28.7,81,61,4.7,2376,False,14,374,1988,13,1,2024-02-19,False,False,True,0.8367003367003367,0.1574074074074074,0.005471380471380472,0.00042087542087542086,Peak,Monday,February
2024-02-19 15:00:00,33,480,2,0,515,228,480,7,3,718,28.0,81,63,8.3,1233,False,15,261,960,9,3,2024-02-19,False,False,False,0.7785888077858881,0.2116788321167883,0.0072992700729927005,0.0024330900243309003,Peak,Monday,February
2024-02-19 16:00:00,38,395,2,2,437,177,395,15,2,589,29.0,79,3,7.9,1026,False,16,215,790,17,4,2024-02-19,False,False,False,0.7699805068226121,0.20955165692007796,0.016569200779727095,0.003898635477582846,Peak,Monday,February
2024-02-19 17:00:00,107,988,2,1,1098,132,988,11,2,1133,30.6,72,51,8.5,2231,False,17,239,1976,13,3,2024-02-19,False,False,True,0.8857014791573286,0.10712684894666069,0.00582698341550874,0.001344688480502017,Peak,Monday,February
2024-02-19 18:00:00,76,674,2,0,752,214,674,10,0,898,29.1,75,61,9.2,1650,False,18,290,1348,12,0,2024-02-19,False,False,True,0.816969696969697,0.17575757575757575,0.007272727272727273,0.0,Peak,Monday,February
2024-02-19 19:00:00,52,488,4,0,544,427,488,7,5,927,28.6,78,3,9.2,1471,False,19,479,976,11,5,2024-02-19,False,False,True,0.663494221617947,0.3256288239292998,0.007477906186267845,0.003399048266485384,Peak,Monday,February
2024-02-19 20:00:00,45,375,3,0,423,103,375,6,3,487,27.0,85,51,10.8,910,False,20,148,750,9,3,2024-02-19,False,False,False,0.8241758241758241,0.16263736263736264,0.00989010989010989,0.0032967032967032967,Shoulder,Monday,February
2024-02-19 21:00:00,49,186,4,1,240,53,186,1,2,242,27.4,86,3,3.9,482,False,21,102,372,5,3,2024-02-19,False,False,False,0.7717842323651453,0.21161825726141079,0.01037344398340249,0.006224066390041493,Shoulder,Monday,February
2024-02-19 22:00:00,36,167,2,0,205,12,167,5,3,187,27.4,85,3,6.9,392,False,22,48,334,7,3,2024-02-19,False,False,False,0.8520408163265306,0.12244897959183673,0.017857142857142856,0.007653061224489796,Shoulder,Monday,February
2024-02-19 23:00:00,44,137,1,0,182,32,137,5,4,178,27.1,86,3,8.7,360,False,23,76,274,6,4,2024-02-19,False,False,False,0.7611111111111111,0.2111111111111111,0.016666666666666666,0.011111111111111112,Shoulder,Monday,February
2024-02-20 00:00:00,6,122,1,1,130,21,122,7,0,150,26.8,86,3,6.9,280,False,0,27,244,8,1,2024-02-20,False,False,False,0.8714285714285714,0.09642857142857143,0.02857142857142857,0.0035714285714285713,Off-Peak,Tuesday,February
2024-02-20 01:00:00,21,170,0,0,191,8,170,6,1,185,26.2,89,3,6.5,376,False,1,29,340,6,1,2024-02-20,False,False,False,0.9042553191489362,0.07712765957446809,0.015957446808510637,0.0026595744680851063,Off-Peak,Tuesday,February
2024-02-20 02:00:00,2,70,1,0,73,30,70,10,0,110,25.8,91,3,8.4,183,False,2,32,140,11,0,2024-02-20,False,False,False,0.7650273224043715,0.17486338797814208,0.060109289617486336,0.0,Off-Peak,Tuesday,February
2024-02-20 03:00:00,8,72,1,0,81,52,72,7,1,132,25.5,94,3,10.0,213,False,3,60,144,8,1,2024-02-20,False,False,False,0.676056338028169,0.28169014084507044,0.03755868544600939,0.004694835680751174,Off-Peak,Tuesday,February
2024-02-20 04:00:00,3,103,1,0,107,69,103,5,0,177,25.1,96,3,9.8,284,False,4,72,206,6,0,2024-02-20,False,False,False,0.7253521126760564,0.2535211267605634,0.02112676056338028,0.0,Off-Peak,Tuesday,February
2024-02-20 05:00:00,8,107,3,0,118,126,107,0,1,234,25.0,97,3,8.4,352,False,5,134,214,3,1,2024-02-20,False,False,False,0.6079545454545454,0.3806818181818182,0.008522727272727272,0.002840909090909091,Shoulder,Tuesday,February
2024-02-20 06:00:00,57,301,1,1,360,193,301,5,0,499,24.9,97,3,9.4,859,False,6,250,602,6,1,2024-02-20,False,False,False,0.7008149010477299,0.2910360884749709,0.006984866123399301,0.0011641443538998836,Shoulder,Tuesday,February
2024-02-20 07:00:00,73,482,3,0,558,233,482,6,0,721,24.9,97,3,9.3,1279,False,7,306,964,9,0,2024-02-20,False,False,False,0.7537138389366693,0.23924941360437843,0.007036747458952306,0.0,Peak,Tuesday,February
2024-02-20 08:00:00,86,791,1,3,881,76,791,9,1,877,25.4,94,3,10.1,1758,False,8,162,1582,10,4,2024-02-20,False,False,True,0.8998862343572241,0.09215017064846416,0.005688282138794084,0.0022753128555176336,Peak,Tuesday,February
2024-02-20 09:00:00,56,747,1,0,804,152,747,9,0,908,27.2,92,3,13.2,1712,False,9,208,1494,10,0,2024-02-20,False,False,True,0.8726635514018691,0.12149532710280374,0.005841121495327103,0.0,Shoulder,Tuesday,February
2024-02-20 10:00:00,66,578,1,0,645,134,578,5,0,717,28.8,82,3,14.2,1362,False,10,200,1156,6,0,2024-02-20,False,False,False,0.8487518355359766,0.14684287812041116,0.004405286343612335,0.0,Shoulder,Tuesday,February
2024-02-20 11:00:00,64,426,1,1,492,142,426,5,1,574,30.3,74,3,11.5,1066,False,11,206,852,6,2,2024-02-20,False,False,False,0.799249530956848,0.19324577861163228,0.005628517823639775,0.001876172607879925,Peak,Tuesday,February
2024-02-20 12:00:00,68,549,2,1,620,269,549,0,0,818,31.0,71,51,6.4,1438,False,12,337,1098,2,1,2024-02-20,False,False,True,0.7635605006954103,0.23435326842837273,0.0013908205841446453,0.0006954102920723226,Peak,Tuesday,February
2024-02-20 13:00:00,90,1162,7,2,1261,266,1162,16,1,1445,31.8,68,51,7.2,2706,False,13,356,2324,23,3,2024-02-20,False,False,True,0.8588322246858833,0.13155949741315595,0.008499630450849963,0.0011086474501108647,Peak,Tuesday,February
2024-02-20 14:00:00,35,994,2,0,1031,142,994,11,0,1147,31.4,73,53,8.8,2178,False,14,177,1988,13,0,2024-02-20,False,False,True,0.9127640036730946,0.081267217630854,0.005968778696051423,0.0,Peak,Tuesday,February
2024-02-20 15:00:00,28,480,2,0,510,110,480,7,2,599,30.0,80,63,11.8,1109,False,15,138,960,9,2,2024-02-20,False,False,False,0.8656447249774571,0.12443642921550947,0.008115419296663661,0.0018034265103697023,Peak,Tuesday,February
2024-02-20 16:00:00,34,395,2,2,433,110,395,15,4,524,29.7,79,53,10.2,957,False,16,144,790,17,6,2024-02-20,False,False,False,0.8254963427377221,0.15047021943573669,0.017763845350052248,0.006269592476489028,Peak,Tuesday,February
2024-02-20 17:00:00,88,988,2,1,1079,233,988,11,2,1234,28.8,82,51,10.5,2313,False,17,321,1976,13,3,2024-02-20,False,False,True,0.8543017725897103,0.13878080415045396,0.005620406398616515,0.0012970168612191958,Peak,Tuesday,February
2024-02-20 18:00:00,92,674,2,0,768,342,674,10,0,1026,28.6,81,51,7.7,1794,False,18,434,1348,12,0,2024-02-20,False,False,True,0.7513935340022296,0.241917502787068,0.006688963210702341,0.0,Peak,Tuesday,February
2024-02-20 19:00:00,73,488,4,0,565,58,488,7,3,556,27.4,84,53,10.5,1121,False,19,131,976,11,3,2024-02-20,False,False,False,0.8706512042818911,0.11685994647636039,0.009812667261373774,0.0026761819803746653,Peak,Tuesday,February
2024-02-20 20:00:00,47,375,3,0,425,112,375,6,3,496,27.0,85,2,12.7,921,False,20,159,750,9,3,2024-02-20,False,False,False,0.8143322475570033,0.17263843648208468,0.009771986970684038,0.003257328990228013,Shoulder,Tuesday,February
2024-02-20 21:00:00,34,186,4,1,225,73,186,1,1,261,26.2,89,51,11.7,486,False,21,107,372,5,2,2024-02-20,False,False,False,0.7654320987654321,0.22016460905349794,0.0102880658436214,0.00411522633744856,Shoulder,Tuesday,February
2024-02-20 22:00:00,30,167,2,0,199,65,167,5,3,240,25.6,91,53,8.2,439,False,22,95,334,7,3,2024-02-20,False,False,False,0.7608200455580866,0.2164009111617312,0.015945330296127564,0.00683371298405467,Shoulder,Tuesday,February
2024-02-20 23:00:00,10,137,1,0,148,66,137,5,4,212,25.0,93,63,8.7,360,False,23,76,274,6,4,2024-02-20,False,False,False,0.7611111111111111,0.2111111111111111,0.016666666666666666,0.011111111111111112,Shoulder,Tuesday,February
2024-02-21 00:00:00,9,36,1,0,46,21,36,1,0,58,24.8,95,51,6.7,104,False,0,30,72,2,0,2024-02-21,False,False,False,0.6923076923076923,0.28846153846153844,0.019230769230769232,0.0,Off-Peak,Wednesday,February
2024-02-21 01:00:00,19,71,0,0,90,8,71,8,1,88,24.4,94,51,5.4,178,False,1,27,142,8,1,2024-02-21,False,False,False,0.797752808988764,0.15168539325842698,0.0449438202247191,0.0056179775280898875,Off-Peak,Wednesday,February
2024-02-21 02:00:00,2,26,1,0,29,30,26,1,0,57,23.5,97,65,5.9,86,False,2,32,52,2,0,2024-02-21,False,False,False,0.6046511627906976,0.37209302325581395,0.023255813953488372,0.0,Off-Peak,Wednesday,February
2024-02-21 03:00:00,14,48,1,0,63,52,48,3,0,103,23.5,95,63,5.4,166,False,3,66,96,4,0,2024-02-21,False,False,False,0.5783132530120482,0.39759036144578314,0.024096385542168676,0.0,Off-Peak,Wednesday,February
2024-02-21 04:00:00,24,60,1,0,85,69,60,2,1,132,23.5,94,51,5.6,217,False,4,93,120,3,1,2024-02-21,False,False,False,0.5529953917050692,0.42857142857142855,0.013824884792626729,0.004608294930875576,Off-Peak,Wednesday,February
2024-02-21 05:00:00,40,51,3,0,94,126,51,4,1,182,23.6,93,51,10.3,276,False,5,166,102,7,1,2024-02-21,False,False,False,0.3695652173913043,0.6014492753623188,0.025362318840579712,0.0036231884057971015,Shoulder,Wednesday,February
2024-02-21 06:00:00,57,446,1,1,505,193,446,8,1,648,23.2,96,51,5.0,1153,False,6,250,892,9,2,2024-02-21,False,False,False,0.7736339982653946,0.2168256721595837,0.007805724197745013,0.0017346053772766695,Shoulder,Wednesday,February
2024-02-21 07:00:00,87,770,0,0,857,233,770,3,1,1007,23.2,96,51,3.1,1864,False,7,320,1540,3,1,2024-02-21,False,False,True,0.8261802575107297,0.17167381974248927,0.001609442060085837,0.000536480686695279,Peak,Wednesday,February
2024-02-21 08:00:00,93,837,1,0,931,76,837,6,0,919,23.5,94,3,4.6,1850,False,8,169,1674,7,0,2024-02-21,False,False,True,0.9048648648648648,0.09135135135135135,0.0037837837837837837,0.0,Peak,Wednesday,February
2024-02-21 09:00:00,47,795,1,0,843,152,795,9,0,956,25.6,91,3,8.5,1799,False,9,199,1590,10,0,2024-02-21,False,False,True,0.8838243468593663,0.11061700944969427,0.005558643690939411,0.0,Shoulder,Wednesday,February
2024-02-21 10:00:00,34,563,1,0,598,134,563,7,1,705,25.8,89,51,12.8,1303,False,10,168,1126,8,1,2024-02-21,False,False,False,0.86415963161934,0.1289332310053722,0.0061396776669224865,0.0007674597083653108,Shoulder,Wednesday,February
2024-02-21 11:00:00,37,509,1,0,547,142,509,5,0,656,27.4,82,51,14.2,1203,False,11,179,1018,6,0,2024-02-21,False,False,False,0.8462177888611804,0.1487946799667498,0.004987531172069825,0.0,Peak,Wednesday,February
2024-02-21 12:00:00,79,868,2,0,949,269,868,7,0,1144,29.0,76,51,10.3,2093,False,12,348,1736,9,0,2024-02-21,False,False,True,0.8294314381270903,0.16626851409460106,0.004300047778308648,0.0,Peak,Wednesday,February
2024-02-21 13:00:00,27,1007,7,1,1042,266,1007,5,0,1278,30.4,72,3,5.4,2320,False,13,293,2014,12,1,2024-02-21,False,False,True,0.868103448275862,0.12629310344827585,0.005172413793103448,0.0004310344827586207,Peak,Wednesday,February
2024-02-21 14:00:00,36,417,2,0,455,142,417,10,0,569,31.6,68,3,2.3,1024,False,14,178,834,12,0,2024-02-21,False,False,False,0.814453125,0.173828125,0.01171875,0.0,Peak,Wednesday,February
2024-02-21 15:00:00,33,434,4,0,471,110,434,7,1,552,31.9,65,3,8.2,1023,False,15,143,868,11,1,2024-02-21,False,False,False,0.8484848484848485,0.13978494623655913,0.010752688172043012,0.0009775171065493646,Peak,Wednesday,February
2024-02-21 16:00:00,38,538,2,2,580,110,538,11,1,660,28.5,78,63,5.4,1240,False,16,148,1076,13,3,2024-02-21,False,False,False,0.867741935483871,0.11935483870967742,0.010483870967741936,0.0024193548387096775,Peak,Wednesday,February
2024-02-21 17:00:00,57,1028,2,1,1088,233,1028,7,0,1268,29.0,75,51,6.2,2356,False,17,290,2056,9,1,2024-02-21,False,False,True,0.8726655348047538,0.1230899830220713,0.0038200339558573855,0.00042444821731748726,Peak,Wednesday,February
2024-02-21 18:00:00,76,956,2,0,1034,318,956,9,2,1285,29.1,76,0,5.2,2319,False,18,394,1912,11,2,2024-02-21,False,False,True,0.8244933160845191,0.16990081931867185,0.004743423889607589,0.0008624407072013799,Peak,Wednesday,February
2024-02-21 19:00:00,52,321,4,0,377,76,321,7,1,405,28.5,79,0,3.8,782,False,19,128,642,11,1,2024-02-21,False,False,False,0.8209718670076727,0.1636828644501279,0.014066496163682864,0.0012787723785166241,Peak,Wednesday,February
2024-02-21 20:00:00,45,453,0,0,498,112,453,7,2,574,27.2,86,1,3.7,1072,False,20,157,906,7,2,2024-02-21,False,False,False,0.8451492537313433,0.146455223880597,0.0065298507462686565,0.0018656716417910447,Shoulder,Wednesday,February
2024-02-21 21:00:00,49,317,4,1,371,73,317,7,1,398,26.6,91,2,8.8,769,False,21,122,634,11,2,2024-02-21,False,False,False,0.8244473342002601,0.15864759427828348,0.014304291287386216,0.002600780234070221,Shoulder,Wednesday,February
2024-02-21 22:00:00,36,239,2,0,277,65,239,5,2,311,26.3,90,1,10.5,588,False,22,101,478,7,2,2024-02-21,False,False,False,0.8129251700680272,0.1717687074829932,0.011904761904761904,0.003401360544217687,Shoulder,Wednesday,February
2024-02-21 23:00:00,44,141,1,0,186,66,141,10,1,218,25.6,91,3,9.2,404,False,23,110,282,11,1,2024-02-21,False,False,False,0.698019801980198,0.2722772277227723,0.027227722772277228,0.0024752475247524753,Shoulder,Wednesday,February
2024-02-22 00:00:00,9,223,0,0,232,31,223,1,0,255,25.2,92,1,10.3,487,False,0,40,446,1,0,2024-02-22,False,False,False,0.9158110882956879,0.08213552361396304,0.002053388090349076,0.0,Off-Peak,Thursday,February
2024-02-22 01:00:00,19,213,1,0,233,21,213,8,1,243,24.9,93,2,9.4,476,False,1,40,426,9,1,2024-02-22,False,False,False,0.8949579831932774,0.08403361344537816,0.018907563025210083,0.0021008403361344537,Off-Peak,Thursday,February
2024-02-22 02:00:00,2,231,1,0,234,22,231,1,0,254,24.7,93,2,11.0,488,False,2,24,462,2,0,2024-02-22,False,False,False,0.9467213114754098,0.04918032786885246,0.004098360655737705,0.0,Off-Peak,Thursday,February
2024-02-22 03:00:00,14,101,0,0,115,24,101,3,0,128,24.4,94,1,8.4,243,False,3,38,202,3,0,2024-02-22,False,False,False,0.831275720164609,0.15637860082304528,0.012345679012345678,0.0,Off-Peak,Thursday,February
2024-02-22 04:00:00,24,33,1,0,58,63,33,2,1,99,24.4,94,3,11.3,157,False,4,87,66,3,1,2024-02-22,False,False,False,0.42038216560509556,0.554140127388535,0.01910828025477707,0.006369426751592357,Off-Peak,Thursday,February
2024-02-22 05:00:00,40,45,1,0,86,82,45,9,1,137,24.5,93,3,11.3,223,False,5,122,90,10,1,2024-02-22,False,False,False,0.40358744394618834,0.547085201793722,0.04484304932735426,0.004484304932735426,Shoulder,Thursday,February
2024-02-22 06:00:00,57,152,0,0,209,41,152,8,1,202,24.5,94,3,9.7,411,False,6,98,304,8,1,2024-02-22,False,False,False,0.7396593673965937,0.2384428223844282,0.019464720194647202,0.0024330900243309003,Shoulder,Thursday,February
2024-02-22 07:00:00,87,52,3,0,142,275,52,3,1,331,24.4,94,3,9.4,473,False,7,362,104,6,1,2024-02-22,False,False,False,0.21987315010570824,0.7653276955602537,0.012684989429175475,0.0021141649048625794,Peak,Thursday,February
2024-02-22 08:00:00,93,124,2,0,219,248,124,6,0,378,24.8,94,3,10.2,597,False,8,341,248,8,0,2024-02-22,False,False,False,0.4154103852596315,0.5711892797319933,0.01340033500837521,0.0,Peak,Thursday,February
2024-02-22 09:00:00,47,477,3,0,527,163,477,9,0,649,26.6,90,51,7.5,1176,False,9,210,954,12,0,2024-02-22,False,False,False,0.8112244897959183,0.17857142857142858,0.01020408163265306,0.0,Shoulder,Thursday,February
2024-02-22 10:00:00,64,470,3,0,537,117,470,7,1,595,27.9,85,2,11.8,1132,False,10,181,940,10,1,2024-02-22,False,False,False,0.8303886925795053,0.1598939929328622,0.0088339222614841,0.0008833922261484099,Shoulder,Thursday,February
2024-02-22 11:00:00,37,651,1,0,689,164,651,5,0,820,30.0,75,0,10.0,1509,False,11,201,1302,6,0,2024-02-22,False,False,True,0.8628230616302187,0.13320079522862824,0.003976143141153081,0.0,Peak,Thursday,February
2024-02-22 12:00:00,99,500,2,2,603,153,500,9,0,662,30.3,73,3,4.6,1265,False,12,252,1000,11,2,2024-02-22,False,False,False,0.7905138339920948,0.1992094861660079,0.008695652173913044,0.0015810276679841897,Peak,Thursday,February
2024-02-22 13:00:00,127,1294,1,0,1422,396,1294,5,0,1695,26.8,86,55,14.4,3117,False,13,523,2588,6,0,2024-02-22,False,False,True,0.8302855309592557,0.16778954122553738,0.0019249278152069298,0.0,Peak,Thursday,February
2024-02-22 14:00:00,36,843,1,1,881,350,843,10,0,1203,28.3,82,51,6.1,2084,False,14,386,1686,11,1,2024-02-22,False,False,True,0.809021113243762,0.1852207293666027,0.00527831094049904,0.0004798464491362764,Peak,Thursday,February
2024-02-22 15:00:00,33,533,1,1,568,174,533,7,1,715,29.9,76,51,6.2,1283,False,15,207,1066,8,2,2024-02-22,False,False,False,0.8308651597817615,0.16134060795011693,0.006235385814497272,0.001558846453624318,Peak,Thursday,February
2024-02-22 16:00:00,38,436,0,1,475,134,436,11,1,582,30.5,73,51,5.1,1057,False,16,172,872,11,2,2024-02-22,False,False,False,0.8249763481551561,0.16272469252601704,0.010406811731315043,0.001892147587511826,Peak,Thursday,February
2024-02-22 17:00:00,107,827,3,0,937,258,827,7,0,1092,30.2,75,1,6.4,2029,False,17,365,1654,10,0,2024-02-22,False,False,True,0.815179891572203,0.17989157220305568,0.0049285362247412515,0.0,Peak,Thursday,February
2024-02-22 18:00:00,76,1345,0,0,1421,142,1345,9,2,1498,29.6,78,3,5.9,2919,False,18,218,2690,9,2,2024-02-22,False,False,True,0.92154847550531,0.07468311065433368,0.003083247687564234,0.0006851661527920521,Peak,Thursday,February
2024-02-22 19:00:00,52,434,2,0,488,141,434,7,1,583,28.1,84,3,4.0,1071,False,19,193,868,9,1,2024-02-22,False,False,False,0.8104575163398693,0.18020541549953314,0.008403361344537815,0.0009337068160597573,Peak,Thursday,February
2024-02-22 20:00:00,35,206,4,1,246,131,206,7,2,346,27.7,86,51,2.7,592,False,20,166,412,11,3,2024-02-22,False,False,False,0.6959459459459459,0.28040540540540543,0.018581081081081082,0.005067567567567568,Shoulder,Thursday,February
2024-02-22 21:00:00,49,395,4,0,448,145,395,7,1,548,26.7,87,53,4.2,996,False,21,194,790,11,1,2024-02-22,False,False,False,0.7931726907630522,0.19477911646586346,0.01104417670682731,0.001004016064257028,Shoulder,Thursday,February
2024-02-22 22:00:00,34,156,4,0,194,131,156,5,2,294,26.2,90,51,1.1,488,False,22,165,312,9,2,2024-02-22,False,False,False,0.639344262295082,0.33811475409836067,0.018442622950819672,0.004098360655737705,Shoulder,Thursday,February
2024-02-22 23:00:00,44,142,3,2,191,71,142,0,1,214,25.9,91,51,9.4,405,False,23,115,284,3,3,2024-02-22,False,False,False,0.7012345679012346,0.2839506172839506,0.007407407407407408,0.007407407407407408,Shoulder,Thursday,February
2024-02-23 00:00:00,6,122,0,0,128,16,122,5,0,143,25.8,93,51,9.2,271,False,0,22,244,5,0,2024-02-23,False,False,False,0.9003690036900369,0.08118081180811808,0.01845018450184502,0.0,Off-Peak,Friday,February
2024-02-23 01:00:00,21,170,0,0,191,13,170,2,0,185,25.9,91,2,12.3,376,False,1,34,340,2,0,2024-02-23,False,False,False,0.9042553191489362,0.09042553191489362,0.005319148936170213,0.0,Off-Peak,Friday,February
2024-02-23 02:00:00,2,70,0,1,73,43,70,2,1,116,25.2,92,2,11.1,189,False,2,45,140,2,2,2024-02-23,False,False,False,0.7407407407407407,0.23809523809523808,0.010582010582010581,0.010582010582010581,Off-Peak,Friday,February
2024-02-23 03:00:00,8,72,1,0,81,54,72,1,0,127,25.2,91,3,10.0,208,False,3,62,144,2,0,2024-02-23,False,False,False,0.6923076923076923,0.2980769230769231,0.009615384615384616,0.0,Off-Peak,Friday,February
2024-02-23 04:00:00,3,103,1,0,107,86,103,5,1,195,25.1,92,3,13.3,302,False,4,89,206,6,1,2024-02-23,False,False,False,0.6821192052980133,0.2947019867549669,0.019867549668874173,0.0033112582781456954,Off-Peak,Friday,February
2024-02-23 05:00:00,8,107,1,0,116,78,107,3,1,189,25.1,91,1,13.5,305,False,5,86,214,4,1,2024-02-23,False,False,False,0.7016393442622951,0.2819672131147541,0.013114754098360656,0.003278688524590164,Shoulder,Friday,February
2024-02-23 06:00:00,57,301,1,0,359,116,301,5,0,422,25.0,92,1,12.5,781,False,6,173,602,6,0,2024-02-23,False,False,False,0.7708066581306018,0.22151088348271447,0.0076824583866837385,0.0,Shoulder,Friday,February
2024-02-23 07:00:00,73,482,0,2,557,179,482,3,1,665,25.0,93,1,14.2,1222,False,7,252,964,3,3,2024-02-23,False,False,False,0.7888707037643208,0.20621931260229132,0.0024549918166939444,0.0024549918166939444,Peak,Friday,February
2024-02-23 08:00:00,86,791,1,0,878,217,791,4,0,1012,25.3,91,3,14.6,1890,False,8,303,1582,5,0,2024-02-23,False,False,True,0.837037037037037,0.16031746031746033,0.0026455026455026454,0.0,Peak,Friday,February
2024-02-23 09:00:00,56,747,1,0,804,156,747,2,0,905,27.7,85,2,9.2,1709,False,9,212,1494,3,0,2024-02-23,False,False,True,0.874195435927443,0.1240491515506144,0.0017554125219426564,0.0,Shoulder,Friday,February
2024-02-23 10:00:00,66,578,0,0,644,100,578,1,1,680,29.3,78,3,10.9,1324,False,10,166,1156,1,1,2024-02-23,False,False,False,0.8731117824773413,0.12537764350453173,0.0007552870090634441,0.0007552870090634441,Shoulder,Friday,February
2024-02-23 11:00:00,64,426,5,0,495,81,426,1,0,508,30.7,71,2,7.9,1003,False,11,145,852,6,0,2024-02-23,False,False,False,0.8494516450648056,0.14456630109670987,0.005982053838484547,0.0,Peak,Friday,February
2024-02-23 12:00:00,68,549,7,0,624,91,549,5,1,646,31.8,65,3,3.6,1270,False,12,159,1098,12,1,2024-02-23,False,False,False,0.8645669291338582,0.1251968503937008,0.009448818897637795,0.0007874015748031496,Peak,Friday,February
2024-02-23 13:00:00,90,1190,3,0,1283,241,1190,0,1,1432,31.9,64,51,9.3,2715,False,13,331,2380,3,1,2024-02-23,False,False,True,0.8766114180478821,0.12191528545119705,0.0011049723756906078,0.00036832412523020257,Peak,Friday,February
2024-02-23 14:00:00,35,994,4,0,1033,279,994,5,1,1279,28.3,83,63,7.5,2312,False,14,314,1988,9,1,2024-02-23,False,False,True,0.8598615916955017,0.13581314878892733,0.0038927335640138406,0.00043252595155709344,Peak,Friday,February
2024-02-23 15:00:00,28,480,1,1,510,220,480,7,1,708,28.6,83,51,2.9,1218,False,15,248,960,8,2,2024-02-23,False,False,False,0.7881773399014779,0.20361247947454844,0.006568144499178982,0.0016420361247947454,Peak,Friday,February
2024-02-23 16:00:00,54,395,1,0,450,177,395,2,1,575,29.9,75,51,3.3,1025,False,16,231,790,3,1,2024-02-23,False,False,False,0.7707317073170732,0.2253658536585366,0.002926829268292683,0.000975609756097561,Peak,Friday,February
2024-02-23 17:00:00,92,988,1,0,1081,132,988,2,1,1123,30.6,70,51,4.8,2204,False,17,224,1976,3,1,2024-02-23,False,False,True,0.896551724137931,0.10163339382940109,0.0013611615245009074,0.00045372050816696913,Peak,Friday,February
2024-02-23 18:00:00,95,674,1,0,770,214,674,0,2,890,30.0,69,3,4.8,1660,False,18,309,1348,1,2,2024-02-23,False,False,True,0.8120481927710843,0.186144578313253,0.0006024096385542169,0.0012048192771084338,Peak,Friday,February
2024-02-23 19:00:00,25,488,1,0,514,427,488,5,1,921,29.1,75,3,2.9,1435,False,19,452,976,6,1,2024-02-23,False,False,True,0.6801393728222996,0.31498257839721255,0.004181184668989547,0.0006968641114982578,Peak,Friday,February
2024-02-23 20:00:00,42,375,2,0,419,103,375,9,1,488,28.8,74,3,3.4,907,False,20,145,750,11,1,2024-02-23,False,False,False,0.8269018743109151,0.15986769570011025,0.012127894156560088,0.0011025358324145535,Shoulder,Friday,February
2024-02-23 21:00:00,35,186,1,1,223,53,186,8,3,250,25.8,91,1,13.3,473,False,21,88,372,9,4,2024-02-23,False,False,False,0.7864693446088795,0.18604651162790697,0.019027484143763214,0.008456659619450317,Shoulder,Friday,February
2024-02-23 22:00:00,30,167,5,1,203,12,167,3,2,184,26.2,87,1,13.0,387,False,22,42,334,8,3,2024-02-23,False,False,False,0.8630490956072352,0.10852713178294573,0.020671834625323,0.007751937984496124,Shoulder,Friday,February
2024-02-23 23:00:00,10,137,4,0,151,32,137,7,4,180,25.6,86,1,12.5,331,False,23,42,274,11,4,2024-02-23,False,False,False,0.8277945619335347,0.1268882175226586,0.03323262839879154,0.012084592145015106,Shoulder,Friday,February
2024-02-24 00:00:00,12,122,2,0,136,5,122,7,0,134,25.1,87,0,12.0,270,True,0,17,244,9,0,2024-02-24,False,False,False,0.9037037037037037,0.06296296296296296,0.03333333333333333,0.0,Off-Peak,Saturday,February
2024-02-24 01:00:00,2,170,2,0,174,14,170,6,0,190,24.9,88,1,9.7,364,True,1,16,340,8,0,2024-02-24,False,False,False,0.9340659340659341,0.04395604395604396,0.02197802197802198,0.0,Off-Peak,Saturday,February
2024-02-24 02:00:00,2,70,0,0,72,6,70,10,0,86,24.7,91,1,5.8,158,True,2,8,140,10,0,2024-02-24,False,False,False,0.8860759493670886,0.05063291139240506,0.06329113924050633,0.0,Off-Peak,Saturday,February
2024-02-24 03:00:00,6,72,1,0,79,4,72,7,0,83,24.5,92,3,6.0,162,True,3,10,144,8,0,2024-02-24,False,False,False,0.8888888888888888,0.06172839506172839,0.04938271604938271,0.0,Off-Peak,Saturday,February
2024-02-24 04:00:00,12,103,0,0,115,11,103,5,1,120,24.6,93,3,8.2,235,True,4,23,206,5,1,2024-02-24,False,False,False,0.8765957446808511,0.09787234042553192,0.02127659574468085,0.00425531914893617,Off-Peak,Saturday,February
2024-02-24 05:00:00,11,107,1,0,119,7,107,0,1,115,24.6,94,2,8.9,234,True,5,18,214,1,1,2024-02-24,False,False,False,0.9145299145299145,0.07692307692307693,0.004273504273504274,0.004273504273504274,Shoulder,Saturday,February
2024-02-24 06:00:00,22,301,0,0,323,12,301,5,1,319,24.6,94,2,8.0,642,True,6,34,602,5,1,2024-02-24,False,False,False,0.9376947040498442,0.0529595015576324,0.00778816199376947,0.001557632398753894,Shoulder,Saturday,February
2024-02-24 07:00:00,27,482,1,0,510,38,482,6,1,527,24.6,94,0,9.4,1037,True,7,65,964,7,1,2024-02-24,False,False,False,0.9296046287367405,0.0626808100289296,0.006750241080038573,0.0009643201542912247,Peak,Saturday,February
2024-02-24 08:00:00,35,791,1,0,827,48,791,9,0,848,24.8,93,1,9.8,1675,True,8,83,1582,10,0,2024-02-24,False,False,True,0.9444776119402986,0.04955223880597015,0.005970149253731343,0.0,Peak,Saturday,February
2024-02-24 09:00:00,55,747,1,0,803,83,747,9,1,840,25.8,89,51,8.4,1643,True,9,138,1494,10,1,2024-02-24,False,False,True,0.9093122337188071,0.08399269628727937,0.006086427267194157,0.0006086427267194157,Shoulder,Saturday,February
2024-02-24 10:00:00,71,578,3,0,652,112,578,5,1,696,27.2,84,51,7.5,1348,True,10,183,1156,8,1,2024-02-24,False,False,False,0.857566765578635,0.1357566765578635,0.005934718100890208,0.000741839762611276,Shoulder,Saturday,February
2024-02-24 11:00:00,79,426,0,0,505,218,426,5,0,649,29.1,71,51,13.1,1154,True,11,297,852,5,0,2024-02-24,False,False,False,0.7383015597920277,0.25736568457538994,0.004332755632582322,0.0,Peak,Saturday,February
2024-02-24 12:00:00,87,549,2,1,639,189,549,0,0,738,31.2,61,0,11.3,1377,True,12,276,1098,2,1,2024-02-24,False,False,True,0.7973856209150327,0.20043572984749455,0.0014524328249818446,0.0007262164124909223,Peak,Saturday,February
2024-02-24 13:00:00,124,1190,4,0,1318,302,1190,16,2,1510,32.3,56,51,6.8,2828,True,13,426,2380,20,2,2024-02-24,False,False,True,0.8415841584158416,0.15063649222065065,0.007072135785007072,0.0007072135785007072,Peak,Saturday,February
2024-02-24 14:00:00,52,994,0,0,1046,416,994,11,0,1421,32.0,59,53,3.6,2467,True,14,468,1988,11,0,2024-02-24,False,False,True,0.805837049047426,0.18970409404134578,0.0044588569112282124,0.0,Peak,Saturday,February
2024-02-24 15:00:00,73,480,3,0,556,126,480,7,1,614,30.9,67,51,7.7,1170,True,15,199,960,10,1,2024-02-24,False,False,False,0.8205128205128205,0.1700854700854701,0.008547008547008548,0.0008547008547008547,Peak,Saturday,February
2024-02-24 16:00:00,47,395,0,0,442,117,395,5,1,518,30.0,78,55,8.4,960,True,16,164,790,5,1,2024-02-24,False,False,False,0.8229166666666666,0.17083333333333334,0.005208333333333333,0.0010416666666666667,Peak,Saturday,February
2024-02-24 17:00:00,52,988,2,3,1045,288,988,11,3,1290,29.6,80,51,5.2,2335,True,17,340,1976,13,6,2024-02-24,False,False,True,0.8462526766595289,0.145610278372591,0.00556745182012848,0.002569593147751606,Peak,Saturday,February
2024-02-24 18:00:00,99,674,3,0,776,289,674,10,2,975,29.6,77,51,6.4,1751,True,18,388,1348,13,2,2024-02-24,False,False,True,0.7698458023986293,0.22158766419189035,0.0074243289548829245,0.001142204454597373,Peak,Saturday,February
2024-02-24 19:00:00,74,488,3,0,565,233,488,7,0,728,28.7,80,1,3.4,1293,True,19,307,976,10,0,2024-02-24,False,False,False,0.7548337200309359,0.2374323279195669,0.007733952049497293,0.0,Peak,Saturday,February
2024-02-24 20:00:00,25,375,2,1,403,261,375,6,2,644,27.8,84,1,5.0,1047,True,20,286,750,8,3,2024-02-24,False,False,False,0.7163323782234957,0.2731614135625597,0.007640878701050621,0.0028653295128939827,Shoulder,Saturday,February
2024-02-24 21:00:00,37,182,4,0,223,108,182,1,1,292,27.1,82,53,6.7,515,True,21,145,364,5,1,2024-02-24,False,False,False,0.7067961165048544,0.2815533980582524,0.009708737864077669,0.001941747572815534,Shoulder,Saturday,February
2024-02-24 22:00:00,11,168,3,0,182,36,168,5,2,211,26.4,87,1,7.6,393,True,22,47,336,8,2,2024-02-24,False,False,False,0.8549618320610687,0.11959287531806616,0.020356234096692113,0.005089058524173028,Shoulder,Saturday,February
2024-02-24 23:00:00,14,137,0,2,153,54,137,5,1,197,25.7,88,0,6.0,350,True,23,68,274,5,3,2024-02-24,False,False,False,0.7828571428571428,0.19428571428571428,0.014285714285714285,0.008571428571428572,Shoulder,Saturday,February
2024-02-25 00:00:00,6,122,1,1,130,5,122,7,0,134,25.6,83,0,9.0,264,True,0,11,244,8,1,2024-02-25,False,False,False,0.9242424242424242,0.041666666666666664,0.030303030303030304,0.003787878787878788,Off-Peak,Sunday,February
2024-02-25 01:00:00,21,170,0,0,191,14,170,6,1,191,25.2,84,0,8.7,382,True,1,35,340,6,1,2024-02-25,False,False,False,0.8900523560209425,0.09162303664921466,0.015706806282722512,0.002617801047120419,Off-Peak,Sunday,February
2024-02-25 02:00:00,2,70,1,0,73,6,70,10,0,86,24.8,87,0,10.6,159,True,2,8,140,11,0,2024-02-25,False,False,False,0.8805031446540881,0.050314465408805034,0.06918238993710692,0.0,Off-Peak,Sunday,February
2024-02-25 03:00:00,8,72,1,0,81,4,72,7,0,83,24.4,89,0,9.6,164,True,3,12,144,8,0,2024-02-25,False,False,False,0.8780487804878049,0.07317073170731707,0.04878048780487805,0.0,Off-Peak,Sunday,February
2024-02-25 04:00:00,3,103,1,0,107,11,103,5,1,120,24.5,90,0,10.3,227,True,4,14,206,6,1,2024-02-25,False,False,False,0.9074889867841409,0.06167400881057269,0.02643171806167401,0.004405286343612335,Off-Peak,Sunday,February
2024-02-25 05:00:00,8,107,0,0,115,7,107,0,1,115,24.4,91,0,10.7,230,True,5,15,214,0,1,2024-02-25,False,False,False,0.9304347826086956,0.06521739130434782,0.0,0.004347826086956522,Shoulder,Sunday,February
2024-02-25 06:00:00,57,301,1,1,360,12,301,5,1,319,24.2,92,0,11.7,679,True,6,69,602,6,2,2024-02-25,False,False,False,0.8865979381443299,0.101620029455081,0.008836524300441826,0.0029455081001472753,Shoulder,Sunday,February
2024-02-25 07:00:00,73,482,2,0,557,38,482,6,1,527,24.1,93,0,11.5,1084,True,7,111,964,8,1,2024-02-25,False,False,False,0.8892988929889298,0.10239852398523985,0.007380073800738007,0.0009225092250922509,Peak,Sunday,February
2024-02-25 08:00:00,86,791,1,3,881,48,791,9,0,848,24.5,92,0,13.5,1729,True,8,134,1582,10,3,2024-02-25,False,False,True,0.9149797570850202,0.07750144592249855,0.00578368999421631,0.001735106998264893,Peak,Sunday,February
2024-02-25 09:00:00,56,747,1,0,804,83,747,9,0,839,27.2,82,3,14.0,1643,True,9,139,1494,10,0,2024-02-25,False,False,True,0.9093122337188071,0.08460133901399879,0.006086427267194157,0.0,Shoulder,Sunday,February
2024-02-25 10:00:00,66,578,1,0,645,112,578,5,1,696,28.7,74,2,15.2,1341,True,10,178,1156,6,1,2024-02-25,False,False,False,0.8620432513049963,0.13273676360924683,0.0044742729306487695,0.0007457121551081282,Shoulder,Sunday,February
2024-02-25 11:00:00,64,426,4,1,495,218,426,5,0,649,30.3,67,2,14.5,1144,True,11,282,852,9,1,2024-02-25,False,False,False,0.7447552447552448,0.2465034965034965,0.007867132867132868,0.0008741258741258741,Peak,Sunday,February
2024-02-25 12:00:00,68,549,2,1,620,189,549,0,0,738,31.7,61,1,11.2,1358,True,12,257,1098,2,1,2024-02-25,False,False,False,0.8085419734904271,0.18924889543446244,0.0014727540500736377,0.0007363770250368188,Peak,Sunday,February
2024-02-25 13:00:00,90,1190,7,2,1289,302,1190,16,0,1508,32.8,56,3,6.3,2797,True,13,392,2380,23,2,2024-02-25,False,False,True,0.8509116910976046,0.1401501608866643,0.008223096174472649,0.0007150518412584912,Peak,Sunday,February
2024-02-25 14:00:00,35,994,2,0,1031,416,994,11,0,1421,29.8,70,63,10.6,2452,True,14,451,1988,13,0,2024-02-25,False,False,True,0.8107667210440457,0.18393148450244698,0.005301794453507341,0.0,Peak,Sunday,February
2024-02-25 15:00:00,28,480,2,0,510,126,480,7,1,614,25.7,91,63,10.2,1124,True,15,154,960,9,1,2024-02-25,False,False,False,0.8540925266903915,0.13701067615658363,0.00800711743772242,0.0008896797153024911,Peak,Sunday,February
2024-02-25 16:00:00,54,395,2,2,453,117,395,5,1,518,28.6,81,51,4.0,971,True,16,171,790,7,3,2024-02-25,False,False,False,0.8135942327497425,0.17610710607621008,0.007209062821833162,0.003089598352214212,Peak,Sunday,February
2024-02-25 17:00:00,92,988,2,1,1083,288,988,11,0,1287,29.4,74,51,6.1,2370,True,17,380,1976,13,1,2024-02-25,False,False,True,0.8337552742616033,0.16033755274261605,0.005485232067510549,0.0004219409282700422,Peak,Sunday,February
2024-02-25 18:00:00,95,674,2,0,771,289,674,10,5,978,29.6,72,1,4.7,1749,True,18,384,1348,12,5,2024-02-25,False,False,True,0.7707261292166953,0.2195540308747856,0.00686106346483705,0.002858776443682104,Peak,Sunday,February
2024-02-25 19:00:00,25,488,4,0,517,233,488,7,7,735,28.0,75,51,10.0,1252,True,19,258,976,11,7,2024-02-25,False,False,False,0.7795527156549521,0.20607028753993611,0.00878594249201278,0.005591054313099041,Peak,Sunday,February
2024-02-25 20:00:00,42,375,3,0,420,261,375,6,5,647,26.7,84,2,3.8,1067,True,20,303,750,9,5,2024-02-25,False,False,False,0.7029053420805998,0.2839737582005623,0.008434864104967198,0.004686035613870665,Shoulder,Sunday,February
2024-02-25 21:00:00,35,182,4,1,222,108,182,1,1,292,28.8,67,1,12.6,514,True,21,143,364,5,2,2024-02-25,False,False,False,0.708171206225681,0.2782101167315175,0.009727626459143969,0.0038910505836575876,Shoulder,Sunday,February
2024-02-25 22:00:00,30,168,2,0,200,36,168,5,0,209,28.3,70,0,14.1,409,True,22,66,336,7,0,2024-02-25,False,False,False,0.8215158924205379,0.16136919315403422,0.017114914425427872,0.0,Shoulder,Sunday,February
2024-02-25 23:00:00,10,137,1,0,148,54,137,5,1,197,27.4,75,0,13.6,345,True,23,64,274,6,1,2024-02-25,False,False,False,0.7942028985507247,0.1855072463768116,0.017391304347826087,0.002898550724637681,Shoulder,Sunday,February
2024-02-26 00:00:00,9,35,1,0,45,16,35,7,0,58,26.6,80,0,14.5,103,False,0,25,70,8,0,2024-02-26,False,False,False,0.6796116504854369,0.24271844660194175,0.07766990291262135,0.0,Off-Peak,Monday,February
2024-02-26 01:00:00,19,17,0,0,36,13,17,6,0,36,26.1,82,3,15.8,72,False,1,32,34,6,0,2024-02-26,False,False,False,0.4722222222222222,0.4444444444444444,0.08333333333333333,0.0,Off-Peak,Monday,February
2024-02-26 02:00:00,2,37,1,0,40,43,37,10,1,91,25.9,83,2,16.3,131,False,2,45,74,11,1,2024-02-26,False,False,False,0.5648854961832062,0.3435114503816794,0.08396946564885496,0.007633587786259542,Off-Peak,Monday,February
2024-02-26 03:00:00,14,57,1,0,72,54,57,7,0,118,25.6,84,1,17.6,190,False,3,68,114,8,0,2024-02-26,False,False,False,0.6,0.35789473684210527,0.042105263157894736,0.0,Off-Peak,Monday,February
2024-02-26 04:00:00,24,61,1,1,87,98,61,5,0,164,25.4,85,3,17.8,251,False,4,122,122,6,1,2024-02-26,False,False,False,0.4860557768924303,0.4860557768924303,0.02390438247011952,0.00398406374501992,Off-Peak,Monday,February
2024-02-26 05:00:00,40,98,3,1,142,101,98,0,0,199,25.2,86,3,17.4,341,False,5,141,196,3,1,2024-02-26,False,False,False,0.5747800586510264,0.41348973607038125,0.008797653958944282,0.002932551319648094,Shoulder,Monday,February
2024-02-26 06:00:00,57,215,1,1,274,116,215,5,0,336,25.0,86,3,16.9,610,False,6,173,430,6,1,2024-02-26,False,False,False,0.7049180327868853,0.2836065573770492,0.009836065573770493,0.001639344262295082,Shoulder,Monday,February
2024-02-26 07:00:00,77,382,0,0,459,179,382,6,0,567,24.9,86,3,17.1,1026,False,7,256,764,6,0,2024-02-26,False,False,False,0.7446393762183235,0.24951267056530213,0.005847953216374269,0.0,Peak,Monday,February
2024-02-26 08:00:00,83,408,1,0,492,217,408,9,3,637,25.2,86,3,17.4,1129,False,8,300,816,10,3,2024-02-26,False,False,False,0.7227635075287865,0.2657218777679362,0.008857395925597875,0.002657218777679362,Peak,Monday,February
2024-02-26 09:00:00,47,635,1,1,684,156,635,9,0,800,27.5,80,3,20.7,1484,False,9,203,1270,10,1,2024-02-26,False,False,True,0.8557951482479784,0.13679245283018868,0.006738544474393531,0.0006738544474393531,Shoulder,Monday,February
2024-02-26 10:00:00,64,589,1,1,655,100,589,5,2,696,28.8,74,3,17.3,1351,False,10,164,1178,6,3,2024-02-26,False,False,False,0.8719467061435974,0.12139156180606958,0.0044411547002220575,0.0022205773501110288,Shoulder,Monday,February
2024-02-26 11:00:00,37,931,1,0,969,156,931,5,1,1093,30.5,65,3,17.9,2062,False,11,193,1862,6,1,2024-02-26,False,False,True,0.9030067895247332,0.0935984481086324,0.002909796314258002,0.00048496605237633366,Peak,Monday,February
2024-02-26 12:00:00,102,1268,2,0,1372,191,1268,10,4,1473,31.9,59,51,17.9,2845,False,12,293,2536,12,4,2024-02-26,False,False,True,0.8913884007029877,0.10298769771528998,0.00421792618629174,0.00140597539543058,Peak,Monday,February
2024-02-26 13:00:00,126,1155,7,1,1289,241,1155,8,2,1406,32.9,55,51,18.5,2695,False,13,367,2310,15,3,2024-02-26,False,False,True,0.8571428571428571,0.13617810760667903,0.0055658627087198514,0.0011131725417439704,Peak,Monday,February
2024-02-26 14:00:00,36,931,5,0,972,338,931,11,1,1281,33.8,51,51,17.2,2253,False,14,374,1862,16,1,2024-02-26,False,False,True,0.8264536173990236,0.16600088770528185,0.007101642254771416,0.0004438526409232135,Peak,Monday,February
2024-02-26 15:00:00,33,820,0,1,854,228,820,7,3,1058,33.9,51,51,16.4,1912,False,15,261,1640,7,4,2024-02-26,False,False,True,0.8577405857740585,0.1365062761506276,0.0036610878661087866,0.0020920502092050207,Peak,Monday,February
2024-02-26 16:00:00,38,865,2,1,906,177,865,15,2,1059,33.4,52,3,9.4,1965,False,16,215,1730,17,3,2024-02-26,False,False,True,0.8804071246819338,0.10941475826972011,0.008651399491094147,0.0015267175572519084,Peak,Monday,February
2024-02-26 17:00:00,38,712,2,0,752,132,712,11,2,857,31.7,58,51,5.8,1609,False,17,170,1424,13,2,2024-02-26,False,False,True,0.8850217526413922,0.10565568676196395,0.008079552517091361,0.001243008079552517,Peak,Monday,February
2024-02-26 18:00:00,66,693,2,2,763,214,693,10,0,917,31.6,58,51,4.1,1680,False,18,280,1386,12,2,2024-02-26,False,False,True,0.825,0.16666666666666666,0.007142857142857143,0.0011904761904761906,Peak,Monday,February
2024-02-26 19:00:00,52,429,4,1,486,322,429,7,5,763,30.4,63,51,5.4,1249,False,19,374,858,11,6,2024-02-26,False,False,False,0.6869495596477182,0.29943955164131303,0.008807045636509208,0.004803843074459567,Peak,Monday,February
2024-02-26 20:00:00,35,198,0,2,235,103,198,6,3,310,29.8,63,3,12.8,545,False,20,138,396,6,5,2024-02-26,False,False,False,0.726605504587156,0.25321100917431194,0.011009174311926606,0.009174311926605505,Shoulder,Monday,February
2024-02-26 21:00:00,49,191,4,1,245,53,191,1,2,247,26.2,92,51,2.9,492,False,21,102,382,5,3,2024-02-26,False,False,False,0.7764227642276422,0.2073170731707317,0.01016260162601626,0.006097560975609756,Shoulder,Monday,February
2024-02-26 22:00:00,36,129,2,2,169,12,129,5,3,149,27.1,83,3,12.9,318,False,22,48,258,7,5,2024-02-26,False,False,False,0.8113207547169812,0.1509433962264151,0.0220125786163522,0.015723270440251572,Shoulder,Monday,February
2024-02-26 23:00:00,43,170,1,1,215,32,170,5,4,211,26.7,81,3,13.0,426,False,23,75,340,6,5,2024-02-26,False,False,False,0.7981220657276995,0.176056338028169,0.014084507042253521,0.011737089201877934,Shoulder,Monday,February
2024-02-27 00:00:00,9,36,0,1,46,39,36,2,2,79,26.2,82,3,13.2,125,False,0,48,72,2,3,2024-02-27,False,False,False,0.576,0.384,0.016,0.024,Off-Peak,Tuesday,February
2024-02-27 01:00:00,19,39,1,1,60,35,39,4,0,78,26.0,84,3,12.0,138,False,1,54,78,5,1,2024-02-27,False,False,False,0.5652173913043478,0.391304347826087,0.036231884057971016,0.007246376811594203,Off-Peak,Tuesday,February
2024-02-27 02:00:00,2,40,1,2,45,27,40,4,1,72,25.6,86,3,14.8,117,False,2,29,80,5,3,2024-02-27,False,False,False,0.6837606837606838,0.24786324786324787,0.042735042735042736,0.02564102564102564,Off-Peak,Tuesday,February
2024-02-27 03:00:00,14,32,0,0,46,12,32,2,0,46,25.4,87,3,14.6,92,False,3,26,64,2,0,2024-02-27,False,False,False,0.6956521739130435,0.2826086956521739,0.021739130434782608,0.0,Off-Peak,Tuesday,February
2024-02-27 04:00:00,24,63,1,0,88,18,63,0,0,81,25.2,88,3,14.0,169,False,4,42,126,1,0,2024-02-27,False,False,False,0.7455621301775148,0.2485207100591716,0.005917159763313609,0.0,Off-Peak,Tuesday,February
2024-02-27 05:00:00,40,82,1,2,125,68,82,7,1,158,25.0,88,3,14.8,283,False,5,108,164,8,3,2024-02-27,False,False,False,0.5795053003533569,0.38162544169611307,0.028268551236749116,0.01060070671378092,Shoulder,Tuesday,February
2024-02-27 06:00:00,57,138,0,1,196,147,138,0,0,285,25.0,88,3,15.7,481,False,6,204,276,0,1,2024-02-27,False,False,False,0.5738045738045738,0.42411642411642414,0.0,0.002079002079002079,Shoulder,Tuesday,February
2024-02-27 07:00:00,87,113,3,0,203,215,113,8,2,338,24.8,88,3,14.8,541,False,7,302,226,11,2,2024-02-27,False,False,False,0.4177449168207024,0.5582255083179297,0.02033271719038817,0.0036968576709796672,Peak,Tuesday,February
2024-02-27 08:00:00,93,209,2,0,304,119,209,12,1,341,25.1,87,3,14.7,645,False,8,212,418,14,1,2024-02-27,False,False,False,0.648062015503876,0.32868217054263565,0.021705426356589147,0.0015503875968992248,Peak,Tuesday,February
2024-02-27 09:00:00,47,500,3,0,550,43,500,7,0,550,27.5,75,2,12.7,1100,False,9,90,1000,10,0,2024-02-27,False,False,False,0.9090909090909091,0.08181818181818182,0.00909090909090909,0.0,Shoulder,Tuesday,February
2024-02-27 10:00:00,34,521,3,1,559,88,521,5,0,614,29.3,67,2,14.7,1173,False,10,122,1042,8,1,2024-02-27,False,False,False,0.8883205456095482,0.10400682011935208,0.0068201193520886615,0.0008525149190110827,Shoulder,Tuesday,February
2024-02-27 11:00:00,37,802,2,0,841,125,802,11,1,939,30.9,60,3,15.4,1780,False,11,162,1604,13,1,2024-02-27,False,False,True,0.9011235955056179,0.09101123595505618,0.007303370786516854,0.0005617977528089888,Peak,Tuesday,February
2024-02-27 12:00:00,79,1496,2,0,1577,297,1496,12,0,1805,31.8,57,3,14.8,3382,False,12,376,2992,14,0,2024-02-27,False,False,True,0.8846836191602602,0.11117681845062094,0.004139562389118865,0.0,Peak,Tuesday,February
2024-02-27 13:00:00,27,1202,1,1,1231,320,1202,13,0,1535,31.9,55,3,14.8,2766,False,13,347,2404,14,1,2024-02-27,False,False,True,0.8691250903832248,0.12545191612436732,0.005061460592913955,0.00036153289949385393,Peak,Tuesday,February
2024-02-27 14:00:00,36,879,5,0,920,107,879,15,1,1002,31.7,57,3,10.9,1922,False,14,143,1758,20,1,2024-02-27,False,False,True,0.9146722164412071,0.07440166493236212,0.01040582726326743,0.0005202913631633715,Peak,Tuesday,February
2024-02-27 15:00:00,33,571,4,0,608,120,571,14,2,707,32.5,54,3,9.7,1315,False,15,153,1142,18,2,2024-02-27,False,False,False,0.8684410646387832,0.11634980988593156,0.013688212927756654,0.001520912547528517,Peak,Tuesday,February
2024-02-27 16:00:00,31,501,2,0,534,206,501,12,3,722,30.0,64,55,13.8,1256,False,16,237,1002,14,3,2024-02-27,False,False,False,0.7977707006369427,0.18869426751592358,0.011146496815286623,0.0023885350318471337,Peak,Tuesday,February
2024-02-27 17:00:00,57,986,3,0,1046,226,986,10,0,1222,29.6,68,53,2.1,2268,False,17,283,1972,13,0,2024-02-27,False,False,True,0.8694885361552028,0.1247795414462081,0.005731922398589065,0.0,Peak,Tuesday,February
2024-02-27 18:00:00,76,761,0,0,837,139,761,8,1,909,29.4,69,51,10.2,1746,False,18,215,1522,8,1,2024-02-27,False,False,True,0.8717067583046965,0.12313860252004583,0.004581901489117984,0.000572737686139748,Peak,Tuesday,February
2024-02-27 19:00:00,52,719,2,1,774,175,719,9,3,906,28.3,72,51,10.7,1680,False,19,227,1438,11,4,2024-02-27,False,False,True,0.8559523809523809,0.1351190476190476,0.006547619047619048,0.002380952380952381,Peak,Tuesday,February
2024-02-27 20:00:00,45,485,4,0,534,114,485,13,0,612,27.9,74,3,9.7,1146,False,20,159,970,17,0,2024-02-27,False,False,False,0.8464223385689355,0.1387434554973822,0.014834205933682374,0.0,Shoulder,Tuesday,February
2024-02-27 21:00:00,49,182,4,3,238,162,182,8,6,358,28.0,72,3,12.9,596,False,21,211,364,12,9,2024-02-27,False,False,False,0.610738255033557,0.3540268456375839,0.020134228187919462,0.015100671140939598,Shoulder,Tuesday,February
2024-02-27 22:00:00,36,58,4,0,98,74,58,4,2,138,27.4,74,2,13.5,236,False,22,110,116,8,2,2024-02-27,False,False,False,0.4915254237288136,0.4661016949152542,0.03389830508474576,0.00847457627118644,Shoulder,Tuesday,February
2024-02-27 23:00:00,44,71,3,0,118,75,71,8,5,159,26.9,77,3,13.8,277,False,23,119,142,11,5,2024-02-27,False,False,False,0.5126353790613718,0.4296028880866426,0.039711191335740074,0.018050541516245487,Shoulder,Tuesday,February
2024-02-28 00:00:00,9,45,1,0,55,9,45,1,0,55,26.5,78,3,13.5,110,False,0,18,90,2,0,2024-02-28,False,False,False,0.8181818181818182,0.16363636363636364,0.01818181818181818,0.0,Off-Peak,Wednesday,February
2024-02-28 01:00:00,12,62,3,0,77,19,62,0,0,81,26.2,81,3,14.8,158,False,1,31,124,3,0,2024-02-28,False,False,False,0.7848101265822784,0.1962025316455696,0.0189873417721519,0.0,Off-Peak,Wednesday,February
2024-02-28 02:00:00,8,34,2,0,44,2,34,0,0,36,26.0,83,3,14.8,80,False,2,10,68,2,0,2024-02-28,False,False,False,0.85,0.125,0.025,0.0,Off-Peak,Wednesday,February
2024-02-28 03:00:00,13,25,2,0,40,14,25,4,0,43,25.9,84,3,16.3,83,False,3,27,50,6,0,2024-02-28,False,False,False,0.6024096385542169,0.3253012048192771,0.07228915662650602,0.0,Off-Peak,Wednesday,February
2024-02-28 04:00:00,28,33,1,0,62,24,33,2,0,59,25.7,85,3,17.1,121,False,4,52,66,3,0,2024-02-28,False,False,False,0.5454545454545454,0.4297520661157025,0.024793388429752067,0.0,Off-Peak,Wednesday,February
2024-02-28 05:00:00,49,61,3,0,113,40,61,3,0,104,25.7,84,3,16.3,217,False,5,89,122,6,0,2024-02-28,False,False,False,0.5622119815668203,0.41013824884792627,0.027649769585253458,0.0,Shoulder,Wednesday,February
2024-02-28 06:00:00,78,70,2,1,151,57,70,4,1,132,25.5,84,3,16.0,283,False,6,135,140,6,2,2024-02-28,False,False,False,0.49469964664310956,0.47703180212014135,0.02120141342756184,0.007067137809187279,Shoulder,Wednesday,February
2024-02-28 07:00:00,76,115,3,0,194,77,115,4,0,196,25.5,84,3,15.8,390,False,7,153,230,7,0,2024-02-28,False,False,False,0.5897435897435898,0.3923076923076923,0.017948717948717947,0.0,Peak,Wednesday,February
2024-02-28 08:00:00,22,122,2,3,149,83,122,4,3,212,25.7,83,3,16.3,361,False,8,105,244,6,6,2024-02-28,False,False,False,0.6759002770083102,0.29085872576177285,0.01662049861495845,0.01662049861495845,Peak,Wednesday,February
2024-02-28 09:00:00,29,136,4,0,169,47,136,3,0,186,27.3,74,3,17.1,355,False,9,76,272,7,0,2024-02-28,False,False,False,0.7661971830985915,0.2140845070422535,0.01971830985915493,0.0,Shoulder,Wednesday,February
2024-02-28 10:00:00,37,116,1,0,154,64,116,3,0,183,28.9,67,3,19.6,337,False,10,101,232,4,0,2024-02-28,False,False,False,0.6884272997032641,0.2997032640949555,0.011869436201780416,0.0,Shoulder,Wednesday,February
2024-02-28 11:00:00,78,124,3,1,206,35,124,3,1,163,30.7,58,3,20.4,369,False,11,113,248,6,2,2024-02-28,False,False,False,0.6720867208672087,0.3062330623306233,0.016260162601626018,0.005420054200542005,Peak,Wednesday,February
2024-02-28 12:00:00,84,211,0,1,296,102,211,3,1,317,32.0,51,3,19.4,613,False,12,186,422,3,2,2024-02-28,False,False,False,0.6884176182707994,0.3034257748776509,0.004893964110929853,0.0032626427406199023,Peak,Wednesday,February
2024-02-28 13:00:00,41,286,4,2,333,126,286,2,2,416,33.7,44,3,19.1,749,False,13,167,572,6,4,2024-02-28,False,False,False,0.7636849132176236,0.22296395193591456,0.00801068090787717,0.0053404539385847796,Peak,Wednesday,February
2024-02-28 14:00:00,25,239,2,0,266,36,239,1,0,276,34.7,42,3,18.0,542,False,14,61,478,3,0,2024-02-28,False,False,False,0.8819188191881919,0.11254612546125461,0.005535055350553505,0.0,Peak,Wednesday,February
2024-02-28 15:00:00,36,167,5,0,208,33,167,5,0,205,34.9,43,3,16.6,413,False,15,69,334,10,0,2024-02-28,False,False,False,0.8087167070217918,0.16707021791767554,0.024213075060532687,0.0,Peak,Wednesday,February
2024-02-28 16:00:00,47,289,4,2,342,38,289,2,2,331,34.6,45,51,14.5,673,False,16,85,578,6,4,2024-02-28,False,False,False,0.8588410104011887,0.1263001485884101,0.008915304606240713,0.005943536404160475,Peak,Wednesday,February
2024-02-28 17:00:00,67,266,7,1,341,38,266,5,1,310,34.1,45,3,12.3,651,False,17,105,532,12,2,2024-02-28,False,False,False,0.8172043010752689,0.16129032258064516,0.018433179723502304,0.0030721966205837174,Peak,Wednesday,February
2024-02-28 18:00:00,92,387,6,0,485,66,387,1,0,454,32.5,47,3,13.0,939,False,18,158,774,7,0,2024-02-28,False,False,False,0.8242811501597445,0.16826411075612355,0.007454739084132056,0.0,Peak,Wednesday,February
2024-02-28 19:00:00,41,104,3,0,148,52,104,5,0,161,31.9,48,3,14.3,309,False,19,93,208,8,0,2024-02-28,False,False,False,0.6731391585760518,0.30097087378640774,0.025889967637540454,0.0,Peak,Wednesday,February
2024-02-28 20:00:00,22,141,3,0,166,35,141,3,0,179,30.3,53,3,18.8,345,False,20,57,282,6,0,2024-02-28,False,False,False,0.8173913043478261,0.16521739130434782,0.017391304347826087,0.0,Shoulder,Wednesday,February
2024-02-28 21:00:00,19,79,6,1,105,49,79,2,1,131,29.5,60,1,16.1,236,False,21,68,158,8,2,2024-02-28,False,False,False,0.6694915254237288,0.288135593220339,0.03389830508474576,0.00847457627118644,Shoulder,Wednesday,February
2024-02-28 22:00:00,31,89,0,0,120,36,89,4,0,129,28.6,64,1,16.3,249,False,22,67,178,4,0,2024-02-28,False,False,False,0.714859437751004,0.26907630522088355,0.01606425702811245,0.0,Shoulder,Wednesday,February
2024-02-28 23:00:00,13,67,0,0,80,43,67,3,0,113,27.7,70,1,16.5,193,False,23,56,134,3,0,2024-02-28,False,False,False,0.694300518134715,0.29015544041450775,0.015544041450777202,0.0,Shoulder,Wednesday,February
2024-02-29 00:00:00,7,24,1,0,32,9,24,0,0,33,27.1,73,3,17.1,65,False,0,16,48,1,0,2024-02-29,False,False,False,0.7384615384615385,0.24615384615384617,0.015384615384615385,0.0,Off-Peak,Thursday,February
2024-02-29 01:00:00,5,45,0,0,50,12,45,0,0,57,26.7,75,2,16.8,107,False,1,17,90,0,0,2024-02-29,False,False,False,0.8411214953271028,0.1588785046728972,0.0,0.0,Off-Peak,Thursday,February
2024-02-29 02:00:00,5,20,1,1,27,8,20,2,0,30,26.4,76,2,16.8,57,False,2,13,40,3,1,2024-02-29,False,False,False,0.7017543859649122,0.22807017543859648,0.05263157894736842,0.017543859649122806,Off-Peak,Thursday,February
2024-02-29 03:00:00,9,50,1,0,60,13,50,0,0,63,26.2,77,3,17.9,123,False,3,22,100,1,0,2024-02-29,False,False,False,0.8130081300813008,0.17886178861788618,0.008130081300813009,0.0,Off-Peak,Thursday,February
2024-02-29 04:00:00,21,52,1,0,74,28,52,2,1,83,25.8,79,3,19.0,157,False,4,49,104,3,1,2024-02-29,False,False,False,0.6624203821656051,0.31210191082802546,0.01910828025477707,0.006369426751592357,Off-Peak,Thursday,February
2024-02-29 05:00:00,22,77,3,0,102,49,77,4,1,131,25.6,79,3,19.2,233,False,5,71,154,7,1,2024-02-29,False,False,False,0.6609442060085837,0.30472103004291845,0.030042918454935622,0.004291845493562232,Shoulder,Thursday,February
2024-02-29 06:00:00,45,98,1,0,144,78,98,2,2,180,25.5,80,3,18.8,324,False,6,123,196,3,2,2024-02-29,False,False,False,0.6049382716049383,0.37962962962962965,0.009259259259259259,0.006172839506172839,Shoulder,Thursday,February
2024-02-29 07:00:00,53,54,0,0,107,76,54,6,1,137,25.3,79,3,17.5,244,False,7,129,108,6,1,2024-02-29,False,False,False,0.4426229508196721,0.5286885245901639,0.02459016393442623,0.004098360655737705,Peak,Thursday,February
2024-02-29 08:00:00,39,91,1,1,132,22,91,2,1,116,25.5,78,3,17.9,248,False,8,61,182,3,2,2024-02-29,False,False,False,0.7338709677419355,0.24596774193548387,0.012096774193548387,0.008064516129032258,Peak,Thursday,February
2024-02-29 09:00:00,36,68,1,1,106,29,68,1,1,99,27.9,70,3,16.8,205,False,9,65,136,2,2,2024-02-29,False,False,False,0.6634146341463415,0.3170731707317073,0.00975609756097561,0.00975609756097561,Shoulder,Thursday,February
2024-02-29 10:00:00,22,65,1,2,90,37,65,1,0,103,29.6,62,3,19.7,193,False,10,59,130,2,2,2024-02-29,False,False,False,0.6735751295336787,0.30569948186528495,0.010362694300518135,0.010362694300518135,Shoulder,Thursday,February
2024-02-29 11:00:00,53,73,1,1,128,78,73,2,2,155,31.4,54,3,19.4,283,False,11,131,146,3,3,2024-02-29,False,False,False,0.5159010600706714,0.4628975265017668,0.01060070671378092,0.01060070671378092,Peak,Thursday,February
2024-02-29 12:00:00,88,79,0,1,168,84,79,1,1,165,32.7,48,3,17.4,333,False,12,172,158,1,2,2024-02-29,False,False,False,0.4744744744744745,0.5165165165165165,0.003003003003003003,0.006006006006006006,Peak,Thursday,February
2024-02-29 13:00:00,81,134,0,1,216,41,134,1,1,177,34.1,43,3,14.4,393,False,13,122,268,1,2,2024-02-29,False,False,False,0.6819338422391857,0.3104325699745547,0.002544529262086514,0.005089058524173028,Peak,Thursday,February
2024-02-29 14:00:00,71,158,2,0,231,25,158,1,1,185,35.6,39,3,10.9,416,False,14,96,316,3,1,2024-02-29,False,False,False,0.7596153846153846,0.23076923076923078,0.007211538461538462,0.002403846153846154,Peak,Thursday,February
2024-02-29 15:00:00,68,151,2,2,223,36,151,3,1,191,35.8,37,2,4.1,414,False,15,104,302,5,3,2024-02-29,False,False,False,0.7294685990338164,0.25120772946859904,0.012077294685990338,0.007246376811594203,Peak,Thursday,February
2024-02-29 16:00:00,71,206,2,1,280,47,206,1,2,256,33.9,46,1,12.0,536,False,16,118,412,3,3,2024-02-29,False,False,False,0.7686567164179104,0.22014925373134328,0.005597014925373134,0.005597014925373134,Peak,Thursday,February
2024-02-29 17:00:00,84,164,2,1,251,67,164,0,2,233,32.5,51,2,14.3,484,False,17,151,328,2,3,2024-02-29,False,False,False,0.6776859504132231,0.3119834710743802,0.004132231404958678,0.006198347107438017,Peak,Thursday,February
2024-02-29 18:00:00,67,179,2,1,249,92,179,1,0,272,31.3,59,51,10.9,521,False,18,159,358,3,1,2024-02-29,False,False,False,0.6871401151631478,0.30518234165067176,0.005758157389635317,0.0019193857965451055,Peak,Thursday,February
2024-02-29 19:00:00,46,163,4,1,214,41,163,0,0,204,30.3,66,3,5.4,418,False,19,87,326,4,1,2024-02-29,False,False,False,0.7799043062200957,0.20813397129186603,0.009569377990430622,0.0023923444976076554,Peak,Thursday,February
2024-02-29 20:00:00,30,126,0,2,158,22,126,0,0,148,29.1,74,51,4.6,306,False,20,52,252,0,2,2024-02-29,False,False,False,0.8235294117647058,0.16993464052287582,0.0,0.006535947712418301,Shoulder,Thursday,February
2024-02-29 21:00:00,43,152,4,2,201,29,152,3,0,184,29.6,63,3,3.5,385,False,21,72,304,7,2,2024-02-29,False,False,False,0.7896103896103897,0.18701298701298702,0.01818181818181818,0.005194805194805195,Shoulder,Thursday,February
2024-02-29 22:00:00,38,108,2,0,148,31,108,0,1,140,29.2,64,1,5.4,288,False,22,69,216,2,1,2024-02-29,False,False,False,0.75,0.23958333333333334,0.006944444444444444,0.003472222222222222,Shoulder,Thursday,February
2024-02-29 23:00:00,26,92,1,0,119,33,92,0,0,125,28.8,65,1,9.4,244,False,23,59,184,1,0,2024-02-29,False,False,False,0.7540983606557377,0.24180327868852458,0.004098360655737705,0.0,Shoulder,Thursday,February
2024-03-01 00:00:00,19,94,1,1,115,28,152,2,0,182,28.0,71,1,11.9,297,False,0,47,246,3,1,2024-03-01,False,False,False,0.8282828282828283,0.15824915824915825,0.010101010101010102,0.003367003367003367,Off-Peak,Friday,March
2024-03-01 01:00:00,25,104,1,0,130,14,152,1,0,167,27.1,78,3,13.5,297,False,1,39,256,2,0,2024-03-01,False,False,False,0.8619528619528619,0.13131313131313133,0.006734006734006734,0.0,Off-Peak,Friday,March
2024-03-01 02:00:00,10,88,1,0,99,28,51,1,0,80,26.5,83,3,14.6,179,False,2,38,139,2,0,2024-03-01,False,False,False,0.776536312849162,0.2122905027932961,0.0111731843575419,0.0,Off-Peak,Friday,March
2024-03-01 03:00:00,15,82,0,0,97,28,152,1,0,181,26.2,86,3,14.5,278,False,3,43,234,1,0,2024-03-01,False,False,False,0.841726618705036,0.15467625899280577,0.0035971223021582736,0.0,Off-Peak,Friday,March
2024-03-01 04:00:00,25,83,1,0,109,42,51,1,0,94,26.0,87,3,14.1,203,False,4,67,134,2,0,2024-03-01,False,False,False,0.6600985221674877,0.33004926108374383,0.009852216748768473,0.0,Off-Peak,Friday,March
2024-03-01 05:00:00,19,86,1,0,106,56,152,3,0,211,25.8,88,3,15.2,317,False,5,75,238,4,0,2024-03-01,False,False,False,0.750788643533123,0.23659305993690852,0.012618296529968454,0.0,Shoulder,Friday,March
2024-03-01 06:00:00,43,179,2,1,225,84,305,3,1,393,25.6,88,3,15.6,618,False,6,127,484,5,2,2024-03-01,False,False,False,0.7831715210355987,0.20550161812297735,0.008090614886731391,0.003236245954692557,Shoulder,Friday,March
2024-03-01 07:00:00,87,344,4,0,435,98,356,4,1,459,25.5,88,3,16.3,894,False,7,185,700,8,1,2024-03-01,False,False,False,0.7829977628635347,0.20693512304250558,0.008948545861297539,0.0011185682326621924,Peak,Friday,March
2024-03-01 08:00:00,89,331,5,0,425,141,407,5,1,554,25.9,86,3,17.3,979,False,8,230,738,10,1,2024-03-01,False,False,False,0.7538304392236976,0.23493360572012256,0.010214504596527068,0.0010214504596527069,Peak,Friday,March
2024-03-01 09:00:00,71,375,8,0,454,56,305,2,1,364,28.2,80,3,11.0,818,False,9,127,680,10,1,2024-03-01,False,False,False,0.8312958435207825,0.1552567237163814,0.012224938875305624,0.0012224938875305623,Shoulder,Friday,March
2024-03-01 10:00:00,48,185,3,0,236,70,305,2,1,378,30.5,69,3,14.8,614,False,10,118,490,5,1,2024-03-01,False,False,False,0.7980456026058632,0.19218241042345277,0.008143322475570033,0.0016286644951140066,Shoulder,Friday,March
2024-03-01 11:00:00,78,344,6,0,428,112,508,4,1,625,31.9,62,51,13.1,1053,False,11,190,852,10,1,2024-03-01,False,False,False,0.8091168091168092,0.18043684710351376,0.00949667616334283,0.000949667616334283,Peak,Friday,March
2024-03-01 12:00:00,74,324,4,1,403,141,508,4,1,654,32.8,58,51,13.9,1057,False,12,215,832,8,2,2024-03-01,False,False,False,0.7871333964049196,0.20340586565752128,0.007568590350047304,0.001892147587511826,Peak,Friday,March
2024-03-01 13:00:00,75,354,3,1,433,127,457,5,1,590,31.7,62,51,14.0,1023,False,13,202,811,8,2,2024-03-01,False,False,False,0.7927663734115347,0.19745845552297164,0.007820136852394917,0.0019550342130987292,Peak,Friday,March
2024-03-01 14:00:00,71,348,3,0,422,70,305,2,1,378,30.0,70,63,18.0,800,False,14,141,653,5,1,2024-03-01,False,False,False,0.81625,0.17625,0.00625,0.00125,Peak,Friday,March
2024-03-01 15:00:00,42,169,1,1,213,70,152,2,0,224,29.0,78,55,11.8,437,False,15,112,321,3,1,2024-03-01,False,False,False,0.7345537757437071,0.2562929061784897,0.006864988558352402,0.002288329519450801,Peak,Friday,March
2024-03-01 16:00:00,39,179,0,1,219,42,203,2,1,248,28.9,75,51,10.8,467,False,16,81,382,2,2,2024-03-01,False,False,False,0.8179871520342612,0.1734475374732334,0.004282655246252677,0.004282655246252677,Peak,Friday,March
2024-03-01 17:00:00,81,377,4,0,462,84,407,3,2,496,29.8,70,3,11.1,958,False,17,165,784,7,2,2024-03-01,False,False,False,0.8183716075156576,0.1722338204592902,0.007306889352818371,0.0020876826722338203,Peak,Friday,March
2024-03-01 18:00:00,76,359,7,1,443,98,305,5,2,410,29.5,70,3,13.2,853,False,18,174,664,12,3,2024-03-01,False,False,False,0.7784290738569754,0.20398593200468934,0.01406799531066823,0.0035169988276670576,Peak,Friday,March
2024-03-01 19:00:00,79,335,5,0,419,84,457,4,1,546,28.6,75,3,11.3,965,False,19,163,792,9,1,2024-03-01,False,False,False,0.8207253886010363,0.1689119170984456,0.00932642487046632,0.0010362694300518134,Peak,Friday,March
2024-03-01 20:00:00,83,385,2,2,472,56,305,2,1,364,27.6,79,3,13.8,836,False,20,139,690,4,3,2024-03-01,False,False,False,0.8253588516746412,0.16626794258373206,0.004784688995215311,0.0035885167464114833,Shoulder,Friday,March
2024-03-01 21:00:00,36,187,2,0,225,42,203,2,1,248,24.7,97,63,6.1,473,False,21,78,390,4,1,2024-03-01,False,False,False,0.8245243128964059,0.1649048625792812,0.008456659619450317,0.0021141649048625794,Shoulder,Friday,March
2024-03-01 22:00:00,52,169,1,0,222,84,254,3,1,342,24.6,95,61,7.0,564,False,22,136,423,4,1,2024-03-01,False,False,False,0.75,0.24113475177304963,0.0070921985815602835,0.0017730496453900709,Shoulder,Friday,March
2024-03-01 23:00:00,32,184,2,0,218,88,207,4,0,299,25.2,93,53,9.4,517,False,23,120,391,6,0,2024-03-01,False,False,False,0.7562862669245648,0.23210831721470018,0.01160541586073501,0.0,Shoulder,Friday,March
2024-03-02 00:00:00,13,123,1,0,137,21,79,1,0,101,25.4,93,3,8.9,238,True,0,34,202,2,0,2024-03-02,False,False,False,0.8487394957983193,0.14285714285714285,0.008403361344537815,0.0,Off-Peak,Saturday,March
2024-03-02 01:00:00,38,123,0,0,161,64,158,1,0,223,25.6,91,3,10.3,384,True,1,102,281,1,0,2024-03-02,False,False,False,0.7317708333333334,0.265625,0.0026041666666666665,0.0,Off-Peak,Saturday,March
2024-03-02 02:00:00,25,61,1,0,87,64,79,3,0,146,25.5,91,3,12.6,233,True,2,89,140,4,0,2024-03-02,False,False,False,0.6008583690987125,0.38197424892703863,0.017167381974248927,0.0,Off-Peak,Saturday,March
2024-03-02 03:00:00,25,123,1,0,149,43,158,2,0,203,25.1,92,3,10.5,352,True,3,68,281,3,0,2024-03-02,False,False,False,0.7982954545454546,0.19318181818181818,0.008522727272727272,0.0,Off-Peak,Saturday,March
2024-03-02 04:00:00,25,61,1,0,87,64,158,2,0,224,24.9,93,3,10.6,311,True,4,89,219,3,0,2024-03-02,False,False,False,0.7041800643086816,0.2861736334405145,0.00964630225080386,0.0,Off-Peak,Saturday,March
2024-03-02 05:00:00,38,307,1,0,346,85,237,5,1,328,24.7,93,3,10.6,674,True,5,123,544,6,1,2024-03-02,False,False,False,0.8071216617210683,0.1824925816023739,0.008902077151335312,0.001483679525222552,Shoulder,Saturday,March
2024-03-02 06:00:00,38,307,2,0,347,64,474,5,1,544,24.6,93,3,9.7,891,True,6,102,781,7,1,2024-03-02,False,False,False,0.8765432098765432,0.11447811447811448,0.007856341189674524,0.001122334455667789,Shoulder,Saturday,March
2024-03-02 07:00:00,114,369,5,1,489,192,632,8,1,833,24.4,94,3,10.2,1322,True,7,306,1001,13,2,2024-03-02,False,False,False,0.7571860816944024,0.2314674735249622,0.009833585476550681,0.0015128593040847202,Peak,Saturday,March
2024-03-02 08:00:00,127,492,5,1,625,171,711,8,1,891,24.8,93,3,11.5,1516,True,8,298,1203,13,2,2024-03-02,False,False,True,0.7935356200527705,0.19656992084432717,0.008575197889182058,0.0013192612137203166,Peak,Saturday,March
2024-03-02 09:00:00,76,184,2,1,263,128,395,3,1,527,27.2,86,3,13.4,790,True,9,204,579,5,2,2024-03-02,False,False,False,0.7329113924050633,0.2582278481012658,0.006329113924050633,0.002531645569620253,Shoulder,Saturday,March
2024-03-02 10:00:00,76,307,1,0,384,85,316,4,1,406,28.7,79,51,12.3,790,True,10,161,623,5,1,2024-03-02,False,False,False,0.7886075949367088,0.20379746835443038,0.006329113924050633,0.0012658227848101266,Shoulder,Saturday,March
2024-03-02 11:00:00,89,615,3,1,708,213,711,8,1,933,30.4,71,3,12.7,1641,True,11,302,1326,11,2,2024-03-02,False,False,True,0.8080438756855576,0.18403412553321147,0.006703229737964655,0.001218769043266301,Peak,Saturday,March
2024-03-02 12:00:00,127,430,5,1,563,128,711,7,1,847,32.0,64,3,13.6,1410,True,12,255,1141,12,2,2024-03-02,False,False,True,0.8092198581560284,0.18085106382978725,0.00851063829787234,0.0014184397163120568,Peak,Saturday,March
2024-03-02 13:00:00,127,369,5,1,502,149,553,8,1,711,33.2,58,3,14.2,1213,True,13,276,922,13,2,2024-03-02,False,False,False,0.7600989282769992,0.22753503709810388,0.010717230008244023,0.0016488046166529267,Peak,Saturday,March
2024-03-02 14:00:00,76,184,2,0,262,128,474,5,1,608,33.0,57,3,4.1,870,True,14,204,658,7,1,2024-03-02,False,False,False,0.7563218390804598,0.23448275862068965,0.008045977011494253,0.0011494252873563218,Peak,Saturday,March
2024-03-02 15:00:00,51,369,2,0,422,64,237,3,1,305,28.1,78,65,8.3,727,True,15,115,606,5,1,2024-03-02,False,False,False,0.8335625859697386,0.15818431911966988,0.0068775790921595595,0.001375515818431912,Peak,Saturday,March
2024-03-02 16:00:00,63,307,2,0,372,128,395,5,1,529,28.1,81,63,7.4,901,True,16,191,702,7,1,2024-03-02,False,False,False,0.779134295227525,0.21198668146503885,0.00776914539400666,0.0011098779134295228,Peak,Saturday,March
2024-03-02 17:00:00,114,553,3,1,671,128,790,8,1,927,28.5,80,3,9.7,1598,True,17,242,1343,11,2,2024-03-02,False,False,True,0.8404255319148937,0.15143929912390489,0.00688360450563204,0.0012515644555694619,Peak,Saturday,March
2024-03-02 18:00:00,127,553,5,1,686,213,632,8,1,854,27.5,84,63,11.5,1540,True,18,340,1185,13,2,2024-03-02,False,False,True,0.7694805194805194,0.22077922077922077,0.008441558441558441,0.0012987012987012987,Peak,Saturday,March
2024-03-02 19:00:00,76,615,5,1,697,171,711,5,1,888,27.3,85,3,11.2,1585,True,19,247,1326,10,2,2024-03-02,False,False,True,0.8365930599369085,0.15583596214511042,0.006309148264984227,0.0012618296529968455,Peak,Saturday,March
2024-03-02 20:00:00,76,369,3,0,448,64,316,4,1,385,26.4,89,3,9.6,833,True,20,140,685,7,1,2024-03-02,False,False,False,0.8223289315726291,0.16806722689075632,0.008403361344537815,0.0012004801920768306,Shoulder,Saturday,March
2024-03-02 21:00:00,51,246,1,0,298,64,237,5,1,307,26.7,87,51,19.6,605,True,21,115,483,6,1,2024-03-02,False,False,False,0.7983471074380165,0.19008264462809918,0.009917355371900827,0.001652892561983471,Shoulder,Saturday,March
2024-03-02 22:00:00,63,307,2,0,372,107,474,5,0,586,25.1,94,63,16.4,958,True,22,170,781,7,0,2024-03-02,False,False,False,0.8152400835073069,0.17745302713987474,0.007306889352818371,0.0,Shoulder,Saturday,March
2024-03-02 23:00:00,64,374,1,2,441,128,312,1,0,441,25.7,93,51,15.1,882,True,23,192,686,2,2,2024-03-02,False,False,False,0.7777777777777778,0.21768707482993196,0.0022675736961451248,0.0022675736961451248,Shoulder,Saturday,March
2024-03-03 00:00:00,14,165,1,0,180,63,197,3,0,263,25.4,92,3,14.2,443,True,0,77,362,4,0,2024-03-03,False,False,False,0.8171557562076749,0.17381489841986456,0.009029345372460496,0.0,Off-Peak,Sunday,March
2024-03-03 01:00:00,14,110,1,0,125,63,66,2,0,131,25.1,93,2,12.3,256,True,1,77,176,3,0,2024-03-03,False,False,False,0.6875,0.30078125,0.01171875,0.0,Off-Peak,Sunday,March
2024-03-03 02:00:00,28,110,1,0,139,21,197,1,0,219,24.9,94,3,10.2,358,True,2,49,307,2,0,2024-03-03,False,False,False,0.8575418994413407,0.13687150837988826,0.00558659217877095,0.0,Off-Peak,Sunday,March
2024-03-03 03:00:00,28,110,1,0,139,42,197,1,0,240,24.9,95,51,7.0,379,True,3,70,307,2,0,2024-03-03,False,False,False,0.8100263852242744,0.18469656992084432,0.005277044854881266,0.0,Off-Peak,Sunday,March
2024-03-03 04:00:00,42,165,0,0,207,21,65,2,0,88,24.8,95,3,10.7,295,True,4,63,230,2,0,2024-03-03,False,False,False,0.7796610169491526,0.2135593220338983,0.006779661016949152,0.0,Off-Peak,Sunday,March
2024-03-03 05:00:00,42,220,2,1,265,84,197,5,0,286,24.7,96,3,9.5,551,True,5,126,417,7,1,2024-03-03,False,False,False,0.7568058076225045,0.22867513611615245,0.012704174228675136,0.0018148820326678765,Shoulder,Sunday,March
2024-03-03 06:00:00,42,275,2,0,319,105,262,7,0,374,24.5,96,3,10.2,693,True,6,147,537,9,0,2024-03-03,False,False,False,0.7748917748917749,0.21212121212121213,0.012987012987012988,0.0,Shoulder,Sunday,March
2024-03-03 07:00:00,113,549,3,1,666,188,590,7,1,786,24.5,96,3,9.7,1452,True,7,301,1139,10,2,2024-03-03,False,False,True,0.7844352617079889,0.20730027548209368,0.006887052341597796,0.0013774104683195593,Peak,Sunday,March
2024-03-03 08:00:00,84,384,3,1,472,146,525,8,1,680,24.6,96,51,8.5,1152,True,8,230,909,11,2,2024-03-03,False,False,False,0.7890625,0.1996527777777778,0.009548611111111112,0.001736111111111111,Peak,Sunday,March
2024-03-03 09:00:00,70,275,1,0,346,105,328,3,1,437,25.1,94,53,15.0,783,True,9,175,603,4,1,2024-03-03,False,False,False,0.7701149425287356,0.22349936143039592,0.005108556832694764,0.001277139208173691,Shoulder,Sunday,March
2024-03-03 10:00:00,70,165,1,0,236,105,394,3,1,503,26.9,85,51,18.8,739,True,10,175,559,4,1,2024-03-03,False,False,False,0.7564276048714479,0.2368064952638701,0.005412719891745603,0.0013531799729364006,Shoulder,Sunday,March
2024-03-03 11:00:00,99,494,2,1,596,209,525,7,1,742,27.9,81,51,16.4,1338,True,11,308,1019,9,2,2024-03-03,False,False,False,0.7615844544095666,0.23019431988041852,0.006726457399103139,0.0014947683109118087,Peak,Sunday,March
2024-03-03 12:00:00,99,494,3,1,597,126,656,9,1,792,29.2,77,51,16.1,1389,True,12,225,1150,12,2,2024-03-03,False,False,True,0.827933765298776,0.16198704103671707,0.008639308855291577,0.0014398848092152627,Peak,Sunday,March
2024-03-03 13:00:00,84,494,2,1,581,188,590,11,1,790,28.6,74,61,16.4,1371,True,13,272,1084,13,2,2024-03-03,False,False,False,0.7906637490882568,0.19839533187454414,0.009482129832239242,0.0014587892049598833,Peak,Sunday,March
2024-03-03 14:00:00,84,220,1,0,305,84,394,4,0,482,28.5,79,53,13.5,787,True,14,168,614,5,0,2024-03-03,False,False,False,0.7801778907242694,0.21346886912325286,0.0063532401524777635,0.0,Peak,Sunday,March
2024-03-03 15:00:00,84,220,1,0,305,126,394,3,0,523,28.7,77,55,13.2,828,True,15,210,614,4,0,2024-03-03,False,False,False,0.7415458937198067,0.2536231884057971,0.004830917874396135,0.0,Peak,Sunday,March
2024-03-03 16:00:00,84,220,2,1,307,105,262,3,1,371,29.8,74,51,15.3,678,True,16,189,482,5,2,2024-03-03,False,False,False,0.7109144542772862,0.27876106194690264,0.007374631268436578,0.0029498525073746312,Peak,Sunday,March
2024-03-03 17:00:00,84,330,3,1,418,126,394,9,1,530,28.4,80,61,14.1,948,True,17,210,724,12,2,2024-03-03,False,False,False,0.7637130801687764,0.22151898734177214,0.012658227848101266,0.002109704641350211,Peak,Sunday,March
2024-03-03 18:00:00,84,549,2,1,636,188,459,9,1,657,28.1,80,53,12.5,1293,True,18,272,1008,11,2,2024-03-03,False,False,False,0.7795823665893271,0.21036349574632637,0.008507347254447023,0.0015467904098994587,Peak,Sunday,March
2024-03-03 19:00:00,84,549,3,1,637,167,525,8,1,701,27.6,82,51,10.0,1338,True,19,251,1074,11,2,2024-03-03,False,False,False,0.8026905829596412,0.187593423019432,0.008221225710014948,0.0014947683109118087,Peak,Sunday,March
2024-03-03 20:00:00,70,220,2,0,292,84,328,4,0,416,26.9,85,51,7.4,708,True,20,154,548,6,0,2024-03-03,False,False,False,0.7740112994350282,0.2175141242937853,0.00847457627118644,0.0,Shoulder,Sunday,March
2024-03-03 21:00:00,56,220,1,1,278,105,262,5,1,373,26.3,92,51,12.2,651,True,21,161,482,6,2,2024-03-03,False,False,False,0.7403993855606759,0.24731182795698925,0.009216589861751152,0.0030721966205837174,Shoulder,Sunday,March
2024-03-03 22:00:00,70,166,0,1,237,84,328,6,1,419,26.2,92,51,12.0,656,True,22,154,494,6,2,2024-03-03,False,False,False,0.7530487804878049,0.2347560975609756,0.009146341463414634,0.003048780487804878,Shoulder,Sunday,March
2024-03-03 23:00:00,90,272,2,0,364,125,394,6,0,525,26.0,93,3,11.0,889,True,23,215,666,8,0,2024-03-03,False,False,False,0.749156355455568,0.24184476940382452,0.008998875140607425,0.0,Shoulder,Sunday,March
2024-03-04 00:00:00,21,185,1,0,207,49,160,3,0,212,25.7,93,51,11.7,419,False,0,70,345,4,0,2024-03-04,False,True,False,0.8233890214797136,0.16706443914081145,0.00954653937947494,0.0,Off-Peak,Monday,March
2024-03-04 01:00:00,10,185,1,0,196,73,80,1,0,154,25.6,94,3,12.5,350,False,1,83,265,2,0,2024-03-04,False,True,False,0.7571428571428571,0.23714285714285716,0.005714285714285714,0.0,Off-Peak,Monday,March
2024-03-04 02:00:00,31,185,2,0,218,49,160,3,0,212,25.4,94,3,13.1,430,False,2,80,345,5,0,2024-03-04,False,True,False,0.8023255813953488,0.18604651162790697,0.011627906976744186,0.0,Off-Peak,Monday,March
2024-03-04 03:00:00,21,185,2,0,208,24,240,1,0,265,25.0,94,3,10.8,473,False,3,45,425,3,0,2024-03-04,False,True,False,0.8985200845665962,0.09513742071881606,0.006342494714587738,0.0,Off-Peak,Monday,March
2024-03-04 04:00:00,21,123,1,0,145,24,240,3,0,267,24.9,95,3,10.8,412,False,4,45,363,4,0,2024-03-04,False,True,False,0.8810679611650486,0.10922330097087378,0.009708737864077669,0.0,Off-Peak,Monday,March
2024-03-04 05:00:00,51,247,3,1,302,97,400,6,0,503,24.9,95,3,10.7,805,False,5,148,647,9,1,2024-03-04,False,True,False,0.8037267080745342,0.18385093167701863,0.011180124223602485,0.0012422360248447205,Shoulder,Monday,March
2024-03-04 06:00:00,51,185,4,0,240,97,320,7,1,425,24.8,94,3,12.8,665,False,6,148,505,11,1,2024-03-04,False,True,False,0.7593984962406015,0.22255639097744362,0.016541353383458645,0.0015037593984962407,Shoulder,Monday,March
2024-03-04 07:00:00,82,431,4,0,517,243,480,9,1,733,24.8,94,3,10.5,1250,False,7,325,911,13,1,2024-03-04,False,True,False,0.7288,0.26,0.0104,0.0008,Peak,Monday,March
2024-03-04 08:00:00,82,616,7,1,706,219,640,7,1,867,25.0,93,3,12.0,1573,False,8,301,1256,14,2,2024-03-04,False,True,True,0.7984742530197075,0.19135410044500953,0.008900190718372537,0.0012714558169103624,Peak,Monday,March
2024-03-04 09:00:00,62,247,3,0,312,97,480,6,0,583,26.9,88,3,8.7,895,False,9,159,727,9,0,2024-03-04,False,True,False,0.8122905027932961,0.1776536312849162,0.01005586592178771,0.0,Shoulder,Monday,March
2024-03-04 10:00:00,51,185,3,0,239,97,400,7,0,504,28.5,79,51,12.3,743,False,10,148,585,10,0,2024-03-04,False,True,False,0.7873485868102288,0.19919246298788695,0.013458950201884253,0.0,Shoulder,Monday,March
2024-03-04 11:00:00,102,493,5,1,601,219,799,10,1,1029,29.7,75,51,11.0,1630,False,11,321,1292,15,2,2024-03-04,False,True,True,0.7926380368098159,0.19693251533742331,0.009202453987730062,0.001226993865030675,Peak,Monday,March
2024-03-04 12:00:00,82,370,5,1,458,243,799,8,1,1051,31.1,67,51,9.8,1509,False,12,325,1169,13,2,2024-03-04,False,True,True,0.7746852220013254,0.21537442014579192,0.008614976805831677,0.0013253810470510272,Peak,Monday,March
2024-03-04 13:00:00,102,431,4,1,538,146,799,10,1,956,30.2,70,51,2.7,1494,False,13,248,1230,14,2,2024-03-04,False,True,True,0.8232931726907631,0.16599732262382866,0.009370816599732263,0.0013386880856760374,Peak,Monday,March
2024-03-04 14:00:00,51,247,4,0,302,73,480,6,1,560,28.9,82,53,3.2,862,False,14,124,727,10,1,2024-03-04,False,True,False,0.8433874709976799,0.14385150812064965,0.01160092807424594,0.001160092807424594,Peak,Monday,March
2024-03-04 15:00:00,41,247,4,0,292,146,320,6,0,472,27.9,86,53,6.4,764,False,15,187,567,10,0,2024-03-04,False,True,False,0.7421465968586387,0.24476439790575916,0.013089005235602094,0.0,Peak,Monday,March
2024-03-04 16:00:00,62,246,4,0,312,122,400,6,0,528,29.0,81,51,9.2,840,False,16,184,646,10,0,2024-03-04,False,True,False,0.7690476190476191,0.21904761904761905,0.011904761904761904,0.0,Peak,Monday,March
2024-03-04 17:00:00,82,431,4,1,518,195,480,8,1,684,29.5,76,51,4.3,1202,False,17,277,911,12,2,2024-03-04,False,True,False,0.7579034941763727,0.23044925124792012,0.009983361064891847,0.0016638935108153079,Peak,Monday,March
2024-03-04 18:00:00,102,616,5,1,724,195,560,12,0,767,28.1,82,61,11.2,1491,False,18,297,1176,17,1,2024-03-04,False,True,True,0.7887323943661971,0.19919517102615694,0.011401743796109993,0.0006706908115358819,Peak,Monday,March
2024-03-04 19:00:00,92,493,5,1,591,170,799,8,1,978,27.4,84,51,4.0,1569,False,19,262,1292,13,2,2024-03-04,False,True,True,0.8234544295729764,0.16698534098151688,0.0082855321861058,0.0012746972594008922,Peak,Monday,March
2024-03-04 20:00:00,51,308,3,0,362,97,320,7,0,424,26.6,92,2,3.7,786,False,20,148,628,10,0,2024-03-04,False,True,False,0.7989821882951654,0.18829516539440203,0.01272264631043257,0.0,Shoulder,Monday,March
2024-03-04 21:00:00,41,308,4,0,353,146,480,7,0,633,27.0,92,3,6.9,986,False,21,187,788,11,0,2024-03-04,False,True,False,0.7991886409736308,0.1896551724137931,0.011156186612576065,0.0,Shoulder,Monday,March
2024-03-04 22:00:00,41,185,4,0,230,146,320,3,0,469,26.3,96,3,4.6,699,False,22,187,505,7,0,2024-03-04,False,True,False,0.7224606580829757,0.2675250357653791,0.010014306151645207,0.0,Shoulder,Monday,March
2024-03-04 23:00:00,41,370,2,0,413,97,400,5,0,502,26.2,96,3,5.4,915,False,23,138,770,7,0,2024-03-04,False,True,False,0.8415300546448088,0.15081967213114755,0.007650273224043716,0.0,Shoulder,Monday,March
2024-03-05 00:00:00,37,63,1,0,101,26,267,3,0,296,25.7,96,3,5.6,397,False,0,63,330,4,0,2024-03-05,False,False,False,0.8312342569269522,0.15869017632241814,0.010075566750629723,0.0,Off-Peak,Tuesday,March
2024-03-05 01:00:00,25,63,2,0,90,51,178,2,0,231,25.3,96,3,3.3,321,False,1,76,241,4,0,2024-03-05,False,False,False,0.7507788161993769,0.2367601246105919,0.012461059190031152,0.0,Off-Peak,Tuesday,March
2024-03-05 02:00:00,37,126,1,0,164,51,267,3,0,321,24.8,99,2,2.6,485,False,2,88,393,4,0,2024-03-05,False,False,False,0.8103092783505155,0.18144329896907216,0.008247422680412371,0.0,Off-Peak,Tuesday,March
2024-03-05 03:00:00,25,188,2,0,215,26,266,1,0,293,24.5,99,3,3.7,508,False,3,51,454,3,0,2024-03-05,False,False,False,0.8937007874015748,0.10039370078740158,0.005905511811023622,0.0,Off-Peak,Tuesday,March
2024-03-05 04:00:00,12,188,2,0,202,77,89,3,0,169,25.0,96,3,5.1,371,False,4,89,277,5,0,2024-03-05,False,False,False,0.7466307277628033,0.2398921832884097,0.013477088948787063,0.0,Off-Peak,Tuesday,March
2024-03-05 05:00:00,50,188,5,1,244,153,533,3,0,689,24.6,97,3,3.9,933,False,5,203,721,8,1,2024-03-05,False,False,False,0.7727759914255091,0.21757770632368703,0.00857449088960343,0.0010718113612004287,Shoulder,Tuesday,March
2024-03-05 06:00:00,37,188,2,1,228,77,533,3,0,613,24.9,95,3,6.4,841,False,6,114,721,5,1,2024-03-05,False,False,False,0.8573127229488704,0.13555291319857313,0.005945303210463734,0.0011890606420927466,Shoulder,Tuesday,March
2024-03-05 07:00:00,75,502,7,1,585,229,533,6,1,769,24.8,96,3,7.5,1354,False,7,304,1035,13,2,2024-03-05,False,False,False,0.7644017725258493,0.22451994091580502,0.009601181683899557,0.0014771048744460858,Peak,Tuesday,March
2024-03-05 08:00:00,75,502,6,1,584,204,533,6,1,744,25.2,94,3,8.2,1328,False,8,279,1035,12,2,2024-03-05,False,False,False,0.7793674698795181,0.21009036144578314,0.009036144578313253,0.0015060240963855422,Peak,Tuesday,March
2024-03-05 09:00:00,75,377,3,0,455,127,266,6,0,399,26.7,91,3,7.0,854,False,9,202,643,9,0,2024-03-05,False,False,False,0.752927400468384,0.23653395784543327,0.01053864168618267,0.0,Shoulder,Tuesday,March
2024-03-05 10:00:00,62,188,2,0,252,153,355,6,0,514,28.2,85,3,8.0,766,False,10,215,543,8,0,2024-03-05,False,False,False,0.7088772845953003,0.28067885117493474,0.010443864229765013,0.0,Shoulder,Tuesday,March
2024-03-05 11:00:00,112,565,5,1,683,204,622,11,1,838,29.5,79,51,6.4,1521,False,11,316,1187,16,2,2024-03-05,False,False,True,0.7804076265614727,0.20775805391190005,0.01051939513477975,0.0013149243918474688,Peak,Tuesday,March
2024-03-05 12:00:00,99,565,7,1,672,178,711,10,1,900,29.3,78,51,6.6,1572,False,12,277,1276,17,2,2024-03-05,False,False,True,0.811704834605598,0.1762086513994911,0.010814249363867684,0.001272264631043257,Peak,Tuesday,March
2024-03-05 13:00:00,87,565,7,1,660,153,799,6,1,959,28.7,82,63,10.4,1619,False,13,240,1364,13,2,2024-03-05,False,False,True,0.8424953675108091,0.14823965410747375,0.008029647930821495,0.0012353304508956147,Peak,Tuesday,March
2024-03-05 14:00:00,74,188,3,1,266,153,355,3,0,511,27.8,86,51,7.7,777,False,14,227,543,6,1,2024-03-05,False,False,False,0.6988416988416989,0.29214929214929214,0.007722007722007722,0.001287001287001287,Peak,Tuesday,March
2024-03-05 15:00:00,62,188,2,0,252,102,533,4,0,639,28.0,81,61,4.9,891,False,15,164,721,6,0,2024-03-05,False,False,False,0.8092031425364759,0.1840628507295174,0.006734006734006734,0.0,Peak,Tuesday,March
2024-03-05 16:00:00,62,188,3,1,254,76,355,3,1,435,27.1,85,53,15.5,689,False,16,138,543,6,2,2024-03-05,False,False,False,0.7880986937590712,0.20029027576197386,0.008708272859216255,0.002902757619738752,Peak,Tuesday,March
2024-03-05 17:00:00,87,502,6,1,596,178,622,9,1,810,26.7,87,53,5.8,1406,False,17,265,1124,15,2,2024-03-05,False,False,True,0.7994310099573257,0.18847795163584638,0.010668563300142247,0.001422475106685633,Peak,Tuesday,March
2024-03-05 18:00:00,99,628,5,1,733,229,711,6,1,947,26.8,88,51,4.2,1680,False,18,328,1339,11,2,2024-03-05,False,False,True,0.7970238095238096,0.19523809523809524,0.006547619047619048,0.0011904761904761906,Peak,Tuesday,March
2024-03-05 19:00:00,74,377,4,1,456,229,622,9,1,861,26.8,89,51,3.8,1317,False,19,303,999,13,2,2024-03-05,False,False,False,0.7585421412300684,0.23006833712984054,0.009870918754745633,0.0015186028853454822,Peak,Tuesday,March
2024-03-05 20:00:00,74,314,2,0,390,127,533,5,0,665,26.0,94,3,6.0,1055,False,20,201,847,7,0,2024-03-05,False,False,False,0.8028436018957346,0.190521327014218,0.006635071090047393,0.0,Shoulder,Tuesday,March
2024-03-05 21:00:00,50,377,2,1,430,102,266,6,0,374,24.9,96,53,10.5,804,False,21,152,643,8,1,2024-03-05,False,False,False,0.7997512437810945,0.1890547263681592,0.009950248756218905,0.0012437810945273632,Shoulder,Tuesday,March
2024-03-05 22:00:00,37,377,4,0,418,153,266,4,0,423,24.5,96,51,6.7,841,False,22,190,643,8,0,2024-03-05,False,False,False,0.7645659928656362,0.2259215219976219,0.009512485136741973,0.0,Shoulder,Tuesday,March
2024-03-05 23:00:00,37,314,2,1,354,76,444,6,0,526,24.1,97,3,2.3,880,False,23,113,758,8,1,2024-03-05,False,False,False,0.8613636363636363,0.12840909090909092,0.00909090909090909,0.0011363636363636363,Shoulder,Tuesday,March
2024-03-06 00:00:00,10,63,1,0,74,48,245,1,0,294,24.2,96,3,5.6,368,False,0,58,308,2,0,2024-03-06,False,False,False,0.8369565217391305,0.15760869565217392,0.005434782608695652,0.0,Off-Peak,Wednesday,March
2024-03-06 01:00:00,19,63,1,0,83,24,82,2,0,108,24.1,95,3,6.2,191,False,1,43,145,3,0,2024-03-06,False,False,False,0.7591623036649214,0.225130890052356,0.015706806282722512,0.0,Off-Peak,Wednesday,March
2024-03-06 02:00:00,29,126,1,0,156,48,245,3,0,296,23.9,96,3,5.0,452,False,2,77,371,4,0,2024-03-06,False,False,False,0.8207964601769911,0.17035398230088494,0.008849557522123894,0.0,Off-Peak,Wednesday,March
2024-03-06 03:00:00,19,126,1,1,147,73,163,3,0,239,23.8,97,3,4.8,386,False,3,92,289,4,1,2024-03-06,False,False,False,0.7487046632124352,0.23834196891191708,0.010362694300518135,0.0025906735751295338,Off-Peak,Wednesday,March
2024-03-06 04:00:00,29,63,1,0,93,73,244,2,0,319,23.8,97,3,4.5,412,False,4,102,307,3,0,2024-03-06,False,False,False,0.7451456310679612,0.24757281553398058,0.007281553398058253,0.0,Off-Peak,Wednesday,March
2024-03-06 05:00:00,48,314,3,1,366,97,244,4,0,345,23.8,98,3,5.4,711,False,5,145,558,7,1,2024-03-06,False,False,False,0.7848101265822784,0.2039381153305204,0.009845288326300985,0.0014064697609001407,Shoulder,Wednesday,March
2024-03-06 06:00:00,38,188,4,1,231,73,407,5,1,486,23.8,97,2,5.2,717,False,6,111,595,9,2,2024-03-06,False,False,False,0.8298465829846583,0.15481171548117154,0.012552301255230125,0.002789400278940028,Shoulder,Wednesday,March
2024-03-06 07:00:00,77,627,7,1,712,193,733,9,1,936,23.6,97,3,5.1,1648,False,7,270,1360,16,2,2024-03-06,False,False,True,0.8252427184466019,0.1638349514563107,0.009708737864077669,0.0012135922330097086,Peak,Wednesday,March
2024-03-06 08:00:00,96,376,6,1,479,169,652,8,1,830,23.9,96,3,6.1,1309,False,8,265,1028,14,2,2024-03-06,False,False,False,0.7853323147440795,0.20244461420932008,0.0106951871657754,0.0015278838808250573,Peak,Wednesday,March
2024-03-06 09:00:00,48,376,4,1,429,72,489,4,1,566,25.3,96,65,7.2,995,False,9,120,865,8,2,2024-03-06,False,False,False,0.8693467336683417,0.12060301507537688,0.008040201005025126,0.0020100502512562816,Shoulder,Wednesday,March
2024-03-06 10:00:00,29,314,4,1,348,97,407,5,1,510,24.9,96,63,10.0,858,False,10,126,721,9,2,2024-03-06,False,False,False,0.8403263403263403,0.14685314685314685,0.01048951048951049,0.002331002331002331,Shoulder,Wednesday,March
2024-03-06 11:00:00,96,565,6,1,668,242,489,8,1,740,26.5,86,51,6.6,1408,False,11,338,1054,14,2,2024-03-06,False,False,True,0.7485795454545454,0.24005681818181818,0.009943181818181818,0.0014204545454545455,Peak,Wednesday,March
2024-03-06 12:00:00,58,565,5,1,629,218,733,9,1,961,28.5,83,3,3.9,1590,False,12,276,1298,14,2,2024-03-06,False,False,True,0.8163522012578617,0.17358490566037735,0.00880503144654088,0.0012578616352201257,Peak,Wednesday,March
2024-03-06 13:00:00,96,376,7,1,480,193,570,6,1,770,30.3,76,51,0.8,1250,False,13,289,946,13,2,2024-03-06,False,False,False,0.7568,0.2312,0.0104,0.0016,Peak,Wednesday,March
2024-03-06 14:00:00,38,251,2,1,292,72,326,3,1,402,30.7,76,51,5.9,694,False,14,110,577,5,2,2024-03-06,False,False,False,0.8314121037463977,0.1585014409221902,0.007204610951008645,0.002881844380403458,Peak,Wednesday,March
2024-03-06 15:00:00,38,314,3,0,355,97,326,3,0,426,30.6,76,51,6.6,781,False,15,135,640,6,0,2024-03-06,False,False,False,0.8194622279129321,0.17285531370038412,0.0076824583866837385,0.0,Peak,Wednesday,March
2024-03-06 16:00:00,38,188,2,1,229,97,489,3,1,590,28.2,86,63,10.8,819,False,16,135,677,5,2,2024-03-06,False,False,False,0.8266178266178266,0.16483516483516483,0.006105006105006105,0.002442002442002442,Peak,Wednesday,March
2024-03-06 17:00:00,96,627,5,1,729,193,652,5,1,851,27.7,85,51,5.9,1580,False,17,289,1279,10,2,2024-03-06,False,False,True,0.8094936708860759,0.1829113924050633,0.006329113924050633,0.0012658227848101266,Peak,Wednesday,March
2024-03-06 18:00:00,58,376,6,1,441,193,652,8,1,854,27.3,87,51,5.2,1295,False,18,251,1028,14,2,2024-03-06,False,False,False,0.7938223938223938,0.19382239382239383,0.010810810810810811,0.0015444015444015444,Peak,Wednesday,March
2024-03-06 19:00:00,77,439,7,1,524,193,570,6,1,770,27.1,89,51,4.4,1294,False,19,270,1009,13,2,2024-03-06,False,False,False,0.7797527047913446,0.20865533230293662,0.010046367851622875,0.0015455950540958269,Peak,Wednesday,March
2024-03-06 20:00:00,38,251,3,1,293,145,244,4,0,393,26.5,94,3,3.6,686,False,20,183,495,7,1,2024-03-06,False,False,False,0.7215743440233237,0.26676384839650147,0.01020408163265306,0.0014577259475218659,Shoulder,Wednesday,March
2024-03-06 21:00:00,38,251,4,0,293,97,489,3,1,590,27.4,85,3,8.7,883,False,21,135,740,7,1,2024-03-06,False,False,False,0.8380520951302378,0.15288788221970556,0.007927519818799546,0.0011325028312570782,Shoulder,Wednesday,March
2024-03-06 22:00:00,58,314,4,0,376,145,489,4,0,638,26.8,91,1,9.0,1014,False,22,203,803,8,0,2024-03-06,False,False,False,0.7919132149901381,0.20019723865877712,0.007889546351084813,0.0,Shoulder,Wednesday,March
2024-03-06 23:00:00,57,314,3,1,375,97,489,3,0,589,26.2,93,0,6.2,964,False,23,154,803,6,1,2024-03-06,False,False,False,0.83298755186722,0.15975103734439833,0.006224066390041493,0.001037344398340249,Shoulder,Wednesday,March
2024-03-07 00:00:00,24,63,1,0,88,68,254,2,0,324,25.8,94,3,3.6,412,False,0,92,317,3,0,2024-03-07,False,False,False,0.7694174757281553,0.22330097087378642,0.007281553398058253,0.0,Off-Peak,Thursday,March
2024-03-07 01:00:00,36,63,2,0,101,68,169,4,0,241,25.9,94,3,4.7,342,False,1,104,232,6,0,2024-03-07,False,False,False,0.6783625730994152,0.30409356725146197,0.017543859649122806,0.0,Off-Peak,Thursday,March
2024-03-07 02:00:00,24,127,1,0,152,23,254,4,0,281,25.5,96,3,5.0,433,False,2,47,381,5,0,2024-03-07,False,False,False,0.8799076212471132,0.10854503464203233,0.011547344110854504,0.0,Off-Peak,Thursday,March
2024-03-07 03:00:00,24,126,2,0,152,22,84,4,0,110,25.5,96,3,6.8,262,False,3,46,210,6,0,2024-03-07,False,False,False,0.8015267175572519,0.17557251908396945,0.022900763358778626,0.0,Off-Peak,Thursday,March
2024-03-07 04:00:00,12,126,1,0,139,68,84,2,0,154,25.3,95,3,4.7,293,False,4,80,210,3,0,2024-03-07,False,False,False,0.7167235494880546,0.27303754266211605,0.010238907849829351,0.0,Off-Peak,Thursday,March
2024-03-07 05:00:00,36,253,2,1,292,113,507,8,0,628,24.9,96,3,5.3,920,False,5,149,760,10,1,2024-03-07,False,False,False,0.8260869565217391,0.16195652173913044,0.010869565217391304,0.0010869565217391304,Shoulder,Thursday,March
2024-03-07 06:00:00,48,316,2,0,366,90,254,5,0,349,24.6,97,3,4.3,715,False,6,138,570,7,0,2024-03-07,False,False,False,0.7972027972027972,0.193006993006993,0.009790209790209791,0.0,Shoulder,Thursday,March
2024-03-07 07:00:00,83,569,6,1,659,158,761,13,1,933,24.3,98,3,2.8,1592,False,7,241,1330,19,2,2024-03-07,False,False,True,0.835427135678392,0.1513819095477387,0.01193467336683417,0.001256281407035176,Peak,Thursday,March
2024-03-07 08:00:00,71,380,6,1,458,226,592,10,0,828,24.8,96,3,6.5,1286,False,8,297,972,16,1,2024-03-07,False,False,False,0.7558320373250389,0.23094867807153965,0.012441679626749611,0.0007776049766718507,Peak,Thursday,March
2024-03-07 09:00:00,36,380,2,0,418,90,423,5,0,518,27.9,90,3,2.6,936,False,9,126,803,7,0,2024-03-07,False,False,False,0.8579059829059829,0.1346153846153846,0.007478632478632479,0.0,Shoulder,Thursday,March
2024-03-07 10:00:00,59,316,3,0,378,90,338,4,0,432,29.1,81,51,4.3,810,False,10,149,654,7,0,2024-03-07,False,False,False,0.8074074074074075,0.18395061728395062,0.008641975308641974,0.0,Shoulder,Thursday,March
2024-03-07 11:00:00,119,380,6,1,506,181,845,10,1,1037,29.9,77,51,5.4,1543,False,11,300,1225,16,2,2024-03-07,False,False,True,0.7939079714841218,0.19442644199611148,0.010369410239792612,0.0012961762799740765,Peak,Thursday,March
2024-03-07 12:00:00,71,633,5,1,710,181,592,13,1,787,30.3,75,51,6.6,1497,False,12,252,1225,18,2,2024-03-07,False,False,True,0.8183032732130928,0.1683366733466934,0.012024048096192385,0.0013360053440213762,Peak,Thursday,March
2024-03-07 13:00:00,71,380,6,1,458,226,592,8,1,827,28.8,76,51,11.8,1285,False,13,297,972,14,2,2024-03-07,False,False,False,0.756420233463035,0.2311284046692607,0.010894941634241245,0.0015564202334630351,Peak,Thursday,March
2024-03-07 14:00:00,59,380,2,1,442,90,507,6,0,603,28.4,83,51,10.1,1045,False,14,149,887,8,1,2024-03-07,False,False,False,0.8488038277511962,0.14258373205741626,0.007655502392344498,0.0009569377990430622,Peak,Thursday,March
2024-03-07 15:00:00,36,380,4,1,421,90,254,4,0,348,29.3,81,51,8.3,769,False,15,126,634,8,1,2024-03-07,False,False,False,0.8244473342002601,0.16384915474642392,0.010403120936280884,0.0013003901170351106,Peak,Thursday,March
2024-03-07 16:00:00,71,190,2,1,264,113,423,4,0,540,29.1,82,51,7.6,804,False,16,184,613,6,1,2024-03-07,False,False,False,0.7624378109452736,0.22885572139303484,0.007462686567164179,0.0012437810945273632,Peak,Thursday,March
2024-03-07 17:00:00,95,443,6,1,545,135,676,10,0,821,28.7,84,51,7.6,1366,False,17,230,1119,16,1,2024-03-07,False,False,False,0.8191800878477306,0.1683748169838946,0.01171303074670571,0.0007320644216691069,Peak,Thursday,March
2024-03-07 18:00:00,71,380,6,1,458,158,761,13,0,932,27.7,86,63,8.3,1390,False,18,229,1141,19,1,2024-03-07,False,False,True,0.820863309352518,0.1647482014388489,0.013669064748201438,0.0007194244604316547,Peak,Thursday,March
2024-03-07 19:00:00,119,633,5,1,758,203,676,11,1,891,26.5,91,61,11.6,1649,False,19,322,1309,16,2,2024-03-07,False,False,True,0.7938144329896907,0.1952698605215282,0.009702850212249849,0.001212856276531231,Peak,Thursday,March
2024-03-07 20:00:00,48,316,3,1,368,135,507,7,0,649,25.8,95,61,6.4,1017,False,20,183,823,10,1,2024-03-07,False,False,False,0.8092428711897739,0.17994100294985252,0.00983284169124877,0.0009832841691248771,Shoulder,Thursday,March
2024-03-07 21:00:00,36,253,3,0,292,68,507,5,0,580,25.6,94,63,12.3,872,False,21,104,760,8,0,2024-03-07,False,False,False,0.8715596330275229,0.11926605504587157,0.009174311926605505,0.0,Shoulder,Thursday,March
2024-03-07 22:00:00,59,190,2,0,251,113,254,6,0,373,26.0,91,3,8.6,624,False,22,172,444,8,0,2024-03-07,False,False,False,0.7115384615384616,0.27564102564102566,0.01282051282051282,0.0,Shoulder,Thursday,March
2024-03-07 23:00:00,48,380,2,0,430,90,423,5,0,518,26.1,93,51,13.2,948,False,23,138,803,7,0,2024-03-07,False,False,False,0.8470464135021097,0.14556962025316456,0.007383966244725738,0.0,Shoulder,Thursday,March
2024-03-08 00:00:00,26,112,1,0,139,21,147,3,0,171,25.8,95,3,8.8,310,False,0,47,259,4,0,2024-03-08,False,False,False,0.8354838709677419,0.15161290322580645,0.012903225806451613,0.0,Off-Peak,Friday,March
2024-03-08 01:00:00,26,112,0,0,138,64,147,3,0,214,25.8,94,53,8.6,352,False,1,90,259,3,0,2024-03-08,False,False,False,0.7357954545454546,0.2556818181818182,0.008522727272727272,0.0,Off-Peak,Friday,March
2024-03-08 02:00:00,26,56,2,0,84,42,221,1,0,264,25.4,96,53,8.7,348,False,2,68,277,3,0,2024-03-08,False,False,False,0.7959770114942529,0.19540229885057472,0.008620689655172414,0.0,Off-Peak,Friday,March
2024-03-08 03:00:00,39,112,1,0,152,21,221,3,0,245,25.2,97,51,5.9,397,False,3,60,333,4,0,2024-03-08,False,False,False,0.8387909319899244,0.15113350125944586,0.010075566750629723,0.0,Off-Peak,Friday,March
2024-03-08 04:00:00,13,56,1,0,70,21,147,2,0,170,25.0,98,51,5.2,240,False,4,34,203,3,0,2024-03-08,False,False,False,0.8458333333333333,0.14166666666666666,0.0125,0.0,Off-Peak,Friday,March
2024-03-08 05:00:00,64,279,3,0,346,127,221,5,1,354,25.1,97,3,4.8,700,False,5,191,500,8,1,2024-03-08,False,False,False,0.7142857142857143,0.27285714285714285,0.011428571428571429,0.0014285714285714286,Shoulder,Friday,March
2024-03-08 06:00:00,51,335,3,0,389,106,294,5,1,406,24.9,97,53,7.1,795,False,6,157,629,8,1,2024-03-08,False,False,False,0.7911949685534592,0.19748427672955976,0.010062893081761006,0.0012578616352201257,Shoulder,Friday,March
2024-03-08 07:00:00,128,335,5,1,469,127,735,8,1,871,23.7,99,63,12.3,1340,False,7,255,1070,13,2,2024-03-08,False,False,False,0.7985074626865671,0.19029850746268656,0.009701492537313432,0.0014925373134328358,Peak,Friday,March
2024-03-08 08:00:00,115,391,4,1,511,170,662,8,1,841,23.8,96,51,6.5,1352,False,8,285,1053,12,2,2024-03-08,False,False,False,0.7788461538461539,0.21079881656804733,0.008875739644970414,0.0014792899408284023,Peak,Friday,March
2024-03-08 09:00:00,64,223,2,1,290,85,221,4,1,311,25.7,93,51,6.1,601,False,9,149,444,6,2,2024-03-08,False,False,False,0.7387687188019967,0.24792013311148087,0.009983361064891847,0.0033277870216306157,Shoulder,Friday,March
2024-03-08 10:00:00,51,335,2,1,389,85,368,4,1,458,26.8,93,53,9.0,847,False,10,136,703,6,2,2024-03-08,False,False,False,0.8299881936245572,0.16056670602125148,0.0070838252656434475,0.0023612750885478157,Shoulder,Friday,March
2024-03-08 11:00:00,115,558,3,1,677,127,662,8,1,798,26.3,88,61,11.0,1475,False,11,242,1220,11,2,2024-03-08,False,False,True,0.8271186440677966,0.1640677966101695,0.007457627118644068,0.0013559322033898306,Peak,Friday,March
2024-03-08 12:00:00,115,447,4,1,567,191,441,11,1,644,26.5,88,51,11.8,1211,False,12,306,888,15,2,2024-03-08,False,False,False,0.7332782824112304,0.2526837324525186,0.012386457473162676,0.0016515276630883566,Peak,Friday,March
2024-03-08 13:00:00,115,558,5,1,679,212,662,11,1,886,27.1,85,51,11.3,1565,False,13,327,1220,16,2,2024-03-08,False,False,True,0.7795527156549521,0.20894568690095847,0.010223642172523962,0.0012779552715654952,Peak,Friday,March
2024-03-08 14:00:00,64,335,3,0,402,85,441,6,1,533,27.5,85,53,11.0,935,False,14,149,776,9,1,2024-03-08,False,False,False,0.8299465240641711,0.15935828877005348,0.009625668449197862,0.0010695187165775401,Peak,Friday,March
2024-03-08 15:00:00,38,279,3,1,321,85,368,5,0,458,27.4,86,53,10.6,779,False,15,123,647,8,1,2024-03-08,False,False,False,0.8305519897304237,0.15789473684210525,0.010269576379974325,0.0012836970474967907,Peak,Friday,March
2024-03-08 16:00:00,51,223,2,0,276,64,220,8,0,292,28.1,81,51,8.4,568,False,16,115,443,10,0,2024-03-08,False,False,False,0.7799295774647887,0.20246478873239437,0.017605633802816902,0.0,Peak,Friday,March
2024-03-08 17:00:00,90,391,6,1,488,212,662,11,1,886,28.2,81,3,8.9,1374,False,17,302,1053,17,2,2024-03-08,False,False,True,0.7663755458515283,0.2197962154294032,0.012372634643377001,0.001455604075691412,Peak,Friday,March
2024-03-08 18:00:00,128,391,5,1,525,212,441,9,1,663,28.5,79,3,5.4,1188,False,18,340,832,14,2,2024-03-08,False,False,False,0.7003367003367004,0.28619528619528617,0.011784511784511785,0.0016835016835016834,Peak,Friday,March
2024-03-08 19:00:00,115,447,4,1,567,191,588,8,1,788,28.1,82,3,5.1,1355,False,19,306,1035,12,2,2024-03-08,False,False,False,0.7638376383763837,0.22583025830258302,0.008856088560885609,0.0014760147601476014,Peak,Friday,March
2024-03-08 20:00:00,38,335,2,0,375,106,220,5,1,332,27.2,87,3,3.3,707,False,20,144,555,7,1,2024-03-08,False,False,False,0.785007072135785,0.2036775106082037,0.009900990099009901,0.0014144271570014145,Shoulder,Friday,March
2024-03-08 21:00:00,51,223,3,1,278,85,441,5,0,531,25.4,96,51,9.2,809,False,21,136,664,8,1,2024-03-08,False,False,False,0.8207663782447466,0.1681087762669963,0.009888751545117428,0.0012360939431396785,Shoulder,Friday,March
2024-03-08 22:00:00,64,168,3,0,235,63,294,5,0,362,25.0,95,51,7.8,597,False,22,127,462,8,0,2024-03-08,False,False,False,0.7738693467336684,0.21273031825795644,0.01340033500837521,0.0,Shoulder,Friday,March
2024-03-08 23:00:00,64,167,3,1,235,106,220,8,1,335,24.8,93,51,9.0,570,False,23,170,387,11,2,2024-03-08,False,False,False,0.6789473684210526,0.2982456140350877,0.01929824561403509,0.0035087719298245615,Shoulder,Friday,March
2024-03-09 00:00:00,27,107,1,0,135,22,134,1,0,157,24.8,94,3,8.5,292,True,0,49,241,2,0,2024-03-09,False,False,False,0.8253424657534246,0.1678082191780822,0.00684931506849315,0.0,Off-Peak,Saturday,March
2024-03-09 01:00:00,27,161,1,0,189,44,134,3,0,181,24.6,95,3,8.4,370,True,1,71,295,4,0,2024-03-09,False,False,False,0.7972972972972973,0.1918918918918919,0.010810810810810811,0.0,Off-Peak,Saturday,March
2024-03-09 02:00:00,27,107,1,0,135,22,201,3,0,226,24.5,95,3,8.7,361,True,2,49,308,4,0,2024-03-09,False,False,False,0.853185595567867,0.13573407202216067,0.0110803324099723,0.0,Off-Peak,Saturday,March
2024-03-09 03:00:00,27,161,1,0,189,67,67,2,0,136,24.6,94,3,10.5,325,True,3,94,228,3,0,2024-03-09,False,False,False,0.7015384615384616,0.28923076923076924,0.009230769230769232,0.0,Off-Peak,Saturday,March
2024-03-09 04:00:00,26,107,1,0,134,44,134,3,0,181,24.5,94,3,11.4,315,True,4,70,241,4,0,2024-03-09,False,False,False,0.765079365079365,0.2222222222222222,0.012698412698412698,0.0,Off-Peak,Saturday,March
2024-03-09 05:00:00,40,161,2,0,203,133,201,4,0,338,24.4,94,3,11.4,541,True,5,173,362,6,0,2024-03-09,False,False,False,0.6691312384473198,0.3197781885397412,0.011090573012939002,0.0,Shoulder,Saturday,March
2024-03-09 06:00:00,80,161,2,0,243,67,201,5,1,274,24.4,94,3,10.7,517,True,6,147,362,7,1,2024-03-09,False,False,False,0.7001934235976789,0.28433268858800775,0.013539651837524178,0.0019342359767891683,Shoulder,Saturday,March
2024-03-09 07:00:00,93,482,2,1,578,155,669,6,1,831,24.4,94,3,9.2,1409,True,7,248,1151,8,2,2024-03-09,False,False,True,0.8168914123491838,0.1760113555713272,0.0056777856635912,0.0014194464158978,Peak,Saturday,March
2024-03-09 08:00:00,133,535,2,1,671,111,669,8,1,789,24.7,93,3,10.5,1460,True,8,244,1204,10,2,2024-03-09,False,False,True,0.8246575342465754,0.16712328767123288,0.00684931506849315,0.0013698630136986301,Peak,Saturday,March
2024-03-09 09:00:00,80,321,2,0,403,111,335,5,1,452,26.8,89,3,12.5,855,True,9,191,656,7,1,2024-03-09,False,False,False,0.7672514619883041,0.22339181286549709,0.008187134502923977,0.0011695906432748538,Shoulder,Saturday,March
2024-03-09 10:00:00,53,161,2,0,216,133,402,5,0,540,28.0,84,3,10.7,756,True,10,186,563,7,0,2024-03-09,False,False,False,0.7447089947089947,0.24603174603174602,0.009259259259259259,0.0,Shoulder,Saturday,March
2024-03-09 11:00:00,66,482,4,1,553,200,335,11,1,547,29.5,74,51,9.7,1100,True,11,266,817,15,2,2024-03-09,False,False,False,0.7427272727272727,0.24181818181818182,0.013636363636363636,0.0018181818181818182,Peak,Saturday,March
2024-03-09 12:00:00,133,482,3,1,619,222,602,6,1,831,30.0,70,51,7.8,1450,True,12,355,1084,9,2,2024-03-09,False,False,True,0.7475862068965518,0.24482758620689654,0.006206896551724138,0.001379310344827586,Peak,Saturday,March
2024-03-09 13:00:00,133,428,3,1,565,177,402,8,1,588,30.6,67,51,5.4,1153,True,13,310,830,11,2,2024-03-09,False,False,False,0.7198612315698178,0.2688638334778838,0.009540329575021683,0.0017346053772766695,Peak,Saturday,March
2024-03-09 14:00:00,80,321,2,0,403,67,402,6,0,475,31.4,65,3,2.9,878,True,14,147,723,8,0,2024-03-09,False,False,False,0.8234624145785877,0.1674259681093394,0.009111617312072893,0.0,Peak,Saturday,March
2024-03-09 15:00:00,66,214,2,0,282,133,268,3,0,404,31.4,65,3,3.0,686,True,15,199,482,5,0,2024-03-09,False,False,False,0.7026239067055393,0.29008746355685133,0.007288629737609329,0.0,Peak,Saturday,March
2024-03-09 16:00:00,53,160,2,0,215,89,201,4,0,294,30.7,68,3,4.6,509,True,16,142,361,6,0,2024-03-09,False,False,False,0.7092337917485265,0.27897838899803534,0.011787819253438114,0.0,Peak,Saturday,March
2024-03-09 17:00:00,106,482,2,0,590,133,669,5,1,808,29.7,71,51,7.7,1398,True,17,239,1151,7,1,2024-03-09,False,False,True,0.8233190271816881,0.1709585121602289,0.005007153075822604,0.000715307582260372,Peak,Saturday,March
2024-03-09 18:00:00,133,535,4,0,672,177,602,7,1,787,28.7,79,51,9.4,1459,True,18,310,1137,11,1,2024-03-09,False,False,True,0.7793008910212474,0.21247429746401644,0.0075394105551747775,0.0006854009595613434,Peak,Saturday,March
2024-03-09 19:00:00,106,375,4,1,486,155,401,10,1,567,28.3,81,3,5.3,1053,True,19,261,776,14,2,2024-03-09,False,False,False,0.7369420702754036,0.24786324786324787,0.013295346628679962,0.001899335232668566,Peak,Saturday,March
2024-03-09 20:00:00,53,321,1,0,375,133,401,6,0,540,28.1,82,3,2.3,915,True,20,186,722,7,0,2024-03-09,False,False,False,0.7890710382513662,0.20327868852459016,0.007650273224043716,0.0,Shoulder,Saturday,March
2024-03-09 21:00:00,40,321,1,0,362,89,268,5,0,362,26.7,92,51,5.2,724,True,21,129,589,6,0,2024-03-09,False,False,False,0.81353591160221,0.1781767955801105,0.008287292817679558,0.0,Shoulder,Saturday,March
2024-03-09 22:00:00,66,321,2,0,389,133,268,5,1,407,26.9,92,51,9.4,796,True,22,199,589,7,1,2024-03-09,False,False,False,0.7399497487437185,0.25,0.008793969849246231,0.001256281407035176,Shoulder,Saturday,March
2024-03-09 23:00:00,40,214,2,0,256,111,268,3,0,382,26.3,91,3,4.3,638,True,23,151,482,5,0,2024-03-09,False,False,False,0.7554858934169278,0.23667711598746083,0.007836990595611285,0.0,Shoulder,Saturday,March
2024-03-10 00:00:00,13,176,1,0,190,23,63,3,0,89,25.5,93,51,10.4,279,True,0,36,239,4,0,2024-03-10,False,False,False,0.8566308243727598,0.12903225806451613,0.014336917562724014,0.0,Off-Peak,Sunday,March
2024-03-10 01:00:00,13,176,1,0,190,46,189,2,0,237,25.4,91,3,13.4,427,True,1,59,365,3,0,2024-03-10,False,False,False,0.8548009367681498,0.13817330210772832,0.00702576112412178,0.0,Off-Peak,Sunday,March
2024-03-10 02:00:00,27,176,0,0,203,46,63,2,0,111,24.9,93,3,12.9,314,True,2,73,239,2,0,2024-03-10,False,False,False,0.7611464968152867,0.23248407643312102,0.006369426751592357,0.0,Off-Peak,Sunday,March
2024-03-10 03:00:00,13,175,1,0,189,23,126,3,0,152,24.8,93,3,13.1,341,True,3,36,301,4,0,2024-03-10,False,False,False,0.8826979472140762,0.10557184750733138,0.011730205278592375,0.0,Off-Peak,Sunday,March
2024-03-10 04:00:00,40,175,1,0,216,23,63,3,0,89,24.4,93,3,13.8,305,True,4,63,238,4,0,2024-03-10,False,False,False,0.780327868852459,0.20655737704918034,0.013114754098360656,0.0,Off-Peak,Sunday,March
2024-03-10 05:00:00,66,234,2,0,302,115,189,3,0,307,24.6,91,3,13.7,609,True,5,181,423,5,0,2024-03-10,False,False,False,0.6945812807881774,0.29720853858784896,0.008210180623973728,0.0,Shoulder,Sunday,March
2024-03-10 06:00:00,80,175,2,0,257,138,377,4,1,520,24.5,91,3,10.9,777,True,6,218,552,6,1,2024-03-10,False,False,False,0.7104247104247104,0.2805662805662806,0.007722007722007722,0.001287001287001287,Shoulder,Sunday,March
2024-03-10 07:00:00,80,292,2,1,375,206,440,5,1,652,24.3,91,3,10.2,1027,True,7,286,732,7,2,2024-03-10,False,False,False,0.7127555988315482,0.27848101265822783,0.006815968841285297,0.0019474196689386564,Peak,Sunday,March
2024-03-10 08:00:00,80,351,2,1,434,160,377,10,1,548,24.4,91,3,11.5,982,True,8,240,728,12,2,2024-03-10,False,False,False,0.7413441955193483,0.24439918533604887,0.012219959266802444,0.002036659877800407,Peak,Sunday,March
2024-03-10 09:00:00,66,292,2,0,360,69,315,4,1,389,27.2,87,3,12.5,749,True,9,135,607,6,1,2024-03-10,False,False,False,0.8104138851802403,0.1802403204272363,0.00801068090787717,0.0013351134846461949,Shoulder,Sunday,March
2024-03-10 10:00:00,80,175,2,0,257,138,189,5,1,333,28.3,82,3,11.7,590,True,10,218,364,7,1,2024-03-10,False,False,False,0.6169491525423729,0.3694915254237288,0.011864406779661017,0.001694915254237288,Shoulder,Sunday,March
2024-03-10 11:00:00,133,468,3,1,605,160,503,7,1,671,30.0,74,3,11.8,1276,True,11,293,971,10,2,2024-03-10,False,False,False,0.7609717868338558,0.22962382445141066,0.007836990595611285,0.001567398119122257,Peak,Sunday,March
2024-03-10 12:00:00,119,292,2,1,414,206,629,5,1,841,30.8,70,3,10.9,1255,True,12,325,921,7,2,2024-03-10,False,False,False,0.7338645418326694,0.2589641434262948,0.005577689243027889,0.0015936254980079682,Peak,Sunday,March
2024-03-10 13:00:00,106,351,2,1,460,160,566,9,1,736,29.8,67,53,16.8,1196,True,13,266,917,11,2,2024-03-10,False,False,False,0.7667224080267558,0.22240802675585283,0.00919732441471572,0.0016722408026755853,Peak,Sunday,March
2024-03-10 14:00:00,66,234,2,0,302,69,189,4,1,263,29.7,75,51,6.0,565,True,14,135,423,6,1,2024-03-10,False,False,False,0.7486725663716814,0.23893805309734514,0.010619469026548672,0.0017699115044247787,Peak,Sunday,March
2024-03-10 15:00:00,66,292,2,0,360,115,377,4,0,496,28.3,79,53,5.0,856,True,15,181,669,6,0,2024-03-10,False,False,False,0.7815420560747663,0.21144859813084113,0.007009345794392523,0.0,Peak,Sunday,March
2024-03-10 16:00:00,80,351,2,0,433,138,189,4,0,331,27.1,85,63,5.3,764,True,16,218,540,6,0,2024-03-10,False,False,False,0.7068062827225131,0.28534031413612565,0.007853403141361256,0.0,Peak,Sunday,March
2024-03-10 17:00:00,80,292,2,1,375,115,566,9,1,691,26.3,87,63,0.4,1066,True,17,195,858,11,2,2024-03-10,False,False,False,0.8048780487804879,0.18292682926829268,0.010318949343339587,0.001876172607879925,Peak,Sunday,March
2024-03-10 18:00:00,93,409,1,1,504,229,377,6,1,613,26.9,87,51,0.4,1117,True,18,322,786,7,2,2024-03-10,False,False,False,0.7036705461056401,0.288272157564906,0.006266786034019696,0.0017905102954341987,Peak,Sunday,March
2024-03-10 19:00:00,106,526,3,1,636,229,503,7,1,740,26.9,88,2,3.0,1376,True,19,335,1029,10,2,2024-03-10,False,False,True,0.7478197674418605,0.24345930232558138,0.007267441860465116,0.0014534883720930232,Peak,Sunday,March
2024-03-10 20:00:00,40,351,1,0,392,138,252,5,0,395,26.3,92,3,4.1,787,True,20,178,603,6,0,2024-03-10,False,False,False,0.7662007623888183,0.22617534942820838,0.007623888182973317,0.0,Shoulder,Sunday,March
2024-03-10 21:00:00,40,292,1,0,333,115,252,5,1,373,26.5,90,3,7.6,706,True,21,155,544,6,1,2024-03-10,False,False,False,0.7705382436260623,0.21954674220963172,0.0084985835694051,0.00141643059490085,Shoulder,Sunday,March
2024-03-10 22:00:00,66,234,1,0,301,137,314,5,1,457,26.3,93,3,4.7,758,True,22,203,548,6,1,2024-03-10,False,False,False,0.7229551451187335,0.2678100263852243,0.0079155672823219,0.0013192612137203166,Shoulder,Sunday,March
2024-03-10 23:00:00,40,234,1,0,275,69,189,4,1,263,26.0,93,3,6.8,538,True,23,109,423,5,1,2024-03-10,False,False,False,0.7862453531598513,0.20260223048327136,0.00929368029739777,0.0018587360594795538,Shoulder,Sunday,March
2024-03-11 00:00:00,45,68,1,0,114,72,202,2,0,276,26.0,82,3,11.0,390,False,0,117,270,3,0,2024-03-11,False,False,False,0.6923076923076923,0.3,0.007692307692307693,0.0,Off-Peak,Monday,March
2024-03-11 01:00:00,30,68,1,0,99,24,202,3,0,229,25.5,82,3,14.7,328,False,1,54,270,4,0,2024-03-11,False,False,False,0.823170731707317,0.16463414634146342,0.012195121951219513,0.0,Off-Peak,Monday,March
2024-03-11 02:00:00,15,136,2,0,153,72,101,2,0,175,25.1,85,3,12.2,328,False,2,87,237,4,0,2024-03-11,False,False,False,0.7225609756097561,0.2652439024390244,0.012195121951219513,0.0,Off-Peak,Monday,March
2024-03-11 03:00:00,30,204,2,0,236,72,101,2,0,175,25.0,86,3,12.1,411,False,3,102,305,4,0,2024-03-11,False,False,False,0.7420924574209246,0.24817518248175183,0.009732360097323601,0.0,Off-Peak,Monday,March
2024-03-11 04:00:00,45,136,2,0,183,72,202,2,0,276,24.5,88,3,11.8,459,False,4,117,338,4,0,2024-03-11,False,False,False,0.7363834422657952,0.2549019607843137,0.008714596949891068,0.0,Off-Peak,Monday,March
2024-03-11 05:00:00,59,272,2,0,333,144,506,7,1,658,24.5,87,3,12.9,991,False,5,203,778,9,1,2024-03-11,False,False,False,0.7850655903128153,0.20484359233097882,0.009081735620585268,0.0010090817356205853,Shoulder,Monday,March
2024-03-11 06:00:00,44,272,2,0,318,144,404,7,1,556,24.3,87,3,13.0,874,False,6,188,676,9,1,2024-03-11,False,False,False,0.7734553775743707,0.2151029748283753,0.010297482837528604,0.0011441647597254005,Shoulder,Monday,March
2024-03-11 07:00:00,119,339,5,1,464,215,708,9,1,933,23.9,88,3,11.8,1397,False,7,334,1047,14,2,2024-03-11,False,False,True,0.7494631352899069,0.23908375089477452,0.010021474588403722,0.0014316392269148174,Peak,Monday,March
2024-03-11 08:00:00,119,407,3,0,529,167,607,11,1,786,24.2,86,3,11.9,1315,False,8,286,1014,14,1,2024-03-11,False,False,False,0.7711026615969582,0.21749049429657794,0.01064638783269962,0.0007604562737642585,Peak,Monday,March
2024-03-11 09:00:00,44,272,4,0,320,144,607,6,1,758,26.7,75,2,10.5,1078,False,9,188,879,10,1,2024-03-11,False,False,False,0.8153988868274582,0.17439703153988867,0.00927643784786642,0.0009276437847866419,Shoulder,Monday,March
2024-03-11 10:00:00,74,204,4,0,282,120,404,3,1,528,28.3,70,3,11.9,810,False,10,194,608,7,1,2024-03-11,False,False,False,0.7506172839506173,0.23950617283950618,0.008641975308641974,0.0012345679012345679,Shoulder,Monday,March
2024-03-11 11:00:00,133,543,3,1,680,239,809,11,2,1061,30.2,63,3,14.2,1741,False,11,372,1352,14,3,2024-03-11,False,False,True,0.7765651924181505,0.21367030442274554,0.0080413555427915,0.0017231476163124641,Peak,Monday,March
2024-03-11 12:00:00,133,679,3,0,815,167,910,5,1,1083,31.9,56,3,12.6,1898,False,12,300,1589,8,1,2024-03-11,False,False,True,0.8371970495258166,0.15806111696522657,0.004214963119072708,0.0005268703898840885,Peak,Monday,March
2024-03-11 13:00:00,104,475,3,1,583,215,506,9,1,731,32.7,51,3,9.7,1314,False,13,319,981,12,2,2024-03-11,False,False,False,0.7465753424657534,0.24277016742770166,0.0091324200913242,0.0015220700152207,Peak,Monday,March
2024-03-11 14:00:00,89,339,2,0,430,72,404,6,0,482,33.1,46,3,6.9,912,False,14,161,743,8,0,2024-03-11,False,False,False,0.8146929824561403,0.17653508771929824,0.008771929824561403,0.0,Peak,Monday,March
2024-03-11 15:00:00,74,339,3,0,416,144,303,3,1,451,33.4,44,3,6.1,867,False,15,218,642,6,1,2024-03-11,False,False,False,0.740484429065744,0.25144175317185696,0.006920415224913495,0.0011534025374855825,Peak,Monday,March
2024-03-11 16:00:00,44,204,3,0,251,96,505,4,1,606,31.9,58,3,11.2,857,False,16,140,709,7,1,2024-03-11,False,False,False,0.8273045507584598,0.1633605600933489,0.008168028004667444,0.0011668611435239206,Peak,Monday,March
2024-03-11 17:00:00,89,543,5,1,638,120,708,6,1,835,31.2,63,3,9.3,1473,False,17,209,1251,11,2,2024-03-11,False,False,True,0.8492871690427699,0.14188730482009504,0.00746775288526816,0.0013577732518669382,Peak,Monday,March
2024-03-11 18:00:00,74,407,3,1,485,167,910,5,2,1084,30.0,70,51,3.2,1569,False,18,241,1317,8,3,2024-03-11,False,False,True,0.8393881453154876,0.15360101975780752,0.005098789037603569,0.0019120458891013384,Peak,Monday,March
2024-03-11 19:00:00,89,475,3,1,568,167,505,5,1,678,29.0,74,51,7.4,1246,False,19,256,980,8,2,2024-03-11,False,False,False,0.7865168539325843,0.20545746388443017,0.006420545746388443,0.0016051364365971107,Peak,Monday,March
2024-03-11 20:00:00,59,271,2,0,332,144,404,4,1,553,28.0,78,3,4.0,885,False,20,203,675,6,1,2024-03-11,False,False,False,0.7627118644067796,0.22937853107344633,0.006779661016949152,0.0011299435028248588,Shoulder,Monday,March
2024-03-11 21:00:00,59,407,3,0,469,96,303,6,1,406,27.1,84,3,5.6,875,False,21,155,710,9,1,2024-03-11,False,False,False,0.8114285714285714,0.17714285714285713,0.010285714285714285,0.001142857142857143,Shoulder,Monday,March
2024-03-11 22:00:00,59,339,2,0,400,120,303,5,1,429,26.9,80,3,4.0,829,False,22,179,642,7,1,2024-03-11,False,False,False,0.7744270205066345,0.21592279855247287,0.008443908323281062,0.0012062726176115801,Shoulder,Monday,March
2024-03-11 23:00:00,59,407,2,0,468,72,303,6,0,381,26.5,79,3,5.4,849,False,23,131,710,8,0,2024-03-11,False,False,False,0.8362779740871613,0.15429917550058891,0.009422850412249705,0.0,Shoulder,Monday,March
2024-03-12 00:00:00,53,68,2,0,123,31,165,3,1,200,26.4,77,3,9.1,323,False,0,84,233,5,1,2024-03-12,True,True,False,0.7213622291021672,0.26006191950464397,0.015479876160990712,0.0030959752321981426,Off-Peak,Tuesday,March
2024-03-12 01:00:00,53,136,2,0,191,63,248,3,0,314,26.4,77,3,13.6,505,False,1,116,384,5,0,2024-03-12,True,True,False,0.7603960396039604,0.2297029702970297,0.009900990099009901,0.0,Off-Peak,Tuesday,March
2024-03-12 02:00:00,35,204,1,0,240,94,83,1,0,178,26.1,81,3,12.9,418,False,2,129,287,2,0,2024-03-12,True,True,False,0.6866028708133971,0.30861244019138756,0.004784688995215311,0.0,Off-Peak,Tuesday,March
2024-03-12 03:00:00,18,136,1,0,155,94,165,2,1,262,25.7,85,3,10.9,417,False,3,112,301,3,1,2024-03-12,True,True,False,0.7218225419664268,0.2685851318944844,0.007194244604316547,0.002398081534772182,Off-Peak,Tuesday,March
2024-03-12 04:00:00,18,204,2,0,224,94,248,3,1,346,25.6,86,3,7.6,570,False,4,112,452,5,1,2024-03-12,True,True,False,0.7929824561403509,0.19649122807017544,0.008771929824561403,0.0017543859649122807,Off-Peak,Tuesday,March
2024-03-12 05:00:00,35,339,1,0,375,63,331,2,1,397,25.1,89,3,6.8,772,False,5,98,670,3,1,2024-03-12,True,True,False,0.8678756476683938,0.12694300518134716,0.0038860103626943004,0.0012953367875647669,Shoulder,Tuesday,March
2024-03-12 06:00:00,71,339,1,0,411,63,331,6,1,401,25.2,88,3,9.9,812,False,6,134,670,7,1,2024-03-12,True,True,False,0.8251231527093597,0.16502463054187191,0.008620689655172414,0.0012315270935960591,Shoulder,Tuesday,March
2024-03-12 07:00:00,106,475,3,1,585,250,331,6,2,589,25.1,88,3,11.8,1174,False,7,356,806,9,3,2024-03-12,True,True,False,0.686541737649063,0.303236797274276,0.007666098807495741,0.002555366269165247,Peak,Tuesday,March
2024-03-12 08:00:00,106,475,4,1,586,250,413,4,1,668,25.6,86,3,12.2,1254,False,8,356,888,8,2,2024-03-12,True,True,False,0.7081339712918661,0.2838915470494418,0.006379585326953748,0.001594896331738437,Peak,Tuesday,March
2024-03-12 09:00:00,71,204,3,0,278,94,248,3,1,346,27.4,83,3,10.2,624,False,9,165,452,6,1,2024-03-12,True,True,False,0.7243589743589743,0.2644230769230769,0.009615384615384616,0.0016025641025641025,Shoulder,Tuesday,March
2024-03-12 10:00:00,71,339,2,0,412,94,331,2,1,428,28.8,76,3,10.2,840,False,10,165,670,4,1,2024-03-12,True,True,False,0.7976190476190477,0.19642857142857142,0.004761904761904762,0.0011904761904761906,Shoulder,Tuesday,March
2024-03-12 11:00:00,71,407,6,0,484,219,331,9,2,561,30.3,69,3,10.1,1045,False,11,290,738,15,2,2024-03-12,True,True,False,0.7062200956937799,0.27751196172248804,0.014354066985645933,0.0019138755980861245,Peak,Tuesday,March
2024-03-12 12:00:00,124,407,6,1,538,125,662,7,1,795,31.5,62,3,10.5,1333,False,12,249,1069,13,2,2024-03-12,True,True,False,0.8019504876219055,0.1867966991747937,0.009752438109527382,0.0015003750937734434,Peak,Tuesday,March
2024-03-12 13:00:00,106,271,4,1,382,156,413,7,1,577,32.3,59,51,11.1,959,False,13,262,684,11,2,2024-03-12,True,True,False,0.7132429614181439,0.2732012513034411,0.011470281543274244,0.0020855057351407717,Peak,Tuesday,March
2024-03-12 14:00:00,53,339,1,0,393,63,413,2,1,479,32.1,58,3,13.1,872,False,14,116,752,3,1,2024-03-12,True,True,False,0.8623853211009175,0.13302752293577982,0.0034403669724770644,0.0011467889908256881,Peak,Tuesday,March
2024-03-12 15:00:00,71,204,4,0,279,94,248,4,0,346,32.0,60,3,13.6,625,False,15,165,452,8,0,2024-03-12,True,True,False,0.7232,0.264,0.0128,0.0,Peak,Tuesday,March
2024-03-12 16:00:00,53,136,1,0,190,63,413,6,1,483,31.3,64,3,14.0,673,False,16,116,549,7,1,2024-03-12,True,True,False,0.8157503714710252,0.1723625557206538,0.010401188707280832,0.0014858841010401188,Peak,Tuesday,March
2024-03-12 17:00:00,142,407,5,1,555,219,662,9,1,891,30.4,67,3,17.6,1446,False,17,361,1069,14,2,2024-03-12,True,True,True,0.7392807745504841,0.24965421853388658,0.009681881051175657,0.0013831258644536654,Peak,Tuesday,March
2024-03-12 18:00:00,124,407,5,1,537,156,413,8,2,579,29.8,69,3,15.0,1116,False,18,280,820,13,3,2024-03-12,True,True,False,0.7347670250896058,0.25089605734767023,0.011648745519713262,0.002688172043010753,Peak,Tuesday,March
2024-03-12 19:00:00,142,339,3,1,485,188,579,6,1,774,29.4,72,3,11.6,1259,False,19,330,918,9,2,2024-03-12,True,True,False,0.7291501191421763,0.2621127879269261,0.007148530579825258,0.0015885623510722795,Peak,Tuesday,March
2024-03-12 20:00:00,88,204,1,0,293,125,331,3,1,460,28.0,84,3,6.3,753,False,20,213,535,4,1,2024-03-12,True,True,False,0.7104913678618858,0.28286852589641437,0.005312084993359893,0.0013280212483399733,Shoulder,Tuesday,March
2024-03-12 21:00:00,71,204,4,0,279,94,165,6,1,266,27.6,84,3,3.3,545,False,21,165,369,10,1,2024-03-12,True,True,False,0.6770642201834862,0.30275229357798167,0.01834862385321101,0.001834862385321101,Shoulder,Tuesday,March
2024-03-12 22:00:00,53,203,3,0,259,63,331,2,0,396,26.7,85,3,5.9,655,False,22,116,534,5,0,2024-03-12,True,True,False,0.815267175572519,0.17709923664122137,0.007633587786259542,0.0,Shoulder,Tuesday,March
2024-03-12 23:00:00,53,203,3,0,259,94,165,4,0,263,25.9,90,2,3.6,522,False,23,147,368,7,0,2024-03-12,True,True,False,0.7049808429118773,0.28160919540229884,0.013409961685823755,0.0,Shoulder,Tuesday,March
2024-03-13 00:00:00,22,78,2,0,102,31,201,3,1,236,25.2,91,1,3.4,338,False,0,53,279,5,1,2024-03-13,False,False,False,0.8254437869822485,0.15680473372781065,0.014792899408284023,0.0029585798816568047,Off-Peak,Wednesday,March
2024-03-13 01:00:00,67,233,3,0,303,91,100,1,0,192,25.0,91,3,5.4,495,False,1,158,333,4,0,2024-03-13,False,False,False,0.6727272727272727,0.3191919191919192,0.00808080808080808,0.0,Off-Peak,Wednesday,March
2024-03-13 02:00:00,22,233,2,0,257,61,301,1,1,364,25.6,83,3,10.5,621,False,2,83,534,3,1,2024-03-13,False,False,False,0.8599033816425121,0.13365539452495975,0.004830917874396135,0.001610305958132045,Off-Peak,Wednesday,March
2024-03-13 03:00:00,22,77,1,0,100,30,200,4,1,235,25.6,82,0,9.0,335,False,3,52,277,5,1,2024-03-13,False,False,False,0.826865671641791,0.15522388059701492,0.014925373134328358,0.0029850746268656717,Off-Peak,Wednesday,March
2024-03-13 04:00:00,22,155,1,0,178,91,200,2,0,293,25.2,84,0,12.5,471,False,4,113,355,3,0,2024-03-13,False,False,False,0.7537154989384289,0.23991507430997877,0.006369426751592357,0.0,Off-Peak,Wednesday,March
2024-03-13 05:00:00,67,310,3,1,381,122,401,5,1,529,25.0,84,0,14.9,910,False,5,189,711,8,2,2024-03-13,False,False,False,0.7813186813186813,0.2076923076923077,0.008791208791208791,0.002197802197802198,Shoulder,Wednesday,March
2024-03-13 06:00:00,45,388,4,0,437,152,200,6,1,359,24.7,85,0,14.8,796,False,6,197,588,10,1,2024-03-13,False,False,False,0.7386934673366834,0.24748743718592964,0.01256281407035176,0.001256281407035176,Shoulder,Wednesday,March
2024-03-13 07:00:00,89,621,4,0,714,152,501,10,1,664,24.4,86,0,14.0,1378,False,7,241,1122,14,1,2024-03-13,False,False,True,0.8142235123367199,0.1748911465892598,0.010159651669085631,0.000725689404934688,Peak,Wednesday,March
2024-03-13 08:00:00,156,465,7,1,629,183,601,10,1,795,24.7,85,0,14.5,1424,False,8,339,1066,17,2,2024-03-13,False,False,True,0.7485955056179775,0.238061797752809,0.011938202247191011,0.0014044943820224719,Peak,Wednesday,March
2024-03-13 09:00:00,67,388,3,1,459,152,200,2,0,354,26.9,80,0,10.5,813,False,9,219,588,5,1,2024-03-13,False,False,False,0.7232472324723247,0.2693726937269373,0.006150061500615006,0.0012300123001230013,Shoulder,Wednesday,March
2024-03-13 10:00:00,112,155,3,1,271,61,401,5,0,467,29.3,70,0,10.9,738,False,10,173,556,8,1,2024-03-13,False,False,False,0.7533875338753387,0.23441734417344173,0.01084010840108401,0.0013550135501355014,Shoulder,Wednesday,March
2024-03-13 11:00:00,156,543,7,1,707,152,601,10,1,764,31.2,59,0,10.9,1471,False,11,308,1144,17,2,2024-03-13,False,False,True,0.7777022433718559,0.20938137321549966,0.011556764106050306,0.0013596193065941536,Peak,Wednesday,March
2024-03-13 12:00:00,111,543,4,1,659,152,401,7,1,561,32.3,54,51,7.6,1220,False,12,263,944,11,2,2024-03-13,False,False,False,0.7737704918032787,0.2155737704918033,0.009016393442622951,0.001639344262295082,Peak,Wednesday,March
2024-03-13 13:00:00,89,388,7,1,485,213,802,9,2,1026,32.5,53,51,8.5,1511,False,13,302,1190,16,3,2024-03-13,False,False,True,0.7875579086697552,0.199867637326274,0.010589013898080741,0.001985440105890139,Peak,Wednesday,March
2024-03-13 14:00:00,67,233,4,0,304,152,301,2,1,456,33.0,51,51,8.5,760,False,14,219,534,6,1,2024-03-13,False,False,False,0.7026315789473684,0.2881578947368421,0.007894736842105263,0.0013157894736842105,Peak,Wednesday,March
2024-03-13 15:00:00,89,388,4,0,481,122,501,2,1,626,33.2,52,51,8.6,1107,False,15,211,889,6,1,2024-03-13,False,False,False,0.8030713640469738,0.19060523938572718,0.005420054200542005,0.0009033423667570009,Peak,Wednesday,March
2024-03-13 16:00:00,111,233,3,0,347,91,501,2,1,595,33.2,53,1,8.6,942,False,16,202,734,5,1,2024-03-13,False,False,False,0.7791932059447984,0.21443736730360935,0.005307855626326964,0.0010615711252653928,Peak,Wednesday,March
2024-03-13 17:00:00,111,621,6,1,739,152,401,9,1,563,31.7,64,53,11.4,1302,False,17,263,1022,15,2,2024-03-13,False,False,False,0.7849462365591398,0.2019969278033794,0.01152073732718894,0.0015360983102918587,Peak,Wednesday,March
2024-03-13 18:00:00,134,310,4,1,449,152,702,6,1,861,30.1,70,1,10.8,1310,False,18,286,1012,10,2,2024-03-13,False,False,False,0.7725190839694657,0.2183206106870229,0.007633587786259542,0.0015267175572519084,Peak,Wednesday,March
2024-03-13 19:00:00,178,388,4,1,571,244,501,5,2,752,29.4,73,0,7.7,1323,False,19,422,889,9,3,2024-03-13,False,False,False,0.671957671957672,0.31897203325774753,0.006802721088435374,0.0022675736961451248,Peak,Wednesday,March
2024-03-13 20:00:00,67,388,4,1,460,61,301,4,1,367,28.3,78,0,4.9,827,False,20,128,689,8,2,2024-03-13,False,False,False,0.8331318016928658,0.154776299879081,0.009673518742442563,0.0024183796856106408,Shoulder,Wednesday,March
2024-03-13 21:00:00,45,388,4,1,438,61,501,4,1,567,27.8,77,0,5.9,1005,False,21,106,889,8,2,2024-03-13,False,False,False,0.8845771144278607,0.1054726368159204,0.007960199004975124,0.001990049751243781,Shoulder,Wednesday,March
2024-03-13 22:00:00,111,233,3,1,348,122,200,5,1,328,27.5,77,2,8.1,676,False,22,233,433,8,2,2024-03-13,False,False,False,0.6405325443786982,0.34467455621301774,0.011834319526627219,0.0029585798816568047,Shoulder,Wednesday,March
2024-03-13 23:00:00,67,233,2,0,302,122,401,2,1,526,27.3,68,1,10.6,828,False,23,189,634,4,1,2024-03-13,False,False,False,0.7657004830917874,0.22826086956521738,0.004830917874396135,0.0012077294685990338,Shoulder,Wednesday,March
2024-03-14 00:00:00,18,180,1,0,199,31,197,1,1,230,26.6,70,0,9.2,429,False,0,49,377,2,1,2024-03-14,False,False,False,0.8787878787878788,0.11421911421911422,0.004662004662004662,0.002331002331002331,Off-Peak,Thursday,March
2024-03-14 01:00:00,18,180,3,0,201,61,98,1,1,161,25.9,73,1,12.1,362,False,1,79,278,4,1,2024-03-14,False,False,False,0.7679558011049724,0.21823204419889503,0.011049723756906077,0.0027624309392265192,Off-Peak,Thursday,March
2024-03-14 02:00:00,36,90,2,1,129,31,196,2,0,229,25.4,80,1,13.2,358,False,2,67,286,4,1,2024-03-14,False,False,False,0.7988826815642458,0.1871508379888268,0.0111731843575419,0.002793296089385475,Off-Peak,Thursday,March
2024-03-14 03:00:00,53,180,2,0,235,30,295,1,0,326,25.1,85,3,14.0,561,False,3,83,475,3,0,2024-03-14,False,False,False,0.8467023172905526,0.14795008912655971,0.0053475935828877,0.0,Off-Peak,Thursday,March
2024-03-14 04:00:00,36,90,2,0,128,30,98,2,0,130,24.8,88,3,15.7,258,False,4,66,188,4,0,2024-03-14,False,False,False,0.7286821705426356,0.2558139534883721,0.015503875968992248,0.0,Off-Peak,Thursday,March
2024-03-14 05:00:00,53,180,2,1,236,91,196,5,1,293,24.6,90,3,16.1,529,False,5,144,376,7,2,2024-03-14,False,False,False,0.7107750472589792,0.2722117202268431,0.013232514177693762,0.003780718336483932,Shoulder,Thursday,March
2024-03-14 06:00:00,36,360,3,0,399,122,196,5,1,324,24.4,91,0,16.4,723,False,6,158,556,8,1,2024-03-14,False,False,False,0.7690179806362379,0.21853388658367912,0.011065006915629323,0.0013831258644536654,Shoulder,Thursday,March
2024-03-14 07:00:00,106,450,4,1,561,122,687,10,1,820,24.3,91,0,14.4,1381,False,7,228,1137,14,2,2024-03-14,False,False,True,0.8233164373642288,0.16509775524981898,0.010137581462708182,0.001448225923244026,Peak,Thursday,March
2024-03-14 08:00:00,142,450,4,1,597,122,393,10,2,527,24.8,88,3,14.3,1124,False,8,264,843,14,3,2024-03-14,False,False,False,0.75,0.23487544483985764,0.012455516014234875,0.0026690391459074734,Peak,Thursday,March
2024-03-14 09:00:00,71,450,4,1,526,61,196,4,0,261,26.9,81,2,10.7,787,False,9,132,646,8,1,2024-03-14,False,False,False,0.820838627700127,0.16772554002541296,0.010165184243964422,0.0012706480304955528,Shoulder,Thursday,March
2024-03-14 10:00:00,89,360,2,1,452,152,196,2,0,350,29.1,71,3,11.8,802,False,10,241,556,4,1,2024-03-14,False,False,False,0.6932668329177057,0.300498753117207,0.004987531172069825,0.0012468827930174563,Shoulder,Thursday,March
2024-03-14 11:00:00,142,630,5,1,778,213,491,10,2,716,31.2,59,3,12.2,1494,False,11,355,1121,15,3,2024-03-14,False,False,True,0.750334672021419,0.23761713520749667,0.010040160642570281,0.002008032128514056,Peak,Thursday,March
2024-03-14 12:00:00,124,450,5,1,580,122,786,8,1,917,33.0,49,3,10.5,1497,False,12,246,1236,13,2,2024-03-14,False,False,True,0.8256513026052105,0.16432865731462926,0.008684034736138945,0.0013360053440213762,Peak,Thursday,March
2024-03-14 13:00:00,89,540,4,1,634,183,589,7,1,780,34.2,42,2,6.5,1414,False,13,272,1129,11,2,2024-03-14,False,False,True,0.7984441301272984,0.19236209335219237,0.007779349363507779,0.0014144271570014145,Peak,Thursday,March
2024-03-14 14:00:00,53,180,3,1,237,152,491,4,1,648,33.4,46,3,9.2,885,False,14,205,671,7,2,2024-03-14,False,False,False,0.7581920903954802,0.23163841807909605,0.007909604519774011,0.0022598870056497176,Peak,Thursday,March
2024-03-14 15:00:00,71,270,3,0,344,91,196,6,1,294,32.1,61,2,14.1,638,False,15,162,466,9,1,2024-03-14,False,False,False,0.7304075235109718,0.25391849529780564,0.014106583072100314,0.001567398119122257,Peak,Thursday,March
2024-03-14 16:00:00,53,360,4,1,418,91,393,5,1,490,31.3,61,1,18.8,908,False,16,144,753,9,2,2024-03-14,False,False,False,0.829295154185022,0.15859030837004406,0.009911894273127754,0.0022026431718061676,Peak,Thursday,March
2024-03-14 17:00:00,124,629,5,1,759,244,786,10,1,1041,30.7,62,0,15.9,1800,False,17,368,1415,15,2,2024-03-14,False,False,True,0.7861111111111111,0.20444444444444446,0.008333333333333333,0.0011111111111111111,Peak,Thursday,March
2024-03-14 18:00:00,124,540,4,1,669,183,687,9,2,881,30.4,66,0,8.3,1550,False,18,307,1227,13,3,2024-03-14,False,False,True,0.7916129032258065,0.19806451612903225,0.008387096774193548,0.001935483870967742,Peak,Thursday,March
2024-03-14 19:00:00,124,450,7,1,582,244,786,6,1,1037,29.7,71,3,5.2,1619,False,19,368,1236,13,2,2024-03-14,False,False,True,0.7634342186534898,0.22730080296479308,0.008029647930821495,0.0012353304508956147,Peak,Thursday,March
2024-03-14 20:00:00,89,450,2,1,542,122,393,6,1,522,28.9,77,3,6.6,1064,False,20,211,843,8,2,2024-03-14,False,False,False,0.7922932330827067,0.19830827067669174,0.007518796992481203,0.0018796992481203006,Shoulder,Thursday,March
2024-03-14 21:00:00,53,180,2,1,236,122,491,2,1,616,28.0,86,3,4.9,852,False,21,175,671,4,2,2024-03-14,False,False,False,0.7875586854460094,0.20539906103286384,0.004694835680751174,0.002347417840375587,Shoulder,Thursday,March
2024-03-14 22:00:00,53,270,2,1,326,122,393,6,1,522,27.6,84,3,3.9,848,False,22,175,663,8,2,2024-03-14,False,False,False,0.7818396226415094,0.20636792452830188,0.009433962264150943,0.0023584905660377358,Shoulder,Thursday,March
2024-03-14 23:00:00,53,180,4,0,237,91,295,2,1,389,27.1,83,3,6.5,626,False,23,144,475,6,1,2024-03-14,False,False,False,0.7587859424920128,0.23003194888178913,0.009584664536741214,0.001597444089456869,Shoulder,Thursday,March
2024-03-15 00:00:00,70,84,2,0,156,28,92,2,0,122,27.0,80,3,9.4,278,False,0,98,176,4,0,2024-03-15,False,False,False,0.6330935251798561,0.35251798561151076,0.014388489208633094,0.0,Off-Peak,Friday,March
2024-03-15 01:00:00,47,168,2,0,217,84,274,2,0,360,26.1,83,2,9.6,577,False,1,131,442,4,0,2024-03-15,False,False,False,0.7660311958405546,0.2270363951473137,0.006932409012131715,0.0,Off-Peak,Friday,March
2024-03-15 02:00:00,24,84,1,0,109,56,183,2,0,241,25.5,88,3,7.8,350,False,2,80,267,3,0,2024-03-15,False,False,False,0.7628571428571429,0.22857142857142856,0.008571428571428572,0.0,Off-Peak,Friday,March
2024-03-15 03:00:00,23,253,1,0,277,84,274,2,0,360,25.4,90,3,7.2,637,False,3,107,527,3,0,2024-03-15,False,False,False,0.8273155416012559,0.16797488226059654,0.004709576138147566,0.0,Off-Peak,Friday,March
2024-03-15 04:00:00,70,168,2,0,240,28,183,2,0,213,24.9,93,3,6.5,453,False,4,98,351,4,0,2024-03-15,False,False,False,0.7748344370860927,0.2163355408388521,0.008830022075055188,0.0,Off-Peak,Friday,March
2024-03-15 05:00:00,47,421,3,1,472,112,274,7,0,393,24.7,94,3,8.4,865,False,5,159,695,10,1,2024-03-15,False,False,False,0.8034682080924855,0.1838150289017341,0.011560693641618497,0.0011560693641618498,Shoulder,Friday,March
2024-03-15 06:00:00,94,421,2,1,518,140,274,6,0,420,24.4,96,3,8.5,938,False,6,234,695,8,1,2024-03-15,False,False,False,0.7409381663113006,0.24946695095948826,0.008528784648187633,0.0010660980810234541,Shoulder,Friday,March
2024-03-15 07:00:00,164,589,4,1,758,140,640,7,1,788,24.4,96,3,10.6,1546,False,7,304,1229,11,2,2024-03-15,False,False,True,0.794954721862872,0.19663648124191463,0.0071151358344113845,0.00129366106080207,Peak,Friday,March
2024-03-15 08:00:00,164,337,5,1,507,195,457,9,1,662,25.0,93,3,11.5,1169,False,8,359,794,14,2,2024-03-15,False,False,False,0.679213002566296,0.30710008554319934,0.011976047904191617,0.001710863986313088,Peak,Friday,March
2024-03-15 09:00:00,70,168,2,1,241,112,183,3,1,299,27.6,86,3,10.1,540,False,9,182,351,5,2,2024-03-15,False,False,False,0.65,0.337037037037037,0.009259259259259259,0.003703703703703704,Shoulder,Friday,March
2024-03-15 10:00:00,70,421,1,1,493,140,457,3,1,601,29.1,77,3,9.6,1094,False,10,210,878,4,2,2024-03-15,False,False,False,0.8025594149908593,0.19195612431444242,0.003656307129798903,0.0018281535648994515,Shoulder,Friday,March
2024-03-15 11:00:00,94,589,3,1,687,223,640,12,1,876,30.7,69,2,9.1,1563,False,11,317,1229,15,2,2024-03-15,False,False,True,0.7863083813179782,0.20281509916826615,0.009596928982725527,0.0012795905310300703,Peak,Friday,March
2024-03-15 12:00:00,141,421,3,1,566,112,366,6,0,484,31.8,63,3,6.6,1050,False,12,253,787,9,1,2024-03-15,False,False,False,0.7495238095238095,0.24095238095238095,0.008571428571428572,0.0009523809523809524,Peak,Friday,March
2024-03-15 13:00:00,141,589,5,1,736,223,457,9,1,690,32.8,57,1,4.9,1426,False,13,364,1046,14,2,2024-03-15,False,False,True,0.7335203366058906,0.2552594670406732,0.009817671809256662,0.001402524544179523,Peak,Friday,March
2024-03-15 14:00:00,70,253,4,0,327,84,274,4,1,363,32.6,58,2,6.7,690,False,14,154,527,8,1,2024-03-15,False,False,False,0.763768115942029,0.22318840579710145,0.011594202898550725,0.0014492753623188406,Peak,Friday,March
2024-03-15 15:00:00,94,337,3,1,435,112,457,6,1,576,32.0,65,51,10.0,1011,False,15,206,794,9,2,2024-03-15,False,False,False,0.7853610286844708,0.20375865479723046,0.008902077151335312,0.0019782393669634025,Peak,Friday,March
2024-03-15 16:00:00,94,337,4,0,435,139,457,6,0,602,31.5,65,51,9.9,1037,False,16,233,794,10,0,2024-03-15,False,False,False,0.7656702025072324,0.22468659594985535,0.009643201542912247,0.0,Peak,Friday,March
2024-03-15 17:00:00,94,337,6,1,438,195,731,9,0,935,31.3,62,51,8.4,1373,False,17,289,1068,15,1,2024-03-15,False,False,False,0.7778587035688274,0.21048798252002912,0.010924981791697014,0.0007283321194464676,Peak,Friday,March
2024-03-15 18:00:00,141,505,4,1,651,139,548,9,1,697,30.9,63,3,6.5,1348,False,18,280,1053,13,2,2024-03-15,False,False,False,0.7811572700296736,0.20771513353115728,0.009643916913946587,0.001483679525222552,Peak,Friday,March
2024-03-15 19:00:00,141,589,5,0,735,223,548,9,0,780,30.0,70,3,2.9,1515,False,19,364,1137,14,0,2024-03-15,False,False,True,0.7504950495049505,0.24026402640264027,0.009240924092409241,0.0,Peak,Friday,March
2024-03-15 20:00:00,47,337,4,0,388,56,457,4,0,517,28.7,76,3,4.0,905,False,20,103,794,8,0,2024-03-15,False,False,False,0.8773480662983425,0.1138121546961326,0.008839779005524863,0.0,Shoulder,Friday,March
2024-03-15 21:00:00,70,252,4,1,327,84,274,3,0,361,27.4,79,3,5.5,688,False,21,154,526,7,1,2024-03-15,False,False,False,0.7645348837209303,0.2238372093023256,0.010174418604651164,0.0014534883720930232,Shoulder,Friday,March
2024-03-15 22:00:00,70,252,1,0,323,139,366,4,0,509,27.0,85,3,3.6,832,False,22,209,618,5,0,2024-03-15,False,False,False,0.7427884615384616,0.2512019230769231,0.006009615384615385,0.0,Shoulder,Friday,March
2024-03-15 23:00:00,47,252,2,0,301,56,274,6,0,336,26.5,86,3,3.9,637,False,23,103,526,8,0,2024-03-15,False,False,False,0.82574568288854,0.16169544740973313,0.012558869701726845,0.0,Shoulder,Friday,March
2024-03-16 00:00:00,19,67,2,0,88,23,213,3,1,240,26.6,81,3,8.9,328,True,0,42,280,5,1,2024-03-16,False,False,False,0.8536585365853658,0.12804878048780488,0.01524390243902439,0.003048780487804878,Off-Peak,Saturday,March
2024-03-16 01:00:00,56,134,1,0,191,69,142,3,1,215,26.5,75,3,11.9,406,True,1,125,276,4,1,2024-03-16,False,False,False,0.6798029556650246,0.3078817733990148,0.009852216748768473,0.0024630541871921183,Off-Peak,Saturday,March
2024-03-16 02:00:00,19,201,1,0,221,46,213,1,1,261,25.9,78,3,11.9,482,True,2,65,414,2,1,2024-03-16,False,False,False,0.8589211618257261,0.13485477178423236,0.004149377593360996,0.002074688796680498,Off-Peak,Saturday,March
2024-03-16 03:00:00,37,201,1,0,239,23,213,1,0,237,25.7,81,3,11.6,476,True,3,60,414,2,0,2024-03-16,False,False,False,0.8697478991596639,0.12605042016806722,0.004201680672268907,0.0,Off-Peak,Saturday,March
2024-03-16 04:00:00,19,67,1,0,87,69,71,3,1,144,25.4,83,2,13.7,231,True,4,88,138,4,1,2024-03-16,False,False,False,0.5974025974025974,0.38095238095238093,0.017316017316017316,0.004329004329004329,Off-Peak,Saturday,March
2024-03-16 05:00:00,37,201,3,1,242,116,355,3,0,474,25.3,85,1,14.6,716,True,5,153,556,6,1,2024-03-16,False,False,False,0.776536312849162,0.21368715083798884,0.008379888268156424,0.0013966480446927375,Shoulder,Saturday,March
2024-03-16 06:00:00,75,267,1,0,343,46,213,7,1,267,25.1,86,3,14.6,610,True,6,121,480,8,1,2024-03-16,False,False,False,0.7868852459016393,0.19836065573770492,0.013114754098360656,0.001639344262295082,Shoulder,Saturday,March
2024-03-16 07:00:00,149,401,2,0,552,139,425,6,1,571,25.1,86,3,15.3,1123,True,7,288,826,8,1,2024-03-16,False,False,False,0.7355298308103295,0.25645592163846836,0.007123775601068566,0.0008904719501335708,Peak,Saturday,March
2024-03-16 08:00:00,93,468,4,1,566,185,355,8,2,550,25.4,85,3,15.4,1116,True,8,278,823,12,3,2024-03-16,False,False,False,0.7374551971326165,0.24910394265232974,0.010752688172043012,0.002688172043010753,Peak,Saturday,March
2024-03-16 09:00:00,37,334,2,0,373,116,213,5,1,335,27.3,80,3,15.0,708,True,9,153,547,7,1,2024-03-16,False,False,False,0.7725988700564972,0.21610169491525424,0.009887005649717515,0.0014124293785310734,Shoulder,Saturday,March
2024-03-16 10:00:00,37,201,2,0,240,116,142,3,1,262,29.6,68,3,14.3,502,True,10,153,343,5,1,2024-03-16,False,False,False,0.6832669322709163,0.3047808764940239,0.0099601593625498,0.00199203187250996,Shoulder,Saturday,March
2024-03-16 11:00:00,74,468,3,1,546,185,425,9,1,620,31.9,54,3,11.0,1166,True,11,259,893,12,2,2024-03-16,False,False,False,0.7658662092624356,0.2221269296740995,0.010291595197255575,0.0017152658662092624,Peak,Saturday,March
2024-03-16 12:00:00,130,267,3,0,400,139,567,8,1,715,32.8,50,51,6.2,1115,True,12,269,834,11,1,2024-03-16,False,False,False,0.747982062780269,0.24125560538116592,0.009865470852017937,0.0008968609865470852,Peak,Saturday,March
2024-03-16 13:00:00,149,401,4,1,555,139,355,10,1,505,33.0,50,53,4.6,1060,True,13,288,756,14,2,2024-03-16,False,False,False,0.7132075471698113,0.27169811320754716,0.013207547169811321,0.0018867924528301887,Peak,Saturday,March
2024-03-16 14:00:00,93,200,2,0,295,69,142,4,1,216,33.2,49,51,6.1,511,True,14,162,342,6,1,2024-03-16,False,False,False,0.6692759295499021,0.31702544031311153,0.011741682974559686,0.0019569471624266144,Peak,Saturday,March
2024-03-16 15:00:00,93,267,1,0,361,115,142,4,0,261,32.7,53,53,9.7,622,True,15,208,409,5,0,2024-03-16,False,False,False,0.657556270096463,0.33440514469453375,0.008038585209003215,0.0,Peak,Saturday,March
2024-03-16 16:00:00,56,200,2,0,258,92,355,6,1,454,32.5,56,1,10.8,712,True,16,148,555,8,1,2024-03-16,False,False,False,0.7794943820224719,0.20786516853932585,0.011235955056179775,0.0014044943820224719,Peak,Saturday,March
2024-03-16 17:00:00,93,267,4,1,365,185,425,10,2,622,32.1,59,1,9.8,987,True,17,278,692,14,3,2024-03-16,False,False,False,0.7011144883485309,0.281661600810537,0.014184397163120567,0.00303951367781155,Peak,Saturday,March
2024-03-16 18:00:00,112,334,3,1,450,185,496,9,1,691,31.0,62,0,10.8,1141,True,18,297,830,12,2,2024-03-16,False,False,False,0.7274320771253286,0.26029798422436456,0.010517090271691499,0.0017528483786152498,Peak,Saturday,March
2024-03-16 19:00:00,112,468,4,0,584,92,355,9,1,457,30.2,65,1,8.7,1041,True,19,204,823,13,1,2024-03-16,False,False,False,0.7905859750240154,0.19596541786743515,0.012487992315081652,0.0009606147934678194,Peak,Saturday,March
2024-03-16 20:00:00,74,134,1,0,209,92,284,3,1,380,29.6,69,0,8.2,589,True,20,166,418,4,1,2024-03-16,False,False,False,0.7096774193548387,0.28183361629881154,0.006791171477079796,0.001697792869269949,Shoulder,Saturday,March
2024-03-16 21:00:00,93,267,1,1,362,46,355,4,0,405,28.0,75,1,3.7,767,True,21,139,622,5,1,2024-03-16,False,False,False,0.8109517601043025,0.18122555410691005,0.00651890482398957,0.001303780964797914,Shoulder,Saturday,March
2024-03-16 22:00:00,74,200,2,0,276,115,142,6,0,263,27.9,68,1,11.3,539,True,22,189,342,8,0,2024-03-16,False,False,False,0.634508348794063,0.35064935064935066,0.014842300556586271,0.0,Shoulder,Saturday,March
2024-03-16 23:00:00,37,334,2,0,373,115,355,3,1,474,27.9,67,2,11.4,847,True,23,152,689,5,1,2024-03-16,False,False,False,0.8134592680047226,0.179456906729634,0.0059031877213695395,0.0011806375442739079,Shoulder,Saturday,March
2024-03-17 00:00:00,18,179,1,0,198,23,125,1,0,149,27.7,70,3,11.2,347,True,0,41,304,2,0,2024-03-17,False,False,False,0.8760806916426513,0.11815561959654179,0.005763688760806916,0.0,Off-Peak,Sunday,March
2024-03-17 01:00:00,18,119,1,0,138,23,125,4,0,152,27.1,73,1,11.8,290,True,1,41,244,5,0,2024-03-17,False,False,False,0.8413793103448276,0.1413793103448276,0.017241379310344827,0.0,Off-Peak,Sunday,March
2024-03-17 02:00:00,18,119,2,0,139,46,188,4,0,238,26.6,77,2,11.1,377,True,2,64,307,6,0,2024-03-17,False,False,False,0.8143236074270557,0.16976127320954906,0.015915119363395226,0.0,Off-Peak,Sunday,March
2024-03-17 03:00:00,35,119,2,0,156,23,63,1,0,87,26.3,80,3,8.6,243,True,3,58,182,3,0,2024-03-17,False,False,False,0.7489711934156379,0.23868312757201646,0.012345679012345678,0.0,Off-Peak,Sunday,March
2024-03-17 04:00:00,53,59,1,0,113,46,188,2,0,236,25.8,83,0,7.1,349,True,4,99,247,3,0,2024-03-17,False,False,False,0.7077363896848138,0.2836676217765043,0.008595988538681949,0.0,Off-Peak,Sunday,March
2024-03-17 05:00:00,35,179,2,1,217,115,314,4,0,433,25.3,85,2,6.6,650,True,5,150,493,6,1,2024-03-17,False,False,False,0.7584615384615384,0.23076923076923078,0.009230769230769232,0.0015384615384615385,Shoulder,Sunday,March
2024-03-17 06:00:00,53,119,1,0,173,115,188,5,0,308,25.0,87,1,5.7,481,True,6,168,307,6,0,2024-03-17,False,False,False,0.6382536382536382,0.3492723492723493,0.012474012474012475,0.0,Shoulder,Sunday,March
2024-03-17 07:00:00,71,298,3,1,373,92,251,5,1,349,24.6,89,0,4.7,722,True,7,163,549,8,2,2024-03-17,False,False,False,0.760387811634349,0.2257617728531856,0.0110803324099723,0.002770083102493075,Peak,Sunday,March
2024-03-17 08:00:00,71,238,3,1,313,162,439,7,1,609,25.3,88,0,6.2,922,True,8,233,677,10,2,2024-03-17,False,False,False,0.7342733188720173,0.2527114967462039,0.010845986984815618,0.0021691973969631237,Peak,Sunday,March
2024-03-17 09:00:00,35,238,2,1,276,92,314,6,1,413,27.9,79,1,7.9,689,True,9,127,552,8,2,2024-03-17,False,False,False,0.8011611030478955,0.18432510885341075,0.011611030478955007,0.002902757619738752,Shoulder,Sunday,March
2024-03-17 10:00:00,53,238,1,0,292,92,188,6,0,286,29.9,70,1,9.4,578,True,10,145,426,7,0,2024-03-17,False,False,False,0.7370242214532872,0.2508650519031142,0.012110726643598616,0.0,Shoulder,Sunday,March
2024-03-17 11:00:00,88,238,3,1,330,185,313,5,1,504,31.7,60,1,10.1,834,True,11,273,551,8,2,2024-03-17,False,False,False,0.6606714628297362,0.3273381294964029,0.009592326139088728,0.002398081534772182,Peak,Sunday,March
2024-03-17 12:00:00,123,476,3,1,603,139,502,8,1,650,32.9,55,51,7.9,1253,True,12,262,978,11,2,2024-03-17,False,False,False,0.7805267358339985,0.20909816440542697,0.008778930566640064,0.0015961691939345571,Peak,Sunday,March
2024-03-17 13:00:00,88,357,3,1,449,138,313,7,1,459,33.3,52,51,7.5,908,True,13,226,670,10,2,2024-03-17,False,False,False,0.737885462555066,0.2488986784140969,0.011013215859030838,0.0022026431718061676,Peak,Sunday,March
2024-03-17 14:00:00,71,179,3,0,253,115,188,2,0,305,32.2,59,51,13.0,558,True,14,186,367,5,0,2024-03-17,False,False,False,0.6577060931899642,0.3333333333333333,0.008960573476702509,0.0,Peak,Sunday,March
2024-03-17 15:00:00,35,298,2,1,336,115,313,6,1,435,31.7,62,53,11.9,771,True,15,150,611,8,2,2024-03-17,False,False,False,0.7924773022049286,0.19455252918287938,0.010376134889753566,0.0025940337224383916,Peak,Sunday,March
2024-03-17 16:00:00,71,179,2,1,253,115,188,5,1,309,31.9,61,51,11.6,562,True,16,186,367,7,2,2024-03-17,False,False,False,0.6530249110320284,0.3309608540925267,0.012455516014234875,0.0035587188612099642,Peak,Sunday,March
2024-03-17 17:00:00,141,357,2,1,501,115,502,5,1,623,31.3,62,51,12.1,1124,True,17,256,859,7,2,2024-03-17,False,False,False,0.7642348754448398,0.2277580071174377,0.006227758007117438,0.0017793594306049821,Peak,Sunday,March
2024-03-17 18:00:00,123,298,2,1,424,185,251,6,1,443,30.4,66,51,8.7,867,True,18,308,549,8,2,2024-03-17,False,False,False,0.6332179930795848,0.3552479815455594,0.00922722029988466,0.002306805074971165,Peak,Sunday,March
2024-03-17 19:00:00,71,476,2,1,550,138,251,5,1,395,29.6,70,51,10.7,945,True,19,209,727,7,2,2024-03-17,False,False,False,0.7693121693121693,0.22116402116402117,0.007407407407407408,0.0021164021164021165,Peak,Sunday,March
2024-03-17 20:00:00,71,298,2,0,371,92,251,3,0,346,28.7,75,51,8.1,717,True,20,163,549,5,0,2024-03-17,False,False,False,0.7656903765690377,0.22733612273361228,0.00697350069735007,0.0,Shoulder,Sunday,March
2024-03-17 21:00:00,35,298,2,1,336,92,188,3,0,283,28.6,79,51,6.3,619,True,21,127,486,5,1,2024-03-17,False,False,False,0.7851373182552503,0.20516962843295639,0.008077544426494346,0.0016155088852988692,Shoulder,Sunday,March
2024-03-17 22:00:00,88,298,2,1,389,46,313,5,0,364,28.0,83,51,6.8,753,True,22,134,611,7,1,2024-03-17,False,False,False,0.8114209827357237,0.17795484727755645,0.009296148738379814,0.0013280212483399733,Shoulder,Sunday,March
2024-03-17 23:00:00,71,238,1,1,311,92,125,5,1,223,27.2,88,1,7.1,534,True,23,163,363,6,2,2024-03-17,False,False,False,0.6797752808988764,0.3052434456928839,0.011235955056179775,0.003745318352059925,Shoulder,Sunday,March
2024-03-18 00:00:00,36,78,2,0,116,58,308,1,0,367,26.9,87,0,7.6,483,False,0,94,386,3,0,2024-03-18,False,False,False,0.7991718426501035,0.19461697722567287,0.006211180124223602,0.0,Off-Peak,Monday,March
2024-03-18 01:00:00,36,78,2,0,116,57,205,1,0,263,27.0,70,0,10.0,379,False,1,93,283,3,0,2024-03-18,False,False,False,0.7467018469656992,0.24538258575197888,0.0079155672823219,0.0,Off-Peak,Monday,March
2024-03-18 02:00:00,18,156,1,0,175,86,205,1,0,292,26.3,74,0,8.9,467,False,2,104,361,2,0,2024-03-18,False,False,False,0.7730192719486081,0.22269807280513917,0.004282655246252677,0.0,Off-Peak,Monday,March
2024-03-18 03:00:00,54,235,1,0,290,57,102,3,0,162,25.9,79,0,10.2,452,False,3,111,337,4,0,2024-03-18,False,False,False,0.745575221238938,0.24557522123893805,0.008849557522123894,0.0,Off-Peak,Monday,March
2024-03-18 04:00:00,54,78,2,0,134,29,308,5,0,342,25.5,83,0,9.2,476,False,4,83,386,7,0,2024-03-18,False,False,False,0.8109243697478992,0.17436974789915966,0.014705882352941176,0.0,Off-Peak,Monday,March
2024-03-18 05:00:00,54,313,2,0,369,57,513,8,0,578,25.3,84,0,8.5,947,False,5,111,826,10,0,2024-03-18,False,False,False,0.8722280887011615,0.11721224920802534,0.010559662090813094,0.0,Shoulder,Monday,March
2024-03-18 06:00:00,90,156,4,0,250,57,410,3,0,470,25.1,84,0,9.9,720,False,6,147,566,7,0,2024-03-18,False,False,False,0.7861111111111111,0.20416666666666666,0.009722222222222222,0.0,Shoulder,Monday,March
2024-03-18 07:00:00,72,547,4,1,624,144,615,9,1,769,25.0,85,2,10.3,1393,False,7,216,1162,13,2,2024-03-18,False,False,True,0.8341708542713567,0.15506101938262742,0.00933237616654702,0.0014357501794687725,Peak,Monday,March
2024-03-18 08:00:00,108,313,4,1,426,115,615,9,1,740,25.5,83,0,11.0,1166,False,8,223,928,13,2,2024-03-18,False,False,False,0.7958833619210978,0.19125214408233276,0.011149228130360206,0.0017152658662092624,Peak,Monday,March
2024-03-18 09:00:00,90,391,3,0,484,144,308,3,0,455,28.8,73,2,10.9,939,False,9,234,699,6,0,2024-03-18,False,False,False,0.744408945686901,0.24920127795527156,0.006389776357827476,0.0,Shoulder,Monday,March
2024-03-18 10:00:00,54,313,2,0,369,57,205,8,0,270,30.8,62,1,13.2,639,False,10,111,518,10,0,2024-03-18,False,False,False,0.810641627543036,0.17370892018779344,0.01564945226917058,0.0,Shoulder,Monday,March
2024-03-18 11:00:00,125,313,3,0,441,144,513,9,1,667,32.7,53,1,10.8,1108,False,11,269,826,12,1,2024-03-18,False,False,False,0.7454873646209387,0.2427797833935018,0.010830324909747292,0.0009025270758122744,Peak,Monday,March
2024-03-18 12:00:00,125,469,5,1,600,201,513,8,1,723,33.9,48,51,6.8,1323,False,12,326,982,13,2,2024-03-18,False,False,False,0.7422524565381708,0.24640967498110355,0.009826152683295541,0.0015117157974300832,Peak,Monday,March
2024-03-18 13:00:00,108,469,6,0,583,230,718,11,1,960,34.0,48,51,4.5,1543,False,13,338,1187,17,1,2024-03-18,False,False,True,0.7692806221646143,0.21905379131561892,0.01101749837977965,0.0006480881399870382,Peak,Monday,March
2024-03-18 14:00:00,90,391,4,0,485,57,410,8,0,475,33.1,51,53,3.3,960,False,14,147,801,12,0,2024-03-18,False,False,False,0.834375,0.153125,0.0125,0.0,Peak,Monday,March
2024-03-18 15:00:00,72,235,4,0,311,57,308,5,0,370,31.8,59,53,9.2,681,False,15,129,543,9,0,2024-03-18,False,False,False,0.7973568281938326,0.1894273127753304,0.013215859030837005,0.0,Peak,Monday,March
2024-03-18 16:00:00,90,235,2,0,327,144,410,8,0,562,30.7,69,51,9.3,889,False,16,234,645,10,0,2024-03-18,False,False,False,0.7255343082114736,0.26321709786276715,0.01124859392575928,0.0,Peak,Monday,March
2024-03-18 17:00:00,108,547,5,1,661,230,410,8,1,649,30.7,68,1,8.7,1310,False,17,338,957,13,2,2024-03-18,False,False,False,0.7305343511450382,0.2580152671755725,0.009923664122137405,0.0015267175572519084,Peak,Monday,March
2024-03-18 18:00:00,72,469,3,0,544,201,513,11,1,726,29.6,71,53,4.4,1270,False,18,273,982,14,1,2024-03-18,False,False,False,0.7732283464566929,0.21496062992125983,0.011023622047244094,0.0007874015748031496,Peak,Monday,March
2024-03-18 19:00:00,90,313,6,1,410,144,615,8,0,767,27.7,82,53,8.0,1177,False,19,234,928,14,1,2024-03-18,False,False,False,0.7884451996601529,0.1988105352591334,0.0118946474086661,0.0008496176720475786,Peak,Monday,March
2024-03-18 20:00:00,36,313,4,0,353,115,513,3,1,632,26.9,89,2,4.3,985,False,20,151,826,7,1,2024-03-18,False,False,False,0.8385786802030457,0.1532994923857868,0.007106598984771574,0.0010152284263959391,Shoulder,Monday,March
2024-03-18 21:00:00,54,234,2,0,290,144,410,8,0,562,27.9,86,1,2.8,852,False,21,198,644,10,0,2024-03-18,False,False,False,0.755868544600939,0.2323943661971831,0.011737089201877934,0.0,Shoulder,Monday,March
2024-03-18 22:00:00,90,156,2,0,248,115,410,6,0,531,27.5,89,1,4.5,779,False,22,205,566,8,0,2024-03-18,False,False,False,0.7265725288831836,0.2631578947368421,0.010269576379974325,0.0,Shoulder,Monday,March
2024-03-18 23:00:00,54,313,3,0,370,57,308,5,0,370,27.6,87,1,7.4,740,False,23,111,621,8,0,2024-03-18,False,False,False,0.8391891891891892,0.15,0.010810810810810811,0.0,Shoulder,Monday,March
2024-03-19 00:00:00,35,143,2,0,180,48,164,3,1,216,27.2,88,0,8.3,396,False,0,83,307,5,1,2024-03-19,False,False,False,0.7752525252525253,0.20959595959595959,0.012626262626262626,0.0025252525252525255,Off-Peak,Tuesday,March
2024-03-19 01:00:00,44,102,2,0,148,48,163,2,0,213,26.5,88,0,8.3,361,False,1,92,265,4,0,2024-03-19,False,False,False,0.7340720221606648,0.2548476454293629,0.0110803324099723,0.0,Off-Peak,Tuesday,March
2024-03-19 02:00:00,25,154,2,0,181,48,163,2,0,213,26.0,89,0,9.3,394,False,2,73,317,4,0,2024-03-19,False,False,False,0.8045685279187818,0.18527918781725888,0.01015228426395939,0.0,Off-Peak,Tuesday,March
2024-03-19 03:00:00,32,143,2,0,177,48,163,2,0,213,25.7,90,0,10.6,390,False,3,80,306,4,0,2024-03-19,False,False,False,0.7846153846153846,0.20512820512820512,0.010256410256410256,0.0,Off-Peak,Tuesday,March
2024-03-19 04:00:00,29,141,3,0,173,48,163,2,0,213,25.6,90,0,12.1,386,False,4,77,304,5,0,2024-03-19,False,False,False,0.7875647668393783,0.19948186528497408,0.012953367875647668,0.0,Off-Peak,Tuesday,March
2024-03-19 05:00:00,52,232,4,0,288,95,326,4,1,426,25.5,90,0,12.3,714,False,5,147,558,8,1,2024-03-19,False,False,False,0.7815126050420168,0.20588235294117646,0.011204481792717087,0.0014005602240896359,Shoulder,Tuesday,March
2024-03-19 06:00:00,54,219,3,1,277,95,326,4,1,426,25.4,90,0,13.6,703,False,6,149,545,7,2,2024-03-19,False,False,False,0.7752489331436699,0.2119487908961593,0.00995732574679943,0.002844950213371266,Shoulder,Tuesday,March
2024-03-19 07:00:00,117,521,6,1,645,191,653,9,1,854,25.3,90,2,13.0,1499,False,7,308,1174,15,2,2024-03-19,False,False,True,0.7831887925283523,0.2054703135423616,0.01000667111407605,0.00133422281521014,Peak,Tuesday,March
2024-03-19 08:00:00,119,458,6,1,584,191,653,9,1,854,25.8,88,0,13.5,1438,False,8,310,1111,15,2,2024-03-19,False,False,True,0.7726008344923505,0.21557719054242003,0.01043115438108484,0.0013908205841446453,Peak,Tuesday,March
2024-03-19 09:00:00,63,226,3,1,293,95,326,4,1,426,28.1,79,2,16.3,719,False,9,158,552,7,2,2024-03-19,False,False,False,0.7677329624478443,0.21974965229485396,0.009735744089012517,0.0027816411682892906,Shoulder,Tuesday,March
2024-03-19 10:00:00,60,261,3,2,326,95,326,4,1,426,30.3,67,2,15.9,752,False,10,155,587,7,3,2024-03-19,False,False,False,0.7805851063829787,0.20611702127659576,0.009308510638297872,0.003989361702127659,Shoulder,Tuesday,March
2024-03-19 11:00:00,134,503,7,1,645,191,652,9,1,853,32.5,53,2,14.8,1498,False,11,325,1155,16,2,2024-03-19,False,False,True,0.7710280373831776,0.21695594125500667,0.010680907877169559,0.0013351134846461949,Peak,Tuesday,March
2024-03-19 12:00:00,110,425,7,1,543,191,652,9,1,853,34.2,46,2,10.9,1396,False,12,301,1077,16,2,2024-03-19,False,False,True,0.7714899713467048,0.21561604584527222,0.011461318051575931,0.0014326647564469914,Peak,Tuesday,March
2024-03-19 13:00:00,143,500,6,1,650,191,652,9,1,853,35.3,42,3,5.2,1503,False,13,334,1152,15,2,2024-03-19,False,False,True,0.7664670658682635,0.2222222222222222,0.00998003992015968,0.0013306719893546241,Peak,Tuesday,March
2024-03-19 14:00:00,50,217,4,0,271,95,326,4,1,426,35.2,42,3,3.6,697,False,14,145,543,8,1,2024-03-19,False,False,False,0.7790530846484935,0.20803443328550933,0.011477761836441894,0.0014347202295552368,Peak,Tuesday,March
2024-03-19 15:00:00,66,277,4,1,348,95,326,4,0,425,33.9,49,51,9.5,773,False,15,161,603,8,1,2024-03-19,False,False,False,0.7800776196636481,0.20827943078913325,0.01034928848641656,0.00129366106080207,Peak,Tuesday,March
2024-03-19 16:00:00,60,285,3,0,348,95,326,4,0,425,31.8,59,51,17.1,773,False,16,155,611,7,0,2024-03-19,False,False,False,0.7904269081500647,0.20051746442432083,0.009055627425614488,0.0,Peak,Tuesday,March
2024-03-19 17:00:00,127,496,7,1,631,191,652,9,1,853,32.1,58,2,7.4,1484,False,17,318,1148,16,2,2024-03-19,False,False,True,0.7735849056603774,0.21428571428571427,0.01078167115902965,0.0013477088948787063,Peak,Tuesday,March
2024-03-19 18:00:00,107,566,6,1,680,191,652,9,1,853,31.7,64,2,9.8,1533,False,18,298,1218,15,2,2024-03-19,False,False,True,0.7945205479452054,0.1943900848010437,0.009784735812133072,0.001304631441617743,Peak,Tuesday,March
2024-03-19 19:00:00,109,414,7,1,531,191,652,8,1,852,29.7,68,51,4.0,1383,False,19,300,1066,15,2,2024-03-19,False,False,True,0.7707881417208966,0.21691973969631237,0.010845986984815618,0.0014461315979754157,Peak,Tuesday,March
2024-03-19 20:00:00,70,249,3,1,323,95,326,4,0,425,28.1,79,53,7.9,748,False,20,165,575,7,1,2024-03-19,False,False,False,0.7687165775401069,0.22058823529411764,0.009358288770053475,0.001336898395721925,Shoulder,Tuesday,March
2024-03-19 21:00:00,74,205,4,1,284,95,326,4,0,425,29.0,71,0,7.2,709,False,21,169,531,8,1,2024-03-19,False,False,False,0.7489421720733427,0.2383638928067701,0.011283497884344146,0.0014104372355430183,Shoulder,Tuesday,March
2024-03-19 22:00:00,58,242,3,1,304,95,326,4,0,425,28.4,71,1,6.0,729,False,22,153,568,7,1,2024-03-19,False,False,False,0.7791495198902606,0.20987654320987653,0.009602194787379973,0.0013717421124828531,Shoulder,Tuesday,March
2024-03-19 23:00:00,67,209,3,1,280,95,326,4,0,425,27.9,71,1,7.8,705,False,23,162,535,7,1,2024-03-19,False,False,False,0.7588652482269503,0.2297872340425532,0.009929078014184398,0.0014184397163120568,Shoulder,Tuesday,March
2024-03-20 00:00:00,79,272,3,0,354,88,235,3,1,327,27.4,72,3,10.2,681,False,0,167,507,6,1,2024-03-20,False,False,False,0.7444933920704846,0.24522760646108663,0.00881057268722467,0.0014684287812041115,Off-Peak,Wednesday,March
2024-03-20 01:00:00,85,306,4,1,396,101,250,4,1,356,27.1,75,3,9.9,752,False,1,186,556,8,2,2024-03-20,False,False,False,0.7393617021276596,0.2473404255319149,0.010638297872340425,0.0026595744680851063,Off-Peak,Wednesday,March
2024-03-20 02:00:00,71,305,6,1,383,97,300,4,0,401,26.7,79,3,12.0,784,False,2,168,605,10,1,2024-03-20,False,False,False,0.7716836734693877,0.21428571428571427,0.012755102040816327,0.0012755102040816326,Off-Peak,Wednesday,March
2024-03-20 03:00:00,70,298,2,0,370,98,229,4,0,331,26.5,80,3,13.1,701,False,3,168,527,6,0,2024-03-20,False,False,False,0.7517831669044223,0.2396576319543509,0.008559201141226819,0.0,Off-Peak,Wednesday,March
2024-03-20 04:00:00,95,318,3,0,416,67,220,3,1,291,26.4,80,3,13.3,707,False,4,162,538,6,1,2024-03-20,False,False,False,0.7609618104667609,0.22913719943422914,0.008486562942008486,0.0014144271570014145,Off-Peak,Wednesday,March
2024-03-20 05:00:00,87,314,5,0,406,123,367,5,1,496,26.4,80,2,14.5,902,False,5,210,681,10,1,2024-03-20,False,False,False,0.7549889135254989,0.2328159645232816,0.011086474501108648,0.0011086474501108647,Shoulder,Wednesday,March
2024-03-20 06:00:00,85,303,2,0,390,133,405,5,1,544,26.2,81,2,15.0,934,False,6,218,708,7,1,2024-03-20,False,False,False,0.7580299785867237,0.2334047109207709,0.007494646680942184,0.0010706638115631692,Shoulder,Wednesday,March
2024-03-20 07:00:00,92,287,1,0,380,135,417,6,0,558,26.1,82,3,14.8,938,False,7,227,704,7,0,2024-03-20,False,False,False,0.7505330490405118,0.2420042643923241,0.007462686567164179,0.0,Peak,Wednesday,March
2024-03-20 08:00:00,75,280,3,0,358,158,467,5,1,631,26.5,80,0,16.3,989,False,8,233,747,8,1,2024-03-20,False,False,False,0.7553083923154702,0.23559150657229525,0.008088978766430738,0.0010111223458038423,Peak,Wednesday,March
2024-03-20 09:00:00,87,304,2,1,394,164,514,5,1,684,28.4,73,1,17.1,1078,False,9,251,818,7,2,2024-03-20,False,False,False,0.7588126159554731,0.23283858998144713,0.006493506493506494,0.0018552875695732839,Shoulder,Wednesday,March
2024-03-20 10:00:00,85,284,7,0,376,110,376,5,1,492,30.2,67,2,17.7,868,False,10,195,660,12,1,2024-03-20,False,False,False,0.7603686635944701,0.22465437788018433,0.013824884792626729,0.001152073732718894,Shoulder,Wednesday,March
2024-03-20 11:00:00,82,306,6,0,394,164,485,6,1,656,31.7,61,1,17.5,1050,False,11,246,791,12,1,2024-03-20,False,False,False,0.7533333333333333,0.2342857142857143,0.011428571428571429,0.0009523809523809524,Peak,Wednesday,March
2024-03-20 12:00:00,74,328,5,1,408,137,417,5,1,560,33.3,57,1,12.0,968,False,12,211,745,10,2,2024-03-20,False,False,False,0.7696280991735537,0.21797520661157024,0.010330578512396695,0.002066115702479339,Peak,Wednesday,March
2024-03-20 13:00:00,76,329,6,0,411,144,464,7,1,616,32.4,58,63,17.3,1027,False,13,220,793,13,1,2024-03-20,False,False,False,0.7721518987341772,0.21421616358325218,0.012658227848101266,0.0009737098344693282,Peak,Wednesday,March
2024-03-20 14:00:00,73,325,5,2,405,127,379,5,1,512,29.0,81,65,5.8,917,False,14,200,704,10,3,2024-03-20,False,False,False,0.7677208287895311,0.21810250817884405,0.010905125408942203,0.003271537622682661,Peak,Wednesday,March
2024-03-20 15:00:00,104,315,2,1,422,130,341,5,0,476,27.4,85,63,2.5,898,False,15,234,656,7,1,2024-03-20,False,False,False,0.7305122494432071,0.26057906458797325,0.0077951002227171495,0.0011135857461024498,Peak,Wednesday,March
2024-03-20 16:00:00,92,330,6,0,428,121,379,4,1,505,28.7,81,63,12.3,933,False,16,213,709,10,1,2024-03-20,False,False,False,0.759914255091104,0.2282958199356913,0.010718113612004287,0.0010718113612004287,Peak,Wednesday,March
2024-03-20 17:00:00,80,289,3,0,372,169,504,7,1,681,28.2,81,55,8.8,1053,False,17,249,793,10,1,2024-03-20,False,False,False,0.7530864197530864,0.23646723646723647,0.00949667616334283,0.000949667616334283,Peak,Wednesday,March
2024-03-20 18:00:00,73,300,5,0,378,156,526,6,1,689,27.0,85,61,5.6,1067,False,18,229,826,11,1,2024-03-20,False,False,False,0.7741330834114339,0.21462043111527648,0.010309278350515464,0.0009372071227741331,Peak,Wednesday,March
2024-03-20 19:00:00,85,305,5,0,395,138,523,6,0,667,26.5,88,53,5.4,1062,False,19,223,828,11,0,2024-03-20,False,False,False,0.7796610169491526,0.20998116760828625,0.010357815442561206,0.0,Peak,Wednesday,March
2024-03-20 20:00:00,89,324,2,0,415,123,373,4,0,500,25.8,90,63,4.6,915,False,20,212,697,6,0,2024-03-20,False,False,False,0.7617486338797814,0.23169398907103825,0.006557377049180328,0.0,Shoulder,Wednesday,March
2024-03-20 21:00:00,76,307,1,0,384,106,344,5,1,456,26.2,85,51,0.8,840,False,21,182,651,6,1,2024-03-20,False,False,False,0.775,0.21666666666666667,0.007142857142857143,0.0011904761904761906,Shoulder,Wednesday,March
2024-03-20 22:00:00,108,295,3,1,407,110,323,5,1,439,26.6,86,0,11.2,846,False,22,218,618,8,2,2024-03-20,False,False,False,0.7304964539007093,0.2576832151300236,0.009456264775413711,0.002364066193853428,Shoulder,Wednesday,March
2024-03-20 23:00:00,81,326,5,0,412,125,352,5,0,482,26.5,85,1,11.0,894,False,23,206,678,10,0,2024-03-20,False,False,False,0.7583892617449665,0.23042505592841164,0.011185682326621925,0.0,Shoulder,Wednesday,March
2024-03-21 00:00:00,35,107,4,0,146,59,169,4,0,232,26.1,85,0,12.0,378,False,0,94,276,8,0,2024-03-21,False,False,False,0.7301587301587301,0.24867724867724866,0.021164021164021163,0.0,Off-Peak,Thursday,March
2024-03-21 01:00:00,40,121,1,1,163,64,190,5,0,259,25.7,87,1,12.1,422,False,1,104,311,6,1,2024-03-21,False,False,False,0.7369668246445498,0.24644549763033174,0.014218009478672985,0.002369668246445498,Off-Peak,Thursday,March
2024-03-21 02:00:00,35,142,2,0,179,66,198,6,0,270,25.8,84,0,13.3,449,False,2,101,340,8,0,2024-03-21,False,False,False,0.7572383073496659,0.22494432071269488,0.017817371937639197,0.0,Off-Peak,Thursday,March
2024-03-21 03:00:00,46,108,2,0,156,65,190,3,0,258,25.6,83,2,13.4,414,False,3,111,298,5,0,2024-03-21,False,False,False,0.7198067632850241,0.26811594202898553,0.012077294685990338,0.0,Off-Peak,Thursday,March
2024-03-21 04:00:00,34,120,2,0,156,63,204,5,0,272,25.5,83,2,13.4,428,False,4,97,324,7,0,2024-03-21,False,False,False,0.7570093457943925,0.2266355140186916,0.016355140186915886,0.0,Off-Peak,Thursday,March
2024-03-21 05:00:00,82,316,4,0,402,110,376,6,0,492,25.4,83,3,13.7,894,False,5,192,692,10,0,2024-03-21,False,False,False,0.7740492170022372,0.21476510067114093,0.011185682326621925,0.0,Shoulder,Thursday,March
2024-03-21 06:00:00,88,320,6,1,415,116,369,4,0,489,25.2,83,3,10.9,904,False,6,204,689,10,1,2024-03-21,False,False,False,0.7621681415929203,0.22566371681415928,0.011061946902654867,0.0011061946902654867,Shoulder,Thursday,March
2024-03-21 07:00:00,104,432,6,1,543,160,513,9,1,683,25.2,84,3,9.1,1226,False,7,264,945,15,2,2024-03-21,False,False,False,0.7707993474714518,0.21533442088091354,0.012234910277324634,0.0016313213703099511,Peak,Thursday,March
2024-03-21 08:00:00,124,372,5,2,503,154,508,8,1,671,25.3,86,3,9.1,1174,False,8,278,880,13,3,2024-03-21,False,False,False,0.7495741056218058,0.23679727427597955,0.011073253833049404,0.002555366269165247,Peak,Thursday,March
2024-03-21 09:00:00,75,294,4,0,373,111,412,6,0,529,27.9,76,3,15.5,902,False,9,186,706,10,0,2024-03-21,False,False,False,0.7827050997782705,0.20620842572062084,0.011086474501108648,0.0,Shoulder,Thursday,March
2024-03-21 10:00:00,90,298,3,1,392,112,401,4,0,517,29.2,70,2,16.1,909,False,10,202,699,7,1,2024-03-21,False,False,False,0.768976897689769,0.2222222222222222,0.007700770077007701,0.0011001100110011,Shoulder,Thursday,March
2024-03-21 11:00:00,110,384,6,1,501,145,517,11,1,674,30.9,64,3,18.2,1175,False,11,255,901,17,2,2024-03-21,False,False,False,0.7668085106382979,0.2170212765957447,0.01446808510638298,0.001702127659574468,Peak,Thursday,March
2024-03-21 12:00:00,117,407,5,2,531,150,505,12,1,668,31.8,61,2,15.6,1199,False,12,267,912,17,3,2024-03-21,False,False,False,0.7606338615512928,0.2226855713094245,0.014178482068390326,0.0025020850708924102,Peak,Thursday,March
2024-03-21 13:00:00,115,388,6,0,509,158,511,11,1,681,32.5,59,3,14.0,1190,False,13,273,899,17,1,2024-03-21,False,False,False,0.7554621848739496,0.22941176470588234,0.014285714285714285,0.0008403361344537816,Peak,Thursday,March
2024-03-21 14:00:00,83,295,6,1,385,113,418,6,0,537,34.0,54,2,10.6,922,False,14,196,713,12,1,2024-03-21,False,False,False,0.7733188720173536,0.21258134490238612,0.013015184381778741,0.0010845986984815619,Peak,Thursday,March
2024-03-21 15:00:00,84,289,6,0,379,107,399,5,0,511,34.3,51,3,1.8,890,False,15,191,688,11,0,2024-03-21,False,False,False,0.7730337078651686,0.21460674157303372,0.012359550561797753,0.0,Peak,Thursday,March
2024-03-21 16:00:00,66,321,4,1,392,115,392,5,0,512,28.0,78,65,3.8,904,False,16,181,713,9,1,2024-03-21,False,False,False,0.7887168141592921,0.2002212389380531,0.00995575221238938,0.0011061946902654867,Peak,Thursday,March
2024-03-21 17:00:00,99,402,5,1,507,161,515,11,2,689,27.1,84,63,6.8,1196,False,17,260,917,16,3,2024-03-21,False,False,False,0.7667224080267558,0.21739130434782608,0.013377926421404682,0.002508361204013378,Peak,Thursday,March
2024-03-21 18:00:00,105,433,7,1,546,151,513,9,1,674,27.6,84,51,4.0,1220,False,18,256,946,16,2,2024-03-21,False,False,False,0.7754098360655738,0.2098360655737705,0.013114754098360656,0.001639344262295082,Peak,Thursday,March
2024-03-21 19:00:00,102,421,6,0,529,151,517,8,1,677,27.6,83,3,9.3,1206,False,19,253,938,14,1,2024-03-21,False,False,False,0.7777777777777778,0.20978441127694858,0.011608623548922056,0.0008291873963515755,Peak,Thursday,March
2024-03-21 20:00:00,87,294,6,0,387,111,454,8,1,574,26.9,84,3,8.9,961,False,20,198,748,14,1,2024-03-21,False,False,False,0.7783558792924038,0.2060353798126951,0.014568158168574402,0.001040582726326743,Shoulder,Thursday,March
2024-03-21 21:00:00,85,319,3,0,407,123,450,8,1,582,27.0,88,2,10.7,989,False,21,208,769,11,1,2024-03-21,False,False,False,0.7775530839231547,0.2103134479271992,0.011122345803842264,0.0010111223458038423,Shoulder,Thursday,March
2024-03-21 22:00:00,70,307,5,1,383,108,444,6,1,559,26.5,85,3,13.5,942,False,22,178,751,11,2,2024-03-21,False,False,False,0.79723991507431,0.18895966029723993,0.01167728237791932,0.0021231422505307855,Shoulder,Thursday,March
2024-03-21 23:00:00,86,323,6,0,415,116,438,8,1,563,26.0,87,51,9.4,978,False,23,202,761,14,1,2024-03-21,False,False,False,0.778118609406953,0.2065439672801636,0.014314928425357873,0.0010224948875255625,Shoulder,Thursday,March
2024-03-22 00:00:00,34,118,2,1,155,49,186,4,0,239,26.0,86,51,9.8,394,False,0,83,304,6,1,2024-03-22,False,False,False,0.7715736040609137,0.21065989847715735,0.015228426395939087,0.0025380710659898475,Off-Peak,Friday,March
2024-03-22 01:00:00,35,118,3,0,156,50,186,4,0,240,25.8,87,3,11.0,396,False,1,85,304,7,0,2024-03-22,False,False,False,0.7676767676767676,0.21464646464646464,0.017676767676767676,0.0,Off-Peak,Friday,March
2024-03-22 02:00:00,34,118,2,1,155,50,186,4,0,240,25.7,87,3,11.7,395,False,2,84,304,6,1,2024-03-22,False,False,False,0.769620253164557,0.21265822784810126,0.015189873417721518,0.002531645569620253,Off-Peak,Friday,March
2024-03-22 03:00:00,35,119,2,0,156,49,185,4,0,238,25.6,86,3,12.7,394,False,3,84,304,6,0,2024-03-22,False,False,False,0.7715736040609137,0.2131979695431472,0.015228426395939087,0.0,Off-Peak,Friday,March
2024-03-22 04:00:00,35,118,2,1,156,50,185,4,0,239,25.4,86,3,14.0,395,False,4,85,303,6,1,2024-03-22,False,False,False,0.7670886075949367,0.21518987341772153,0.015189873417721518,0.002531645569620253,Off-Peak,Friday,March
2024-03-22 05:00:00,70,237,5,0,312,100,371,7,1,479,25.3,86,3,14.8,791,False,5,170,608,12,1,2024-03-22,False,False,False,0.7686472819216182,0.21491782553729458,0.015170670037926675,0.0012642225031605564,Shoulder,Friday,March
2024-03-22 06:00:00,69,237,4,0,310,100,371,7,0,478,25.1,86,0,14.5,788,False,6,169,608,11,0,2024-03-22,False,False,False,0.7715736040609137,0.21446700507614214,0.013959390862944163,0.0,Shoulder,Friday,March
2024-03-22 07:00:00,103,355,7,1,466,148,554,11,0,713,25.0,86,0,15.5,1179,False,7,251,909,18,1,2024-03-22,False,False,False,0.7709923664122137,0.21289228159457166,0.015267175572519083,0.0008481764206955047,Peak,Friday,March
2024-03-22 08:00:00,103,355,6,0,464,148,555,11,1,715,25.4,85,0,17.1,1179,False,8,251,910,17,1,2024-03-22,False,False,False,0.7718405428329093,0.21289228159457166,0.01441899915182358,0.0008481764206955047,Peak,Friday,March
2024-03-22 09:00:00,70,238,4,0,312,100,371,7,1,479,27.8,77,3,15.6,791,False,9,170,609,11,1,2024-03-22,False,False,False,0.7699115044247787,0.21491782553729458,0.01390644753476612,0.0012642225031605564,Shoulder,Friday,March
2024-03-22 10:00:00,69,238,5,0,312,100,371,7,1,479,29.1,71,3,18.1,791,False,10,169,609,12,1,2024-03-22,False,False,False,0.7699115044247787,0.213653603034134,0.015170670037926675,0.0012642225031605564,Shoulder,Friday,March
2024-03-22 11:00:00,103,355,6,0,464,149,555,11,1,716,30.9,61,2,17.3,1180,False,11,252,910,17,1,2024-03-22,False,False,False,0.7711864406779662,0.2135593220338983,0.01440677966101695,0.000847457627118644,Peak,Friday,March
2024-03-22 12:00:00,103,356,6,0,465,149,555,11,1,716,32.6,52,1,14.1,1181,False,12,252,911,17,1,2024-03-22,False,False,False,0.7713801862828111,0.21337849280270957,0.014394580863674851,0.000846740050804403,Peak,Friday,March
2024-03-22 13:00:00,104,356,6,0,466,149,555,11,0,715,33.7,49,3,11.3,1181,False,13,253,911,17,0,2024-03-22,False,False,False,0.7713801862828111,0.21422523285351397,0.014394580863674851,0.0,Peak,Friday,March
2024-03-22 14:00:00,69,238,4,1,312,100,371,7,1,479,34.6,46,3,5.8,791,False,14,169,609,11,2,2024-03-22,False,False,False,0.7699115044247787,0.213653603034134,0.01390644753476612,0.0025284450063211127,Peak,Friday,March
2024-03-22 15:00:00,69,237,4,1,311,100,371,7,1,479,33.9,48,2,4.3,790,False,15,169,608,11,2,2024-03-22,False,False,False,0.769620253164557,0.2139240506329114,0.013924050632911392,0.002531645569620253,Peak,Friday,March
2024-03-22 16:00:00,69,238,5,0,312,100,371,7,0,478,33.2,54,51,8.6,790,False,16,169,609,12,0,2024-03-22,False,False,False,0.7708860759493671,0.2139240506329114,0.015189873417721518,0.0,Peak,Friday,March
2024-03-22 17:00:00,104,356,6,1,467,149,555,12,1,717,31.9,61,1,11.4,1184,False,17,253,911,18,2,2024-03-22,False,False,False,0.7694256756756757,0.21368243243243243,0.015202702702702704,0.0016891891891891893,Peak,Friday,March
2024-03-22 18:00:00,103,356,6,0,465,149,555,11,0,715,30.7,64,0,10.2,1180,False,18,252,911,17,0,2024-03-22,False,False,False,0.7720338983050847,0.2135593220338983,0.01440677966101695,0.0,Peak,Friday,March
2024-03-22 19:00:00,104,356,6,0,466,149,555,11,0,715,29.3,72,2,8.0,1181,False,19,253,911,17,0,2024-03-22,False,False,False,0.7713801862828111,0.21422523285351397,0.014394580863674851,0.0,Peak,Friday,March
2024-03-22 20:00:00,70,237,4,1,312,99,371,7,1,478,28.7,78,53,3.6,790,False,20,169,608,11,2,2024-03-22,False,False,False,0.769620253164557,0.2139240506329114,0.013924050632911392,0.002531645569620253,Shoulder,Friday,March
2024-03-22 21:00:00,69,237,4,0,310,100,371,8,1,480,29.1,65,3,13.2,790,False,21,169,608,12,1,2024-03-22,False,False,False,0.769620253164557,0.2139240506329114,0.015189873417721518,0.0012658227848101266,Shoulder,Friday,March
2024-03-22 22:00:00,70,238,4,0,312,100,371,7,1,479,28.3,68,3,11.4,791,False,22,170,609,11,1,2024-03-22,False,False,False,0.7699115044247787,0.21491782553729458,0.01390644753476612,0.0012642225031605564,Shoulder,Friday,March
2024-03-22 23:00:00,69,238,4,0,311,99,370,8,1,478,27.4,71,3,8.9,789,False,23,168,608,12,1,2024-03-22,False,False,False,0.770595690747782,0.21292775665399238,0.015209125475285171,0.0012674271229404308,Shoulder,Friday,March
2024-03-23 00:00:00,22,75,1,0,98,45,149,3,0,197,27.0,71,3,12.2,295,True,0,67,224,4,0,2024-03-23,False,True,False,0.7593220338983051,0.2271186440677966,0.013559322033898305,0.0,Off-Peak,Saturday,March
2024-03-23 01:00:00,21,74,0,0,95,44,148,2,0,194,26.5,73,3,13.8,289,True,1,65,222,2,0,2024-03-23,False,True,False,0.7681660899653979,0.22491349480968859,0.006920415224913495,0.0,Off-Peak,Saturday,March
2024-03-23 02:00:00,21,75,0,1,97,44,149,2,1,196,26.2,76,3,13.8,293,True,2,65,224,2,2,2024-03-23,False,True,False,0.764505119453925,0.22184300341296928,0.006825938566552901,0.006825938566552901,Off-Peak,Saturday,March
2024-03-23 03:00:00,23,73,0,2,98,46,147,2,2,197,26.1,79,3,14.6,295,True,3,69,220,2,4,2024-03-23,False,True,False,0.7457627118644068,0.23389830508474577,0.006779661016949152,0.013559322033898305,Off-Peak,Saturday,March
2024-03-23 04:00:00,22,73,0,1,96,45,147,3,0,195,26.0,80,3,15.5,291,True,4,67,220,3,1,2024-03-23,False,True,False,0.7560137457044673,0.23024054982817868,0.010309278350515464,0.003436426116838488,Off-Peak,Saturday,March
2024-03-23 05:00:00,43,146,2,0,191,44,147,3,0,194,25.9,81,2,14.3,385,True,5,87,293,5,0,2024-03-23,False,True,False,0.7610389610389611,0.22597402597402597,0.012987012987012988,0.0,Shoulder,Saturday,March
2024-03-23 06:00:00,43,147,2,1,193,89,297,6,0,392,25.7,82,2,12.7,585,True,6,132,444,8,1,2024-03-23,False,True,False,0.7589743589743589,0.22564102564102564,0.013675213675213675,0.0017094017094017094,Shoulder,Saturday,March
2024-03-23 07:00:00,109,367,5,0,481,136,444,9,0,589,25.6,83,2,12.2,1070,True,7,245,811,14,0,2024-03-23,False,True,False,0.7579439252336448,0.22897196261682243,0.013084112149532711,0.0,Peak,Saturday,March
2024-03-23 08:00:00,108,366,5,1,480,135,443,10,0,588,26.0,82,3,9.2,1068,True,8,243,809,15,1,2024-03-23,False,True,False,0.7574906367041199,0.22752808988764045,0.014044943820224719,0.0009363295880149813,Peak,Saturday,March
2024-03-23 09:00:00,107,366,4,0,477,134,443,8,0,585,28.4,74,1,12.7,1062,True,9,241,809,12,0,2024-03-23,False,True,False,0.7617702448210922,0.22693032015065914,0.011299435028248588,0.0,Shoulder,Saturday,March
2024-03-23 10:00:00,43,146,2,1,192,89,295,7,0,391,30.0,68,1,12.4,583,True,10,132,441,9,1,2024-03-23,False,True,False,0.7564322469982847,0.22641509433962265,0.015437392795883362,0.0017152658662092624,Shoulder,Saturday,March
2024-03-23 11:00:00,107,366,4,1,478,134,443,8,2,587,31.5,61,2,11.8,1065,True,11,241,809,12,3,2024-03-23,False,True,False,0.7596244131455399,0.22629107981220659,0.011267605633802818,0.0028169014084507044,Peak,Saturday,March
2024-03-23 12:00:00,107,366,4,1,478,134,443,8,1,586,33.1,56,2,7.4,1064,True,12,241,809,12,2,2024-03-23,False,True,False,0.7603383458646616,0.22650375939849623,0.011278195488721804,0.0018796992481203006,Peak,Saturday,March
2024-03-23 13:00:00,107,367,6,0,480,134,445,9,0,588,34.3,52,3,2.6,1068,True,13,241,812,15,0,2024-03-23,False,True,False,0.7602996254681648,0.22565543071161048,0.014044943820224719,0.0,Peak,Saturday,March
2024-03-23 14:00:00,107,366,5,0,478,134,443,9,0,586,34.0,52,3,8.7,1064,True,14,241,809,14,0,2024-03-23,False,True,False,0.7603383458646616,0.22650375939849623,0.013157894736842105,0.0,Peak,Saturday,March
2024-03-23 15:00:00,43,146,1,0,190,89,295,5,0,389,29.3,78,61,12.5,579,True,15,132,441,6,0,2024-03-23,False,True,False,0.7616580310880829,0.22797927461139897,0.010362694300518135,0.0,Peak,Saturday,March
2024-03-23 16:00:00,43,147,1,0,191,89,296,5,0,390,31.7,64,51,3.8,581,True,16,132,443,6,0,2024-03-23,False,True,False,0.7624784853700516,0.22719449225473323,0.010327022375215147,0.0,Peak,Saturday,March
2024-03-23 17:00:00,107,367,6,0,480,134,446,8,0,588,30.7,69,53,10.0,1068,True,17,241,813,14,0,2024-03-23,False,True,False,0.7612359550561798,0.22565543071161048,0.013108614232209739,0.0,Peak,Saturday,March
2024-03-23 18:00:00,107,367,5,0,479,134,444,9,0,587,30.5,67,2,7.9,1066,True,18,241,811,14,0,2024-03-23,False,True,False,0.7607879924953096,0.22607879924953095,0.013133208255159476,0.0,Peak,Saturday,March
2024-03-23 19:00:00,107,367,4,0,478,134,444,8,0,586,30.0,69,3,3.0,1064,True,19,241,811,12,0,2024-03-23,False,True,False,0.7622180451127819,0.22650375939849623,0.011278195488721804,0.0,Peak,Saturday,March
2024-03-23 20:00:00,65,220,3,0,288,135,444,8,0,587,28.6,79,2,3.7,875,True,20,200,664,11,0,2024-03-23,False,True,False,0.7588571428571429,0.22857142857142856,0.012571428571428572,0.0,Shoulder,Saturday,March
2024-03-23 21:00:00,65,220,2,0,287,90,295,5,0,390,29.3,77,2,7.0,677,True,21,155,515,7,0,2024-03-23,False,True,False,0.7607090103397341,0.22895125553914328,0.0103397341211226,0.0,Shoulder,Saturday,March
2024-03-23 22:00:00,64,220,5,0,289,89,297,6,0,392,28.8,78,2,6.0,681,True,22,153,517,11,0,2024-03-23,False,True,False,0.7591776798825257,0.22466960352422907,0.016152716593245228,0.0,Shoulder,Saturday,March
2024-03-23 23:00:00,67,220,2,0,289,92,295,5,0,392,28.5,78,3,7.6,681,True,23,159,515,7,0,2024-03-23,False,True,False,0.7562408223201175,0.23348017621145375,0.010279001468428781,0.0,Shoulder,Saturday,March
2024-03-24 00:00:00,21,70,2,0,93,38,92,2,0,132,27.7,82,3,3.8,225,True,0,59,162,4,0,2024-03-24,False,False,False,0.72,0.26222222222222225,0.017777777777777778,0.0,Off-Peak,Sunday,March
2024-03-24 01:00:00,21,71,2,0,94,37,94,2,0,133,27.1,85,3,3.6,227,True,1,58,165,4,0,2024-03-24,False,False,False,0.7268722466960352,0.2555066079295154,0.01762114537444934,0.0,Off-Peak,Sunday,March
2024-03-24 02:00:00,21,71,1,1,94,37,93,2,1,133,26.8,84,3,7.1,227,True,2,58,164,3,2,2024-03-24,False,False,False,0.7224669603524229,0.2555066079295154,0.013215859030837005,0.00881057268722467,Off-Peak,Sunday,March
2024-03-24 03:00:00,21,71,1,0,93,37,97,2,0,136,26.4,80,1,10.0,229,True,3,58,168,3,0,2024-03-24,False,False,False,0.7336244541484717,0.25327510917030566,0.013100436681222707,0.0,Off-Peak,Sunday,March
2024-03-24 04:00:00,21,70,1,1,93,37,92,2,0,131,25.9,82,2,12.5,224,True,4,58,162,3,1,2024-03-24,False,False,False,0.7232142857142857,0.25892857142857145,0.013392857142857142,0.004464285714285714,Off-Peak,Sunday,March
2024-03-24 05:00:00,52,169,3,0,224,75,187,6,0,268,25.6,85,3,12.8,492,True,5,127,356,9,0,2024-03-24,False,False,False,0.7235772357723578,0.258130081300813,0.018292682926829267,0.0,Shoulder,Sunday,March
2024-03-24 06:00:00,54,169,2,1,226,76,185,4,0,265,25.4,86,3,13.8,491,True,6,130,354,6,1,2024-03-24,False,False,False,0.7209775967413442,0.26476578411405294,0.012219959266802444,0.002036659877800407,Shoulder,Sunday,March
2024-03-24 07:00:00,88,283,4,0,375,151,371,9,0,531,25.3,88,3,14.4,906,True,7,239,654,13,0,2024-03-24,False,False,False,0.7218543046357616,0.26379690949227375,0.01434878587196468,0.0,Peak,Sunday,March
2024-03-24 08:00:00,87,282,4,0,373,151,371,9,2,533,25.9,85,3,15.2,906,True,8,238,653,13,2,2024-03-24,False,False,False,0.7207505518763797,0.26269315673289184,0.01434878587196468,0.002207505518763797,Peak,Sunday,March
2024-03-24 09:00:00,87,282,4,1,374,151,371,9,2,533,28.7,76,3,14.0,907,True,9,238,653,13,3,2024-03-24,False,False,False,0.7199558985667034,0.2624035281146637,0.014332965821389196,0.0033076074972436605,Shoulder,Sunday,March
2024-03-24 10:00:00,53,171,2,0,226,76,185,5,0,266,30.3,69,3,12.1,492,True,10,129,356,7,0,2024-03-24,False,False,False,0.7235772357723578,0.2621951219512195,0.014227642276422764,0.0,Shoulder,Sunday,March
2024-03-24 11:00:00,87,283,6,1,377,152,371,9,0,532,31.9,60,3,10.1,909,True,11,239,654,15,1,2024-03-24,False,False,False,0.7194719471947195,0.2629262926292629,0.0165016501650165,0.0011001100110011,Peak,Sunday,March
2024-03-24 12:00:00,87,282,4,0,373,152,371,9,0,532,32.9,55,51,7.9,905,True,12,239,653,13,0,2024-03-24,False,False,False,0.7215469613259669,0.2640883977900553,0.014364640883977901,0.0,Peak,Sunday,March
2024-03-24 13:00:00,87,282,4,0,373,153,372,9,0,534,33.4,55,3,8.6,907,True,13,240,654,13,0,2024-03-24,False,False,False,0.721058434399118,0.26460859977949286,0.014332965821389196,0.0,Peak,Sunday,March
2024-03-24 14:00:00,88,282,4,2,376,151,371,10,0,532,32.8,60,51,12.8,908,True,14,239,653,14,2,2024-03-24,False,False,False,0.7191629955947136,0.263215859030837,0.015418502202643172,0.0022026431718061676,Peak,Sunday,March
2024-03-24 15:00:00,52,169,2,1,224,75,185,5,0,265,32.5,62,51,13.0,489,True,15,127,354,7,1,2024-03-24,False,False,False,0.7239263803680982,0.25971370143149286,0.014314928425357873,0.002044989775051125,Peak,Sunday,March
2024-03-24 16:00:00,52,169,2,1,224,77,185,7,0,269,32.3,61,3,13.0,493,True,16,129,354,9,1,2024-03-24,False,False,False,0.718052738336714,0.2616632860040568,0.018255578093306288,0.002028397565922921,Peak,Sunday,March
2024-03-24 17:00:00,87,282,4,0,373,151,371,9,0,531,32.2,60,3,5.1,904,True,17,238,653,13,0,2024-03-24,False,False,False,0.7223451327433629,0.26327433628318586,0.014380530973451327,0.0,Peak,Sunday,March
2024-03-24 18:00:00,88,282,4,2,376,151,371,10,1,533,31.1,66,3,9.9,909,True,18,239,653,14,3,2024-03-24,False,False,False,0.7183718371837183,0.2629262926292629,0.015401540154015401,0.0033003300330033004,Peak,Sunday,March
2024-03-24 19:00:00,88,282,4,1,375,152,371,9,1,533,29.6,72,3,7.2,908,True,19,240,653,13,2,2024-03-24,False,False,False,0.7191629955947136,0.2643171806167401,0.014317180616740088,0.0022026431718061676,Peak,Sunday,March
2024-03-24 20:00:00,88,284,5,0,377,152,371,9,0,532,28.6,83,3,0.4,909,True,20,240,655,14,0,2024-03-24,False,False,False,0.7205720572057206,0.264026402640264,0.015401540154015401,0.0,Shoulder,Sunday,March
2024-03-24 21:00:00,43,142,3,0,188,76,185,4,0,265,29.2,79,3,5.8,453,True,21,119,327,7,0,2024-03-24,False,False,False,0.7218543046357616,0.26269315673289184,0.01545253863134658,0.0,Shoulder,Sunday,March
2024-03-24 22:00:00,43,142,2,1,188,75,185,5,1,266,28.7,79,3,4.1,454,True,22,118,327,7,2,2024-03-24,False,False,False,0.7202643171806168,0.2599118942731278,0.015418502202643172,0.004405286343612335,Shoulder,Sunday,March
2024-03-24 23:00:00,43,144,2,0,189,76,185,5,0,266,28.3,79,3,6.6,455,True,23,119,329,7,0,2024-03-24,False,False,False,0.7230769230769231,0.26153846153846155,0.015384615384615385,0.0,Shoulder,Sunday,March
2024-03-25 00:00:00,24,82,1,1,108,35,121,1,0,157,27.6,81,3,4.0,265,False,0,59,203,2,1,2024-03-25,False,False,False,0.7660377358490567,0.22264150943396227,0.007547169811320755,0.0037735849056603774,Off-Peak,Monday,March
2024-03-25 01:00:00,24,83,1,0,108,37,117,3,0,157,27.1,82,3,4.3,265,False,1,61,200,4,0,2024-03-25,False,False,False,0.7547169811320755,0.23018867924528302,0.01509433962264151,0.0,Off-Peak,Monday,March
2024-03-25 02:00:00,24,83,2,0,109,29,131,1,0,161,27.1,78,3,9.6,270,False,2,53,214,3,0,2024-03-25,False,False,False,0.7925925925925926,0.1962962962962963,0.011111111111111112,0.0,Off-Peak,Monday,March
2024-03-25 03:00:00,24,83,1,1,109,27,133,0,0,160,26.7,81,3,12.6,269,False,3,51,216,1,1,2024-03-25,False,False,False,0.8029739776951673,0.1895910780669145,0.0037174721189591076,0.0037174721189591076,Off-Peak,Monday,March
2024-03-25 04:00:00,26,84,1,0,111,37,121,1,0,159,26.5,84,3,12.3,270,False,4,63,205,2,0,2024-03-25,False,False,False,0.7592592592592593,0.23333333333333334,0.007407407407407408,0.0,Off-Peak,Monday,March
2024-03-25 05:00:00,24,83,1,0,108,37,111,0,1,149,26.3,85,3,12.6,257,False,5,61,194,1,1,2024-03-25,False,False,False,0.754863813229572,0.23735408560311283,0.0038910505836575876,0.0038910505836575876,Shoulder,Monday,March
2024-03-25 06:00:00,50,165,2,0,217,115,336,9,0,460,26.2,86,3,13.6,677,False,6,165,501,11,0,2024-03-25,False,False,False,0.740029542097489,0.24372230428360414,0.01624815361890694,0.0,Shoulder,Monday,March
2024-03-25 07:00:00,126,412,5,0,543,197,595,11,0,803,26.1,87,3,13.1,1346,False,7,323,1007,16,0,2024-03-25,False,False,False,0.7481426448736999,0.2399702823179792,0.01188707280832095,0.0,Peak,Monday,March
2024-03-25 08:00:00,126,412,5,1,544,179,579,9,1,768,26.7,85,3,12.1,1312,False,8,305,991,14,2,2024-03-25,False,False,False,0.7553353658536586,0.23246951219512196,0.010670731707317074,0.001524390243902439,Peak,Monday,March
2024-03-25 09:00:00,124,412,5,0,541,175,634,12,0,821,28.7,79,2,10.3,1362,False,9,299,1046,17,0,2024-03-25,False,False,False,0.7679882525697503,0.2195301027900147,0.012481644640234948,0.0,Shoulder,Monday,March
2024-03-25 10:00:00,50,165,2,0,217,102,362,7,1,472,30.9,67,3,10.7,689,False,10,152,527,9,1,2024-03-25,False,False,False,0.7648766328011611,0.22060957910014514,0.013062409288824383,0.001451378809869376,Shoulder,Monday,March
2024-03-25 11:00:00,125,412,5,0,542,198,640,5,1,844,32.6,58,3,7.2,1386,False,11,323,1052,10,1,2024-03-25,False,False,True,0.759018759018759,0.23304473304473305,0.007215007215007215,0.0007215007215007215,Peak,Monday,March
2024-03-25 12:00:00,126,412,7,0,545,193,635,12,0,840,33.6,53,3,4.1,1385,False,12,319,1047,19,0,2024-03-25,False,False,True,0.755956678700361,0.23032490974729242,0.013718411552346571,0.0,Peak,Monday,March
2024-03-25 13:00:00,125,412,6,0,543,152,637,8,0,797,33.8,52,51,7.9,1340,False,13,277,1049,14,0,2024-03-25,False,False,False,0.7828358208955224,0.20671641791044776,0.010447761194029851,0.0,Peak,Monday,March
2024-03-25 14:00:00,125,412,6,0,543,199,620,10,0,829,33.3,55,53,11.8,1372,False,14,324,1032,16,0,2024-03-25,False,False,False,0.7521865889212828,0.23615160349854228,0.011661807580174927,0.0,Peak,Monday,March
2024-03-25 15:00:00,50,166,2,0,218,110,349,7,0,466,31.3,66,61,7.2,684,False,15,160,515,9,0,2024-03-25,False,False,False,0.7529239766081871,0.23391812865497075,0.013157894736842105,0.0,Peak,Monday,March
2024-03-25 16:00:00,49,166,3,0,218,99,357,3,0,459,32.1,63,51,7.2,677,False,16,148,523,6,0,2024-03-25,False,False,False,0.7725258493353028,0.21861152141802068,0.008862629246676515,0.0,Peak,Monday,March
2024-03-25 17:00:00,126,412,5,1,544,163,599,4,0,766,31.9,65,53,8.0,1310,False,17,289,1011,9,1,2024-03-25,False,False,False,0.7717557251908397,0.22061068702290076,0.006870229007633588,0.0007633587786259542,Peak,Monday,March
2024-03-25 18:00:00,126,412,5,0,543,154,639,6,0,799,30.9,72,3,4.5,1342,False,18,280,1051,11,0,2024-03-25,False,False,False,0.7831594634873323,0.20864381520119224,0.00819672131147541,0.0,Peak,Monday,March
2024-03-25 19:00:00,124,412,7,0,543,172,618,8,0,798,28.6,79,63,5.2,1341,False,19,296,1030,15,0,2024-03-25,False,False,False,0.7680835197613721,0.22073079791200598,0.011185682326621925,0.0,Peak,Monday,March
2024-03-25 20:00:00,126,413,5,0,544,178,599,11,0,788,28.1,84,3,3.9,1332,False,20,304,1012,16,0,2024-03-25,False,False,False,0.7597597597597597,0.22822822822822822,0.012012012012012012,0.0,Shoulder,Monday,March
2024-03-25 21:00:00,74,248,3,2,327,119,381,6,2,508,28.1,94,3,4.7,835,False,21,193,629,9,4,2024-03-25,False,False,False,0.7532934131736527,0.2311377245508982,0.010778443113772455,0.004790419161676647,Shoulder,Monday,March
2024-03-25 22:00:00,75,247,3,0,325,87,361,7,0,455,27.3,95,3,6.3,780,False,22,162,608,10,0,2024-03-25,False,False,False,0.7794871794871795,0.2076923076923077,0.01282051282051282,0.0,Shoulder,Monday,March
2024-03-25 23:00:00,76,247,3,1,327,116,403,0,0,519,26.7,96,51,6.4,846,False,23,192,650,3,1,2024-03-25,False,False,False,0.7683215130023641,0.22695035460992907,0.0035460992907801418,0.001182033096926714,Shoulder,Monday,March
2024-03-26 00:00:00,35,120,2,1,158,51,131,3,1,186,26.4,97,51,8.4,344,False,0,86,251,5,2,2024-03-26,False,False,False,0.7296511627906976,0.25,0.014534883720930232,0.005813953488372093,Off-Peak,Tuesday,March
2024-03-26 01:00:00,34,120,2,1,157,49,147,3,1,200,26.2,97,51,5.4,357,False,1,83,267,5,2,2024-03-26,False,False,False,0.7478991596638656,0.23249299719887956,0.014005602240896359,0.0056022408963585435,Off-Peak,Tuesday,March
2024-03-26 02:00:00,35,120,2,0,157,49,185,4,1,239,26.2,95,3,5.0,396,False,2,84,305,6,1,2024-03-26,False,False,False,0.7702020202020202,0.21212121212121213,0.015151515151515152,0.0025252525252525255,Off-Peak,Tuesday,March
2024-03-26 03:00:00,34,120,3,0,157,41,174,2,1,218,26.4,91,3,8.7,375,False,3,75,294,5,1,2024-03-26,False,False,False,0.784,0.2,0.013333333333333334,0.0026666666666666666,Off-Peak,Tuesday,March
2024-03-26 04:00:00,34,121,2,1,158,40,139,2,1,182,26.2,91,3,10.3,340,False,4,74,260,4,2,2024-03-26,False,False,False,0.7647058823529411,0.21764705882352942,0.011764705882352941,0.0058823529411764705,Off-Peak,Tuesday,March
2024-03-26 05:00:00,34,121,3,0,158,37,139,2,0,178,25.9,92,3,10.5,336,False,5,71,260,5,0,2024-03-26,False,False,False,0.7738095238095238,0.2113095238095238,0.01488095238095238,0.0,Shoulder,Tuesday,March
2024-03-26 06:00:00,70,241,4,1,316,70,319,4,0,393,25.7,93,3,9.7,709,False,6,140,560,8,1,2024-03-26,False,False,False,0.7898448519040903,0.19746121297602257,0.011283497884344146,0.0014104372355430183,Shoulder,Tuesday,March
2024-03-26 07:00:00,104,361,6,0,471,189,517,9,0,715,25.4,94,3,8.9,1186,False,7,293,878,15,0,2024-03-26,False,False,False,0.7403035413153457,0.24704890387858347,0.012647554806070826,0.0,Peak,Tuesday,March
2024-03-26 08:00:00,105,361,6,0,472,189,679,9,0,877,25.9,92,3,10.1,1349,False,8,294,1040,15,0,2024-03-26,False,False,False,0.770941438102298,0.21793921423276502,0.01111934766493699,0.0,Peak,Tuesday,March
2024-03-26 09:00:00,104,362,6,1,473,206,700,7,0,913,28.6,82,3,10.5,1386,False,9,310,1062,13,1,2024-03-26,False,False,True,0.7662337662337663,0.22366522366522368,0.00937950937950938,0.0007215007215007215,Shoulder,Tuesday,March
2024-03-26 10:00:00,69,242,4,1,316,96,370,5,0,471,30.6,72,3,11.7,787,False,10,165,612,9,1,2024-03-26,False,False,False,0.7776365946632783,0.2096569250317662,0.011435832274459974,0.0012706480304955528,Shoulder,Tuesday,March
2024-03-26 11:00:00,104,362,6,1,473,174,629,7,0,810,32.1,62,51,9.2,1283,False,11,278,991,13,1,2024-03-26,False,False,False,0.7724084177708496,0.2166796570537802,0.010132501948558068,0.000779423226812159,Peak,Tuesday,March
2024-03-26 12:00:00,105,362,7,1,475,146,528,7,0,681,33.2,56,51,5.8,1156,False,12,251,890,14,1,2024-03-26,False,False,False,0.7698961937716263,0.2171280276816609,0.012110726643598616,0.0008650519031141869,Peak,Tuesday,March
2024-03-26 13:00:00,105,362,6,1,474,182,661,7,0,850,33.0,56,3,7.1,1324,False,13,287,1023,13,1,2024-03-26,False,False,False,0.7726586102719033,0.21676737160120846,0.009818731117824773,0.0007552870090634441,Peak,Tuesday,March
2024-03-26 14:00:00,104,362,7,1,474,197,732,8,0,937,33.6,57,3,8.2,1411,False,14,301,1094,15,1,2024-03-26,False,False,True,0.7753366406803686,0.21332388377037562,0.010630758327427357,0.0007087172218284905,Peak,Tuesday,March
2024-03-26 15:00:00,69,241,4,0,314,87,269,5,0,361,31.9,70,61,15.6,675,False,15,156,510,9,0,2024-03-26,False,False,False,0.7555555555555555,0.2311111111111111,0.013333333333333334,0.0,Peak,Tuesday,March
2024-03-26 16:00:00,69,242,4,1,316,76,314,4,0,394,29.1,81,63,3.9,710,False,16,145,556,8,1,2024-03-26,False,False,False,0.7830985915492957,0.20422535211267606,0.011267605633802818,0.0014084507042253522,Peak,Tuesday,March
2024-03-26 17:00:00,105,361,6,1,473,165,648,9,0,822,29.8,75,51,6.9,1295,False,17,270,1009,15,1,2024-03-26,False,False,False,0.7791505791505792,0.2084942084942085,0.011583011583011582,0.0007722007722007722,Peak,Tuesday,March
2024-03-26 18:00:00,104,361,7,0,472,150,737,9,1,897,30.3,73,3,3.3,1369,False,18,254,1098,16,1,2024-03-26,False,False,False,0.802045288531775,0.18553688823959094,0.01168736303871439,0.0007304601899196494,Peak,Tuesday,March
2024-03-26 19:00:00,104,361,6,0,471,205,728,10,0,943,29.6,80,3,1.6,1414,False,19,309,1089,16,0,2024-03-26,False,False,True,0.7701555869872702,0.21852899575671852,0.011315417256011316,0.0,Peak,Tuesday,March
2024-03-26 20:00:00,104,362,6,1,473,203,685,10,1,899,28.6,84,3,3.0,1372,False,20,307,1047,16,2,2024-03-26,False,False,False,0.7631195335276968,0.22376093294460642,0.011661807580174927,0.0014577259475218659,Shoulder,Tuesday,March
2024-03-26 21:00:00,70,242,5,1,318,101,334,5,0,440,28.8,83,3,2.1,758,False,21,171,576,10,1,2024-03-26,False,False,False,0.7598944591029023,0.22559366754617413,0.013192612137203167,0.0013192612137203166,Shoulder,Tuesday,March
2024-03-26 22:00:00,69,241,4,1,315,90,337,4,0,431,27.5,92,3,6.3,746,False,22,159,578,8,1,2024-03-26,False,False,False,0.774798927613941,0.2131367292225201,0.010723860589812333,0.0013404825737265416,Shoulder,Tuesday,March
2024-03-26 23:00:00,69,242,4,0,315,86,298,4,0,388,27.0,89,3,8.1,703,False,23,155,540,8,0,2024-03-26,False,False,False,0.7681365576102418,0.22048364153627312,0.011379800853485065,0.0,Shoulder,Tuesday,March
2024-03-27 00:00:00,26,83,2,0,111,44,131,3,0,178,26.9,82,3,8.5,289,False,0,70,214,5,0,2024-03-27,False,False,False,0.740484429065744,0.2422145328719723,0.01730103806228374,0.0,Off-Peak,Wednesday,March
2024-03-27 01:00:00,25,84,0,0,109,47,110,5,0,162,26.3,82,3,10.1,271,False,1,72,194,5,0,2024-03-27,False,False,False,0.7158671586715867,0.2656826568265683,0.01845018450184502,0.0,Off-Peak,Wednesday,March
2024-03-27 02:00:00,28,74,0,0,102,36,106,2,0,144,25.7,88,3,10.9,246,False,2,64,180,2,0,2024-03-27,False,False,False,0.7317073170731707,0.2601626016260163,0.008130081300813009,0.0,Off-Peak,Wednesday,March
2024-03-27 03:00:00,25,74,0,0,99,35,119,1,0,155,25.5,90,3,10.8,254,False,3,60,193,1,0,2024-03-27,False,False,False,0.7598425196850394,0.23622047244094488,0.003937007874015748,0.0,Off-Peak,Wednesday,March
2024-03-27 04:00:00,24,68,0,1,93,55,122,3,0,180,25.3,92,3,9.8,273,False,4,79,190,3,1,2024-03-27,False,False,False,0.6959706959706959,0.2893772893772894,0.01098901098901099,0.003663003663003663,Off-Peak,Wednesday,March
2024-03-27 05:00:00,17,72,3,0,92,48,110,2,2,162,25.0,93,3,10.4,254,False,5,65,182,5,2,2024-03-27,False,False,False,0.7165354330708661,0.2559055118110236,0.01968503937007874,0.007874015748031496,Shoulder,Wednesday,March
2024-03-27 06:00:00,76,220,5,0,301,91,313,7,0,411,24.8,95,3,9.2,712,False,6,167,533,12,0,2024-03-27,False,False,False,0.7485955056179775,0.2345505617977528,0.016853932584269662,0.0,Shoulder,Wednesday,March
2024-03-27 07:00:00,105,423,7,0,535,190,625,11,1,827,24.6,96,3,8.2,1362,False,7,295,1048,18,1,2024-03-27,False,False,False,0.7694566813509545,0.21659324522760645,0.013215859030837005,0.0007342143906020558,Peak,Wednesday,March
2024-03-27 08:00:00,112,407,4,0,523,200,650,9,1,860,25.4,94,3,8.4,1383,False,8,312,1057,13,1,2024-03-27,False,False,True,0.7642805495300072,0.22559652928416485,0.009399855386840203,0.0007230657989877079,Peak,Wednesday,March
2024-03-27 09:00:00,122,395,7,0,524,180,635,11,0,826,29.0,81,2,13.0,1350,False,9,302,1030,18,0,2024-03-27,False,False,False,0.762962962962963,0.2237037037037037,0.013333333333333334,0.0,Shoulder,Wednesday,March
2024-03-27 10:00:00,80,246,4,1,331,89,330,5,2,426,30.8,72,2,11.4,757,False,10,169,576,9,3,2024-03-27,False,False,False,0.760898282694848,0.22324966974900926,0.011889035667107,0.003963011889035667,Shoulder,Wednesday,March
2024-03-27 11:00:00,104,417,5,0,526,173,700,5,2,880,32.8,61,2,12.2,1406,False,11,277,1117,10,2,2024-03-27,False,False,True,0.794452347083926,0.19701280227596016,0.007112375533428165,0.001422475106685633,Peak,Wednesday,March
2024-03-27 12:00:00,104,415,7,1,527,199,694,11,0,904,33.9,56,51,10.1,1431,False,12,303,1109,18,1,2024-03-27,False,False,True,0.7749825296995109,0.21174004192872117,0.012578616352201259,0.0006988120195667365,Peak,Wednesday,March
2024-03-27 13:00:00,137,450,7,1,595,194,697,8,0,899,33.0,58,3,8.0,1494,False,13,331,1147,15,1,2024-03-27,False,False,True,0.7677376171352075,0.2215528781793842,0.010040160642570281,0.0006693440428380187,Peak,Wednesday,March
2024-03-27 14:00:00,126,388,9,0,523,154,680,10,0,844,29.6,80,55,12.8,1367,False,14,280,1068,19,0,2024-03-27,False,False,False,0.7812728602779809,0.20482809070958302,0.013899049012435992,0.0,Peak,Wednesday,March
2024-03-27 15:00:00,82,240,5,0,327,105,359,6,0,470,30.1,74,51,11.7,797,False,15,187,599,11,0,2024-03-27,False,False,False,0.7515683814303639,0.23462986198243413,0.013801756587202008,0.0,Peak,Wednesday,March
2024-03-27 16:00:00,78,244,2,0,324,93,316,2,0,411,31.2,67,51,8.7,735,False,16,171,560,4,0,2024-03-27,False,False,False,0.7619047619047619,0.23265306122448978,0.005442176870748299,0.0,Peak,Wednesday,March
2024-03-27 17:00:00,106,370,8,0,484,160,650,4,1,815,30.4,74,3,13.9,1299,False,17,266,1020,12,1,2024-03-27,False,False,False,0.7852193995381063,0.20477290223248654,0.009237875288683603,0.0007698229407236335,Peak,Wednesday,March
2024-03-27 18:00:00,117,412,10,0,539,167,692,6,1,866,29.8,77,3,10.8,1405,False,18,284,1104,16,1,2024-03-27,False,False,True,0.7857651245551601,0.20213523131672598,0.011387900355871887,0.0007117437722419929,Peak,Wednesday,March
2024-03-27 19:00:00,109,403,8,0,520,159,671,7,0,837,29.1,77,51,9.5,1357,False,19,268,1074,15,0,2024-03-27,False,False,False,0.7914517317612381,0.19749447310243184,0.01105379513633014,0.0,Peak,Wednesday,March
2024-03-27 20:00:00,101,394,11,0,506,179,651,10,1,841,26.9,87,3,12.1,1347,False,20,280,1045,21,1,2024-03-27,False,False,False,0.7757980697847068,0.20786933927245732,0.015590200445434299,0.0007423904974016332,Shoulder,Wednesday,March
2024-03-27 21:00:00,48,182,3,0,233,94,345,5,2,446,28.2,88,3,7.6,679,False,21,142,527,8,2,2024-03-27,False,False,False,0.7761413843888071,0.20913107511045656,0.011782032400589101,0.0029455081001472753,Shoulder,Wednesday,March
2024-03-27 22:00:00,42,165,1,1,209,82,368,6,0,456,27.1,94,51,3.2,665,False,22,124,533,7,1,2024-03-27,False,False,False,0.8015037593984963,0.18646616541353384,0.010526315789473684,0.0015037593984962407,Shoulder,Wednesday,March
2024-03-27 23:00:00,45,164,4,0,213,105,326,0,0,431,26.7,95,53,1.1,644,False,23,150,490,4,0,2024-03-27,False,False,False,0.7608695652173914,0.2329192546583851,0.006211180124223602,0.0,Shoulder,Wednesday,March
2024-03-28 00:00:00,30,98,2,1,131,50,181,2,0,233,26.3,98,3,3.7,364,False,0,80,279,4,1,2024-03-28,False,True,False,0.7664835164835165,0.21978021978021978,0.01098901098901099,0.0027472527472527475,Off-Peak,Thursday,March
2024-03-28 01:00:00,30,94,3,0,127,52,183,2,0,237,26.0,97,3,5.8,364,False,1,82,277,5,0,2024-03-28,False,True,False,0.760989010989011,0.22527472527472528,0.013736263736263736,0.0,Off-Peak,Thursday,March
2024-03-28 02:00:00,28,108,3,1,140,35,176,2,0,213,25.9,95,3,5.2,353,False,2,63,284,5,1,2024-03-28,False,True,False,0.8045325779036827,0.17847025495750707,0.014164305949008499,0.0028328611898017,Off-Peak,Thursday,March
2024-03-28 03:00:00,35,77,2,0,114,44,147,2,0,193,25.8,91,3,6.2,307,False,3,79,224,4,0,2024-03-28,False,True,False,0.7296416938110749,0.25732899022801303,0.013029315960912053,0.0,Off-Peak,Thursday,March
2024-03-28 04:00:00,32,106,3,0,141,38,119,2,0,159,25.4,92,3,4.7,300,False,4,70,225,5,0,2024-03-28,False,True,False,0.75,0.23333333333333334,0.016666666666666666,0.0,Off-Peak,Thursday,March
2024-03-28 05:00:00,38,82,4,0,124,52,176,2,0,230,25.1,93,3,4.9,354,False,5,90,258,6,0,2024-03-28,False,True,False,0.7288135593220338,0.2542372881355932,0.01694915254237288,0.0,Shoulder,Thursday,March
2024-03-28 06:00:00,77,213,2,1,293,82,303,4,0,389,24.9,94,3,4.4,682,False,6,159,516,6,1,2024-03-28,False,True,False,0.7565982404692082,0.23313782991202345,0.008797653958944282,0.001466275659824047,Shoulder,Thursday,March
2024-03-28 07:00:00,105,505,5,1,616,214,782,11,1,1008,25.0,94,3,7.3,1624,False,7,319,1287,16,2,2024-03-28,False,True,True,0.7924876847290641,0.19642857142857142,0.009852216748768473,0.0012315270935960591,Peak,Thursday,March
2024-03-28 08:00:00,137,397,5,1,540,194,833,11,1,1039,25.7,92,2,8.7,1579,False,8,331,1230,16,2,2024-03-28,False,True,True,0.77897403419886,0.20962634578847372,0.01013299556681444,0.001266624445851805,Peak,Thursday,March
2024-03-28 09:00:00,134,420,5,1,560,215,820,10,1,1046,28.2,84,3,12.2,1606,False,9,349,1240,15,2,2024-03-28,False,True,True,0.772104607721046,0.21731008717310088,0.00933997509339975,0.0012453300124533001,Shoulder,Thursday,March
2024-03-28 10:00:00,55,163,2,0,220,74,301,4,0,379,30.1,73,51,13.3,599,False,10,129,464,6,0,2024-03-28,False,True,False,0.7746243739565943,0.21535893155258765,0.01001669449081803,0.0,Shoulder,Thursday,March
2024-03-28 11:00:00,133,431,4,1,569,215,781,10,1,1007,31.6,65,51,10.3,1576,False,11,348,1212,14,2,2024-03-28,False,True,True,0.7690355329949239,0.22081218274111675,0.008883248730964468,0.0012690355329949238,Peak,Thursday,March
2024-03-28 12:00:00,131,494,5,1,631,198,791,10,1,1000,33.0,57,3,7.6,1631,False,12,329,1285,15,2,2024-03-28,False,True,True,0.7878602084610669,0.2017167381974249,0.009196811771919068,0.001226241569589209,Peak,Thursday,March
2024-03-28 13:00:00,112,525,6,1,644,194,789,10,1,994,33.6,54,3,6.1,1638,False,13,306,1314,16,2,2024-03-28,False,True,True,0.8021978021978022,0.18681318681318682,0.009768009768009768,0.001221001221001221,Peak,Thursday,March
2024-03-28 14:00:00,123,461,6,1,591,80,300,5,1,386,32.2,63,53,12.3,977,False,14,203,761,11,2,2024-03-28,False,True,False,0.7789150460593655,0.20777891504605936,0.011258955987717503,0.0020470829068577278,Peak,Thursday,March
2024-03-28 15:00:00,54,166,2,0,222,87,284,4,0,375,30.7,72,51,10.4,597,False,15,141,450,6,0,2024-03-28,False,True,False,0.7537688442211056,0.23618090452261306,0.010050251256281407,0.0,Peak,Thursday,March
2024-03-28 16:00:00,59,214,2,0,275,77,312,4,1,394,31.0,67,51,7.1,669,False,16,136,526,6,1,2024-03-28,False,True,False,0.7862481315396114,0.20328849028400597,0.008968609865470852,0.0014947683109118087,Peak,Thursday,March
2024-03-28 17:00:00,120,377,5,1,503,207,842,11,1,1061,30.9,68,51,6.4,1564,False,17,327,1219,16,2,2024-03-28,False,True,True,0.7794117647058824,0.20907928388746802,0.010230179028132993,0.0012787723785166241,Peak,Thursday,March
2024-03-28 18:00:00,128,485,5,1,619,204,817,10,1,1032,30.5,71,3,10.2,1651,False,18,332,1302,15,2,2024-03-28,False,True,True,0.7886129618413082,0.20109024833434283,0.009085402786190187,0.0012113870381586917,Peak,Thursday,March
2024-03-28 19:00:00,133,521,5,1,660,201,838,10,2,1051,29.6,75,3,8.2,1711,False,19,334,1359,15,3,2024-03-28,False,True,True,0.7942723553477499,0.1952074810052601,0.008766803039158387,0.0017533606078316774,Peak,Thursday,March
2024-03-28 20:00:00,121,376,5,1,503,124,491,7,1,623,27.9,80,3,10.3,1126,False,20,245,867,12,2,2024-03-28,False,True,False,0.7699822380106572,0.21758436944937834,0.010657193605683837,0.0017761989342806395,Shoulder,Thursday,March
2024-03-28 21:00:00,78,258,3,1,340,117,461,6,1,585,27.6,80,3,8.0,925,False,21,195,719,9,2,2024-03-28,False,True,False,0.7772972972972974,0.21081081081081082,0.00972972972972973,0.002162162162162162,Shoulder,Thursday,March
2024-03-28 22:00:00,74,235,3,1,313,127,484,7,1,619,27.3,79,3,9.2,932,False,22,201,719,10,2,2024-03-28,False,True,False,0.7714592274678111,0.21566523605150215,0.01072961373390558,0.002145922746781116,Shoulder,Thursday,March
2024-03-28 23:00:00,66,328,3,1,398,110,432,6,2,550,26.8,81,3,6.5,948,False,23,176,760,9,3,2024-03-28,False,True,False,0.8016877637130801,0.18565400843881857,0.00949367088607595,0.0031645569620253164,Shoulder,Thursday,March
2024-03-29 00:00:00,27,96,1,0,124,93,208,4,0,305,26.6,83,3,7.6,429,False,0,120,304,5,0,2024-03-29,False,True,False,0.7086247086247086,0.27972027972027974,0.011655011655011656,0.0,Off-Peak,Friday,March
2024-03-29 01:00:00,42,150,2,1,195,12,250,0,0,262,26.3,85,3,8.8,457,False,1,54,400,2,1,2024-03-29,False,True,False,0.87527352297593,0.11816192560175055,0.00437636761487965,0.002188183807439825,Off-Peak,Friday,March
2024-03-29 02:00:00,37,130,1,0,168,105,125,3,0,233,26.3,86,3,7.3,401,False,2,142,255,4,0,2024-03-29,False,True,False,0.6359102244389028,0.3541147132169576,0.00997506234413965,0.0,Off-Peak,Friday,March
2024-03-29 03:00:00,32,117,4,1,154,12,415,4,0,431,26.0,88,3,5.8,585,False,3,44,532,8,1,2024-03-29,False,True,False,0.9094017094017094,0.07521367521367521,0.013675213675213675,0.0017094017094017094,Off-Peak,Friday,March
2024-03-29 04:00:00,22,75,0,0,97,70,416,3,0,489,25.7,90,1,5.5,586,False,4,92,491,3,0,2024-03-29,False,True,False,0.8378839590443686,0.15699658703071673,0.005119453924914676,0.0,Off-Peak,Friday,March
2024-03-29 05:00:00,21,75,1,0,97,47,83,3,0,133,25.5,91,3,6.1,230,False,5,68,158,4,0,2024-03-29,False,True,False,0.6869565217391305,0.2956521739130435,0.017391304347826087,0.0,Shoulder,Friday,March
2024-03-29 06:00:00,56,192,2,0,250,35,250,1,1,287,25.4,92,3,7.6,537,False,6,91,442,3,1,2024-03-29,False,True,False,0.8230912476722533,0.16945996275605213,0.00558659217877095,0.00186219739292365,Shoulder,Friday,March
2024-03-29 07:00:00,126,449,6,0,581,291,416,7,1,715,25.2,93,3,6.9,1296,False,7,417,865,13,1,2024-03-29,False,True,False,0.6674382716049383,0.32175925925925924,0.010030864197530864,0.0007716049382716049,Peak,Friday,March
2024-03-29 08:00:00,120,425,5,0,550,245,166,9,1,421,25.9,90,3,7.9,971,False,8,365,591,14,1,2024-03-29,False,True,False,0.6086508753861998,0.37590113285272914,0.014418125643666324,0.0010298661174047373,Peak,Friday,March
2024-03-29 09:00:00,122,434,6,1,563,23,790,5,1,819,28.1,83,2,8.4,1382,False,9,145,1224,11,2,2024-03-29,False,True,True,0.8856729377713459,0.1049204052098408,0.007959479015918957,0.001447178002894356,Shoulder,Friday,March
2024-03-29 10:00:00,52,187,2,0,241,12,42,0,1,55,30.1,72,1,12.5,296,False,10,64,229,2,1,2024-03-29,False,True,False,0.7736486486486487,0.21621621621621623,0.006756756756756757,0.0033783783783783786,Shoulder,Friday,March
2024-03-29 11:00:00,130,459,5,1,595,93,1248,12,0,1353,31.8,59,1,12.2,1948,False,11,223,1707,17,1,2024-03-29,False,True,True,0.8762833675564682,0.11447638603696099,0.008726899383983572,0.000513347022587269,Peak,Friday,March
2024-03-29 12:00:00,125,445,5,0,575,82,416,6,0,504,32.7,54,0,12.3,1079,False,12,207,861,11,0,2024-03-29,False,True,False,0.7979610750695088,0.19184430027803523,0.010194624652455977,0.0,Peak,Friday,March
2024-03-29 13:00:00,109,389,5,1,504,315,790,12,1,1118,32.5,58,51,15.3,1622,False,13,424,1179,17,2,2024-03-29,False,True,True,0.7268803945745993,0.26140567200986436,0.010480887792848335,0.0012330456226880395,Peak,Friday,March
2024-03-29 14:00:00,109,387,4,1,501,11,915,7,0,933,31.6,66,53,17.4,1434,False,14,120,1302,11,1,2024-03-29,False,True,True,0.9079497907949791,0.08368200836820083,0.007670850767085077,0.000697350069735007,Peak,Friday,March
2024-03-29 15:00:00,58,207,2,1,268,233,541,2,0,776,31.3,69,51,18.4,1044,False,15,291,748,4,1,2024-03-29,False,True,False,0.7164750957854407,0.27873563218390807,0.0038314176245210726,0.0009578544061302681,Peak,Friday,March
2024-03-29 16:00:00,62,221,3,0,286,58,541,6,0,605,31.1,70,51,18.3,891,False,16,120,762,9,0,2024-03-29,False,True,False,0.8552188552188552,0.13468013468013468,0.010101010101010102,0.0,Peak,Friday,March
2024-03-29 17:00:00,117,419,5,1,542,93,957,5,1,1056,31.2,70,2,15.6,1598,False,17,210,1376,10,2,2024-03-29,False,True,True,0.8610763454317898,0.13141426783479349,0.006257822277847309,0.0012515644555694619,Peak,Friday,March
2024-03-29 18:00:00,117,408,4,0,529,58,291,9,1,359,30.4,74,3,11.6,888,False,18,175,699,13,1,2024-03-29,False,True,False,0.7871621621621622,0.19707207207207209,0.01463963963963964,0.0011261261261261261,Peak,Friday,March
2024-03-29 19:00:00,112,396,4,0,512,186,124,13,0,323,29.8,75,3,12.0,835,False,19,298,520,17,0,2024-03-29,False,True,False,0.6227544910179641,0.3568862275449102,0.02035928143712575,0.0,Peak,Friday,March
2024-03-29 20:00:00,120,426,5,0,551,256,790,12,1,1059,27.4,87,65,7.7,1610,False,20,376,1216,17,1,2024-03-29,False,True,True,0.7552795031055901,0.23354037267080746,0.010559006211180125,0.0006211180124223603,Shoulder,Friday,March
2024-03-29 21:00:00,56,201,4,0,261,47,332,7,2,388,28.4,83,3,10.7,649,False,21,103,533,11,2,2024-03-29,False,True,False,0.8212634822804314,0.15870570107858242,0.01694915254237288,0.0030816640986132513,Shoulder,Friday,March
2024-03-29 22:00:00,63,220,2,0,285,221,166,2,1,390,28.0,83,3,7.8,675,False,22,284,386,4,1,2024-03-29,False,True,False,0.5718518518518518,0.42074074074074075,0.005925925925925926,0.0014814814814814814,Shoulder,Friday,March
2024-03-29 23:00:00,64,229,2,0,295,82,416,6,1,505,27.8,84,3,9.8,800,False,23,146,645,8,1,2024-03-29,False,True,False,0.80625,0.1825,0.01,0.00125,Shoulder,Friday,March
2024-03-30 00:00:00,21,70,1,0,92,34,64,1,0,99,27.5,85,3,9.5,191,True,0,55,134,2,0,2024-03-30,False,False,False,0.7015706806282722,0.2879581151832461,0.010471204188481676,0.0,Off-Peak,Saturday,March
2024-03-30 01:00:00,18,75,1,1,95,71,99,3,0,173,27.3,83,3,9.9,268,True,1,89,174,4,1,2024-03-30,False,False,False,0.6492537313432836,0.332089552238806,0.014925373134328358,0.0037313432835820895,Off-Peak,Saturday,March
2024-03-30 02:00:00,25,69,1,0,95,54,167,3,0,224,27.0,83,3,6.9,319,True,2,79,236,4,0,2024-03-30,False,False,False,0.7398119122257053,0.2476489028213166,0.012539184952978056,0.0,Off-Peak,Saturday,March
2024-03-30 03:00:00,19,88,1,0,108,23,59,3,0,85,26.5,86,3,6.1,193,True,3,42,147,4,0,2024-03-30,False,False,False,0.7616580310880829,0.21761658031088082,0.02072538860103627,0.0,Off-Peak,Saturday,March
2024-03-30 04:00:00,19,75,1,0,95,56,37,2,0,95,26.1,89,3,4.7,190,True,4,75,112,3,0,2024-03-30,False,False,False,0.5894736842105263,0.39473684210526316,0.015789473684210527,0.0,Off-Peak,Saturday,March
2024-03-30 05:00:00,74,207,3,0,284,71,152,0,0,223,25.7,92,3,4.1,507,True,5,145,359,3,0,2024-03-30,False,False,False,0.7080867850098619,0.2859960552268245,0.005917159763313609,0.0,Shoulder,Saturday,March
2024-03-30 06:00:00,62,216,2,0,280,3,186,0,1,190,25.4,94,3,3.6,470,True,6,65,402,2,1,2024-03-30,False,False,False,0.8553191489361702,0.13829787234042554,0.00425531914893617,0.002127659574468085,Shoulder,Saturday,March
2024-03-30 07:00:00,127,339,5,1,472,14,493,1,0,508,25.4,95,3,5.5,980,True,7,141,832,6,1,2024-03-30,False,False,False,0.8489795918367347,0.14387755102040817,0.006122448979591836,0.0010204081632653062,Peak,Saturday,March
2024-03-30 08:00:00,119,328,4,1,452,331,378,3,0,712,26.2,92,3,5.7,1164,True,8,450,706,7,1,2024-03-30,False,False,False,0.6065292096219931,0.3865979381443299,0.006013745704467354,0.000859106529209622,Peak,Saturday,March
2024-03-30 09:00:00,100,399,4,1,504,156,88,12,2,258,28.4,83,3,4.6,762,True,9,256,487,16,3,2024-03-30,False,False,False,0.6391076115485564,0.3359580052493438,0.02099737532808399,0.003937007874015748,Shoulder,Saturday,March
2024-03-30 10:00:00,53,204,3,0,260,77,133,1,0,211,29.9,75,51,4.5,471,True,10,130,337,4,0,2024-03-30,False,False,False,0.7154989384288747,0.2760084925690021,0.008492569002123142,0.0,Shoulder,Saturday,March
2024-03-30 11:00:00,130,403,4,0,537,23,50,1,1,75,31.3,66,51,3.6,612,True,11,153,453,5,1,2024-03-30,False,False,False,0.7401960784313726,0.25,0.008169934640522876,0.0016339869281045752,Peak,Saturday,March
2024-03-30 12:00:00,92,434,4,0,530,62,980,14,1,1057,31.8,63,51,11.5,1587,True,12,154,1414,18,1,2024-03-30,False,False,True,0.8909892879647133,0.09703843730308759,0.011342155009451797,0.000630119722747322,Peak,Saturday,March
2024-03-30 13:00:00,120,395,4,0,519,303,249,2,1,555,28.1,83,63,12.5,1074,True,13,423,644,6,1,2024-03-30,False,False,False,0.5996275605214153,0.39385474860335196,0.00558659217877095,0.000931098696461825,Peak,Saturday,March
2024-03-30 14:00:00,66,193,2,0,261,296,855,9,0,1160,29.3,72,55,8.6,1421,True,14,362,1048,11,0,2024-03-30,False,False,True,0.7375087966220971,0.2547501759324419,0.007741027445460943,0.0,Peak,Saturday,March
2024-03-30 15:00:00,73,241,3,1,318,162,67,7,0,236,30.2,74,53,3.7,554,True,15,235,308,10,1,2024-03-30,False,False,False,0.555956678700361,0.42418772563176893,0.018050541516245487,0.0018050541516245488,Peak,Saturday,March
2024-03-30 16:00:00,71,201,3,0,275,153,40,3,0,196,30.5,74,51,2.3,471,True,16,224,241,6,0,2024-03-30,False,False,False,0.5116772823779193,0.47558386411889597,0.012738853503184714,0.0,Peak,Saturday,March
2024-03-30 17:00:00,116,381,5,0,502,293,723,0,0,1016,29.7,75,51,4.1,1518,True,17,409,1104,5,0,2024-03-30,False,False,True,0.7272727272727273,0.269433465085639,0.0032938076416337285,0.0,Peak,Saturday,March
2024-03-30 18:00:00,109,406,4,0,519,92,999,7,0,1098,26.3,89,63,18.1,1617,True,18,201,1405,11,0,2024-03-30,False,False,True,0.8688930117501547,0.12430426716141002,0.006802721088435374,0.0,Peak,Saturday,March
2024-03-30 19:00:00,123,382,4,1,510,13,333,4,1,351,25.6,93,63,8.7,861,True,19,136,715,8,2,2024-03-30,False,False,False,0.8304297328687572,0.15795586527293845,0.009291521486643438,0.0023228803716608595,Peak,Saturday,March
2024-03-30 20:00:00,37,175,2,0,214,80,924,12,2,1018,25.3,95,61,8.3,1232,True,20,117,1099,14,2,2024-03-30,False,False,False,0.8920454545454546,0.09496753246753246,0.011363636363636364,0.0016233766233766235,Shoulder,Saturday,March
2024-03-30 21:00:00,39,167,1,0,207,37,368,7,1,413,26.0,91,3,6.2,620,True,21,76,535,8,1,2024-03-30,False,False,False,0.8629032258064516,0.12258064516129032,0.012903225806451613,0.0016129032258064516,Shoulder,Saturday,March
2024-03-30 22:00:00,47,135,2,1,185,32,188,1,1,222,26.2,90,3,6.3,407,True,22,79,323,3,2,2024-03-30,False,False,False,0.7936117936117936,0.1941031941031941,0.007371007371007371,0.004914004914004914,Shoulder,Saturday,March
2024-03-30 23:00:00,41,139,2,0,182,55,477,6,1,539,25.7,93,3,4.3,721,True,23,96,616,8,1,2024-03-30,False,False,False,0.8543689320388349,0.13314840499306518,0.011095700416088766,0.0013869625520110957,Shoulder,Saturday,March
2024-03-31 00:00:00,24,77,0,0,101,38,116,0,0,154,25.7,93,3,4.8,255,True,0,62,193,0,0,2024-03-31,False,False,False,0.7568627450980392,0.24313725490196078,0.0,0.0,Off-Peak,Sunday,March
2024-03-31 01:00:00,35,81,1,0,117,44,121,1,1,167,25.2,95,3,4.8,284,True,1,79,202,2,1,2024-03-31,False,False,False,0.7112676056338029,0.27816901408450706,0.007042253521126761,0.0035211267605633804,Off-Peak,Sunday,March
2024-03-31 02:00:00,29,67,0,0,96,40,119,2,1,162,25.2,95,3,4.0,258,True,2,69,186,2,1,2024-03-31,False,False,False,0.7209302325581395,0.26744186046511625,0.007751937984496124,0.003875968992248062,Off-Peak,Sunday,March
2024-03-31 03:00:00,27,98,1,0,126,32,100,0,0,132,25.2,94,3,4.4,258,True,3,59,198,1,0,2024-03-31,False,False,False,0.7674418604651163,0.22868217054263565,0.003875968992248062,0.0,Off-Peak,Sunday,March
2024-03-31 04:00:00,21,96,2,0,119,30,97,1,0,128,24.6,96,3,5.5,247,True,4,51,193,3,0,2024-03-31,False,False,False,0.7813765182186235,0.20647773279352227,0.012145748987854251,0.0,Off-Peak,Sunday,March
2024-03-31 05:00:00,21,80,0,0,101,23,109,2,0,134,24.8,95,3,4.3,235,True,5,44,189,2,0,2024-03-31,False,False,False,0.8042553191489362,0.18723404255319148,0.00851063829787234,0.0,Shoulder,Sunday,March
2024-03-31 06:00:00,44,155,1,0,200,81,213,1,0,295,24.8,94,3,5.7,495,True,6,125,368,2,0,2024-03-31,False,False,False,0.7434343434343434,0.25252525252525254,0.00404040404040404,0.0,Shoulder,Sunday,March
2024-03-31 07:00:00,89,332,4,0,425,155,400,2,0,557,24.8,95,51,1.6,982,True,7,244,732,6,0,2024-03-31,False,False,False,0.745417515274949,0.2484725050916497,0.006109979633401222,0.0,Peak,Sunday,March
2024-03-31 08:00:00,117,329,1,0,447,165,383,3,1,552,25.5,91,51,3.1,999,True,8,282,712,4,1,2024-03-31,False,False,False,0.7127127127127127,0.2822822822822823,0.004004004004004004,0.001001001001001001,Peak,Sunday,March
2024-03-31 09:00:00,109,317,1,0,427,135,374,2,3,514,27.2,86,51,5.2,941,True,9,244,691,3,3,2024-03-31,False,False,False,0.7343251859723698,0.2592986184909671,0.003188097768331562,0.003188097768331562,Shoulder,Sunday,March
2024-03-31 10:00:00,54,148,1,0,203,81,184,5,0,270,28.5,80,3,4.0,473,True,10,135,332,6,0,2024-03-31,False,False,False,0.7019027484143763,0.2854122621564482,0.012684989429175475,0.0,Shoulder,Sunday,March
2024-03-31 11:00:00,114,294,1,2,411,155,400,6,1,562,30.4,71,51,5.0,973,True,11,269,694,7,3,2024-03-31,False,False,False,0.7132579650565262,0.27646454265159304,0.007194244604316547,0.003083247687564234,Peak,Sunday,March
2024-03-31 12:00:00,92,318,6,0,416,152,430,5,2,589,31.1,71,51,6.0,1005,True,12,244,748,11,2,2024-03-31,False,False,False,0.7442786069651741,0.2427860696517413,0.010945273631840797,0.001990049751243781,Peak,Sunday,March
2024-03-31 13:00:00,109,300,4,0,413,177,428,6,1,612,30.3,74,63,10.1,1025,True,13,286,728,10,1,2024-03-31,False,False,False,0.7102439024390244,0.27902439024390246,0.00975609756097561,0.000975609756097561,Peak,Sunday,March
2024-03-31 14:00:00,107,323,3,1,434,133,426,6,3,568,30.0,78,61,7.9,1002,True,14,240,749,9,4,2024-03-31,False,False,False,0.7475049900199601,0.23952095808383234,0.008982035928143712,0.003992015968063872,Peak,Sunday,March
2024-03-31 15:00:00,51,177,3,0,231,67,208,1,2,278,30.7,74,3,5.2,509,True,15,118,385,4,2,2024-03-31,False,False,False,0.756385068762279,0.2318271119842829,0.007858546168958742,0.003929273084479371,Peak,Sunday,March
2024-03-31 16:00:00,49,176,2,1,228,96,223,4,0,323,30.8,73,53,7.2,551,True,16,145,399,6,1,2024-03-31,False,False,False,0.7241379310344828,0.2631578947368421,0.010889292196007259,0.0018148820326678765,Peak,Sunday,March
2024-03-31 17:00:00,95,332,1,1,429,166,384,4,0,554,29.4,81,55,9.5,983,True,17,261,716,5,1,2024-03-31,False,False,False,0.728382502543235,0.26551373346897256,0.00508646998982706,0.001017293997965412,Peak,Sunday,March
2024-03-31 18:00:00,95,348,4,0,447,145,394,5,0,544,29.3,79,51,5.9,991,True,18,240,742,9,0,2024-03-31,False,False,False,0.7487386478304743,0.24217961654894046,0.009081735620585268,0.0,Peak,Sunday,March
2024-03-31 19:00:00,131,306,2,0,439,152,401,5,0,558,27.5,90,61,10.4,997,True,19,283,707,7,0,2024-03-31,False,False,False,0.7091273821464393,0.283851554663992,0.007021063189568706,0.0,Peak,Sunday,March
2024-03-31 20:00:00,113,320,3,0,436,145,428,1,0,574,26.4,93,53,9.9,1010,True,20,258,748,4,0,2024-03-31,False,False,False,0.7405940594059406,0.25544554455445545,0.0039603960396039604,0.0,Shoulder,Sunday,March
2024-03-31 21:00:00,49,176,2,0,227,83,203,0,1,287,25.8,95,65,2.8,514,True,21,132,379,2,1,2024-03-31,False,False,False,0.7373540856031129,0.25680933852140075,0.0038910505836575876,0.0019455252918287938,Shoulder,Sunday,March
2024-03-31 22:00:00,45,162,0,0,207,88,195,1,1,285,25.2,97,65,11.8,492,True,22,133,357,1,1,2024-03-31,False,False,False,0.725609756097561,0.2703252032520325,0.0020325203252032522,0.0020325203252032522,Shoulder,Sunday,March
2024-03-31 23:00:00,59,163,1,1,224,86,218,3,1,308,25.3,96,3,6.2,532,True,23,145,381,4,2,2024-03-31,False,False,False,0.7161654135338346,0.2725563909774436,0.007518796992481203,0.0037593984962406013,Shoulder,Sunday,March
2024-04-01 00:00:00,53,234,1,0,288,54,231,2,0,287,25.3,96,3,8.9,575,False,0,107,465,3,0,2024-04-01,False,False,False,0.808695652173913,0.18608695652173912,0.0052173913043478265,0.0,Off-Peak,Monday,April
2024-04-01 01:00:00,58,176,2,0,236,51,182,1,0,234,25.6,95,3,9.4,470,False,1,109,358,3,0,2024-04-01,False,False,False,0.7617021276595745,0.23191489361702128,0.006382978723404255,0.0,Off-Peak,Monday,April
2024-04-01 02:00:00,33,121,0,0,154,39,121,0,0,160,25.6,95,3,9.1,314,False,2,72,242,0,0,2024-04-01,False,False,False,0.7707006369426752,0.22929936305732485,0.0,0.0,Off-Peak,Monday,April
2024-04-01 03:00:00,23,97,0,0,120,42,97,0,0,139,25.4,96,3,10.5,259,False,3,65,194,0,0,2024-04-01,False,False,False,0.749034749034749,0.25096525096525096,0.0,0.0,Off-Peak,Monday,April
2024-04-01 04:00:00,21,61,0,0,82,31,43,0,0,74,25.3,96,3,9.3,156,False,4,52,104,0,0,2024-04-01,False,False,False,0.6666666666666666,0.3333333333333333,0.0,0.0,Off-Peak,Monday,April
2024-04-01 05:00:00,16,198,1,0,215,25,198,0,0,223,25.1,96,3,8.4,438,False,5,41,396,1,0,2024-04-01,False,False,False,0.9041095890410958,0.09360730593607305,0.00228310502283105,0.0,Shoulder,Monday,April
2024-04-01 06:00:00,61,257,1,0,319,61,257,2,1,321,25.1,96,3,10.0,640,False,6,122,514,3,1,2024-04-01,False,False,False,0.803125,0.190625,0.0046875,0.0015625,Shoulder,Monday,April
2024-04-01 07:00:00,188,465,7,0,660,108,393,6,0,507,25.1,96,3,8.7,1167,False,7,296,858,13,0,2024-04-01,False,False,False,0.7352185089974294,0.2536418166238218,0.011139674378748929,0.0,Peak,Monday,April
2024-04-01 08:00:00,174,434,6,0,614,95,318,5,0,418,25.6,95,3,8.6,1032,False,8,269,752,11,0,2024-04-01,False,False,False,0.7286821705426356,0.2606589147286822,0.01065891472868217,0.0,Peak,Monday,April
2024-04-01 09:00:00,168,419,7,0,594,99,344,9,0,452,27.9,91,2,9.4,1046,False,9,267,763,16,0,2024-04-01,False,False,False,0.7294455066921606,0.2552581261950287,0.015296367112810707,0.0,Shoulder,Monday,April
2024-04-01 10:00:00,173,427,8,0,608,115,456,6,0,577,29.7,79,51,8.9,1185,False,10,288,883,14,0,2024-04-01,False,False,False,0.7451476793248946,0.2430379746835443,0.01181434599156118,0.0,Shoulder,Monday,April
2024-04-01 11:00:00,136,292,5,0,433,87,285,5,0,377,31.0,72,51,5.2,810,False,11,223,577,10,0,2024-04-01,False,False,False,0.7123456790123457,0.27530864197530863,0.012345679012345678,0.0,Peak,Monday,April
2024-04-01 12:00:00,154,352,7,0,513,79,239,5,0,323,31.6,70,51,3.1,836,False,12,233,591,12,0,2024-04-01,False,False,False,0.7069377990430622,0.27870813397129185,0.014354066985645933,0.0,Peak,Monday,April
2024-04-01 13:00:00,175,431,6,0,612,113,425,8,1,547,31.5,71,51,6.6,1159,False,13,288,856,14,1,2024-04-01,False,False,False,0.7385677308024159,0.24849007765314926,0.012079378774805867,0.0008628127696289905,Peak,Monday,April
2024-04-01 14:00:00,148,324,6,0,478,88,296,5,0,389,29.8,82,63,9.7,867,False,14,236,620,11,0,2024-04-01,False,False,False,0.7151095732410612,0.2722029988465975,0.012687427912341407,0.0,Peak,Monday,April
2024-04-01 15:00:00,152,346,6,0,504,96,336,7,0,439,30.2,79,51,4.6,943,False,15,248,682,13,0,2024-04-01,False,False,False,0.7232237539766702,0.26299045599151644,0.013785790031813362,0.0,Peak,Monday,April
2024-04-01 16:00:00,121,250,7,2,380,98,353,8,0,459,30.5,79,51,4.0,839,False,16,219,603,15,2,2024-04-01,False,False,False,0.7187127532777116,0.26102502979737785,0.017878426698450536,0.0023837902264600714,Peak,Monday,April
2024-04-01 17:00:00,131,258,5,1,395,111,409,8,1,529,27.7,82,65,8.0,924,False,17,242,667,13,2,2024-04-01,False,False,False,0.7218614718614719,0.2619047619047619,0.01406926406926407,0.0021645021645021645,Peak,Monday,April
2024-04-01 18:00:00,146,332,7,1,486,104,388,7,1,500,26.6,85,65,4.6,986,False,18,250,720,14,2,2024-04-01,False,False,False,0.7302231237322515,0.2535496957403651,0.014198782961460446,0.002028397565922921,Peak,Monday,April
2024-04-01 19:00:00,162,380,8,1,551,69,194,7,1,271,26.5,88,61,2.8,822,False,19,231,574,15,2,2024-04-01,False,False,False,0.6982968369829684,0.28102189781021897,0.01824817518248175,0.0024330900243309003,Peak,Monday,April
2024-04-01 20:00:00,103,191,8,1,303,106,387,7,1,501,26.0,93,55,2.3,804,False,20,209,578,15,2,2024-04-01,False,False,False,0.7189054726368159,0.2599502487562189,0.018656716417910446,0.0024875621890547263,Shoulder,Monday,April
2024-04-01 21:00:00,116,230,7,1,354,71,197,7,1,276,26.2,94,63,3.4,630,False,21,187,427,14,2,2024-04-01,False,False,False,0.6777777777777778,0.2968253968253968,0.022222222222222223,0.0031746031746031746,Shoulder,Monday,April
2024-04-01 22:00:00,117,236,6,1,360,116,420,7,1,544,25.5,97,63,4.7,904,False,22,233,656,13,2,2024-04-01,False,False,False,0.7256637168141593,0.2577433628318584,0.014380530973451327,0.0022123893805309734,Shoulder,Monday,April
2024-04-01 23:00:00,190,461,8,1,660,76,227,7,1,311,24.9,98,55,5.9,971,False,23,266,688,15,2,2024-04-01,False,False,False,0.7085478887744593,0.27394438722966014,0.015447991761071062,0.0020597322348094747,Shoulder,Monday,April
2024-04-02 00:00:00,65,231,1,0,297,11,268,1,0,280,25.1,97,51,3.1,577,False,0,76,499,2,0,2024-04-02,False,False,False,0.8648180242634316,0.1317157712305026,0.0034662045060658577,0.0,Off-Peak,Tuesday,April
2024-04-02 01:00:00,57,164,0,0,221,16,112,1,0,129,24.8,98,53,2.3,350,False,1,73,276,1,0,2024-04-02,False,False,False,0.7885714285714286,0.20857142857142857,0.002857142857142857,0.0,Off-Peak,Tuesday,April
2024-04-02 02:00:00,33,123,0,0,156,10,97,0,0,107,24.7,97,51,0.8,263,False,2,43,220,0,0,2024-04-02,False,False,False,0.8365019011406845,0.1634980988593156,0.0,0.0,Off-Peak,Tuesday,April
2024-04-02 03:00:00,23,97,0,0,120,8,61,0,0,69,24.6,98,3,2.8,189,False,3,31,158,0,0,2024-04-02,False,False,False,0.8359788359788359,0.164021164021164,0.0,0.0,Off-Peak,Tuesday,April
2024-04-02 04:00:00,21,61,0,0,82,6,43,0,0,49,24.6,97,3,4.4,131,False,4,27,104,0,0,2024-04-02,False,False,False,0.7938931297709924,0.20610687022900764,0.0,0.0,Off-Peak,Tuesday,April
2024-04-02 05:00:00,16,198,1,0,215,3,198,0,0,201,24.4,98,3,5.9,416,False,5,19,396,1,0,2024-04-02,False,False,False,0.9519230769230769,0.04567307692307692,0.002403846153846154,0.0,Shoulder,Tuesday,April
2024-04-02 06:00:00,61,257,1,0,319,61,257,1,0,319,24.3,97,3,6.4,638,False,6,122,514,2,0,2024-04-02,False,False,False,0.8056426332288401,0.19122257053291536,0.003134796238244514,0.0,Shoulder,Tuesday,April
2024-04-02 07:00:00,139,459,10,0,608,160,799,9,0,968,24.3,96,3,6.6,1576,False,7,299,1258,19,0,2024-04-02,False,False,True,0.7982233502538071,0.18972081218274112,0.012055837563451776,0.0,Peak,Tuesday,April
2024-04-02 08:00:00,124,375,8,0,507,121,575,7,1,704,24.6,96,3,8.0,1211,False,8,245,950,15,1,2024-04-02,False,False,False,0.7844756399669695,0.2023121387283237,0.012386457473162676,0.0008257638315441783,Peak,Tuesday,April
2024-04-02 09:00:00,157,574,12,0,743,110,480,6,1,597,26.3,91,3,3.6,1340,False,9,267,1054,18,1,2024-04-02,False,False,False,0.7865671641791044,0.19925373134328359,0.013432835820895522,0.0007462686567164179,Shoulder,Tuesday,April
2024-04-02 10:00:00,140,467,9,0,616,141,687,7,1,836,28.1,85,3,4.8,1452,False,10,281,1154,16,1,2024-04-02,False,False,True,0.7947658402203857,0.19352617079889808,0.011019283746556474,0.0006887052341597796,Shoulder,Tuesday,April
2024-04-02 11:00:00,109,322,9,0,440,112,488,7,1,608,29.8,79,3,2.4,1048,False,11,221,810,16,1,2024-04-02,False,False,False,0.7729007633587787,0.21087786259541985,0.015267175572519083,0.0009541984732824427,Peak,Tuesday,April
2024-04-02 12:00:00,115,342,10,1,468,121,569,8,1,699,30.5,76,51,9.7,1167,False,12,236,911,18,2,2024-04-02,False,False,False,0.7806341045415596,0.20222793487574978,0.015424164524421594,0.001713796058269066,Peak,Tuesday,April
2024-04-02 13:00:00,139,474,11,0,624,98,400,6,1,505,30.3,76,51,11.3,1129,False,13,237,874,17,1,2024-04-02,False,False,False,0.7741364038972542,0.20992028343666963,0.015057573073516387,0.0008857395925597874,Peak,Tuesday,April
2024-04-02 14:00:00,143,437,10,0,590,99,406,7,1,513,29.9,78,53,9.1,1103,False,14,242,843,17,1,2024-04-02,False,False,False,0.7642792384406165,0.21940163191296463,0.015412511332728921,0.0009066183136899365,Peak,Tuesday,April
2024-04-02 15:00:00,147,499,16,0,662,125,562,10,1,698,30.5,76,51,9.0,1360,False,15,272,1061,26,1,2024-04-02,False,False,False,0.7801470588235294,0.2,0.01911764705882353,0.0007352941176470588,Peak,Tuesday,April
2024-04-02 16:00:00,219,897,16,0,1132,102,421,7,1,531,30.0,78,53,6.4,1663,False,16,321,1318,23,1,2024-04-02,False,False,True,0.7925435959110042,0.19302465423932652,0.013830426939266387,0.0006013229104028864,Peak,Tuesday,April
2024-04-02 17:00:00,161,589,14,0,764,109,469,9,2,589,30.2,76,51,4.3,1353,False,17,270,1058,23,2,2024-04-02,False,False,False,0.7819660014781966,0.19955654101995565,0.016999260901699925,0.0014781966001478197,Peak,Tuesday,April
2024-04-02 18:00:00,123,371,10,1,505,119,538,7,1,665,29.7,79,3,6.2,1170,False,18,242,909,17,2,2024-04-02,False,False,False,0.7769230769230769,0.20683760683760682,0.01452991452991453,0.0017094017094017094,Peak,Tuesday,April
2024-04-02 19:00:00,169,632,13,1,815,116,508,7,1,632,29.0,82,3,3.6,1447,False,19,285,1140,20,2,2024-04-02,False,False,True,0.7878369039391845,0.19695922598479612,0.013821700069108501,0.00138217000691085,Peak,Tuesday,April
2024-04-02 20:00:00,139,471,11,1,622,122,558,9,1,690,27.8,88,3,3.1,1312,False,20,261,1029,20,2,2024-04-02,False,False,False,0.7842987804878049,0.1989329268292683,0.01524390243902439,0.001524390243902439,Shoulder,Tuesday,April
2024-04-02 21:00:00,217,888,17,1,1123,149,721,11,1,882,28.1,90,3,2.5,2005,False,21,366,1609,28,2,2024-04-02,False,False,True,0.8024937655860349,0.1825436408977556,0.013965087281795512,0.000997506234413965,Shoulder,Tuesday,April
2024-04-02 22:00:00,185,678,17,1,881,106,441,7,1,555,27.6,91,3,3.5,1436,False,22,291,1119,24,2,2024-04-02,False,False,True,0.7792479108635098,0.20264623955431754,0.016713091922005572,0.001392757660167131,Shoulder,Tuesday,April
2024-04-02 23:00:00,163,564,14,1,742,119,532,10,1,662,27.7,88,3,5.3,1404,False,23,282,1096,24,2,2024-04-02,False,False,True,0.7806267806267806,0.20085470085470086,0.017094017094017096,0.0014245014245014246,Shoulder,Tuesday,April
2024-04-03 00:00:00,61,231,1,0,293,64,267,1,0,332,27.5,90,3,4.3,625,False,0,125,498,2,0,2024-04-03,False,False,False,0.7968,0.2,0.0032,0.0,Off-Peak,Wednesday,April
2024-04-03 01:00:00,58,164,0,0,222,55,183,1,0,239,26.8,90,51,11.0,461,False,1,113,347,1,0,2024-04-03,False,False,False,0.7527114967462039,0.24511930585683298,0.0021691973969631237,0.0,Off-Peak,Wednesday,April
2024-04-03 02:00:00,33,123,0,0,156,39,124,1,0,164,26.3,90,51,8.3,320,False,2,72,247,1,0,2024-04-03,False,False,False,0.771875,0.225,0.003125,0.0,Off-Peak,Wednesday,April
2024-04-03 03:00:00,23,97,0,0,120,48,97,0,0,145,26.0,90,3,9.2,265,False,3,71,194,0,0,2024-04-03,False,False,False,0.7320754716981132,0.2679245283018868,0.0,0.0,Off-Peak,Wednesday,April
2024-04-03 04:00:00,21,61,0,0,82,31,43,0,0,74,25.5,90,3,8.9,156,False,4,52,104,0,0,2024-04-03,False,False,False,0.6666666666666666,0.3333333333333333,0.0,0.0,Off-Peak,Wednesday,April
2024-04-03 05:00:00,16,198,1,0,215,25,198,0,0,223,24.9,91,51,5.9,438,False,5,41,396,1,0,2024-04-03,False,False,False,0.9041095890410958,0.09360730593607305,0.00228310502283105,0.0,Shoulder,Wednesday,April
2024-04-03 06:00:00,61,257,1,0,319,61,257,1,0,319,24.7,90,3,4.2,638,False,6,122,514,2,0,2024-04-03,False,False,False,0.8056426332288401,0.19122257053291536,0.003134796238244514,0.0,Shoulder,Wednesday,April
2024-04-03 07:00:00,136,359,8,0,503,103,642,8,0,753,24.6,90,3,6.6,1256,False,7,239,1001,16,0,2024-04-03,False,False,False,0.7969745222929936,0.19028662420382167,0.012738853503184714,0.0,Peak,Wednesday,April
2024-04-03 08:00:00,159,523,10,0,692,111,746,9,0,866,25.4,90,3,5.5,1558,False,8,270,1269,19,0,2024-04-03,False,False,True,0.8145057766367138,0.17329910141206675,0.012195121951219513,0.0,Peak,Wednesday,April
2024-04-03 09:00:00,172,600,11,0,783,64,319,6,0,389,27.6,87,3,11.2,1172,False,9,236,919,17,0,2024-04-03,False,False,False,0.7841296928327645,0.20136518771331058,0.014505119453924915,0.0,Shoulder,Wednesday,April
2024-04-03 10:00:00,191,688,12,0,891,83,491,7,0,581,28.9,83,3,4.3,1472,False,10,274,1179,19,0,2024-04-03,False,False,True,0.8009510869565217,0.18614130434782608,0.012907608695652174,0.0,Shoulder,Wednesday,April
2024-04-03 11:00:00,171,609,12,1,793,92,543,9,0,644,30.5,77,2,4.5,1437,False,11,263,1152,21,1,2024-04-03,False,False,True,0.8016701461377871,0.18302018093249825,0.014613778705636743,0.0006958942240779402,Peak,Wednesday,April
2024-04-03 12:00:00,173,613,12,1,799,102,672,9,1,784,31.5,73,51,4.7,1583,False,12,275,1285,21,2,2024-04-03,False,False,True,0.8117498420720152,0.1737207833228048,0.013265950726468731,0.0012634238787113076,Peak,Wednesday,April
2024-04-03 13:00:00,148,439,13,1,601,96,603,9,1,709,32.0,71,2,10.0,1310,False,13,244,1042,22,2,2024-04-03,False,False,False,0.7954198473282442,0.18625954198473282,0.016793893129770993,0.0015267175572519084,Peak,Wednesday,April
2024-04-03 14:00:00,156,525,12,1,694,89,513,8,1,611,29.1,84,63,6.6,1305,False,14,245,1038,20,2,2024-04-03,False,False,False,0.7954022988505747,0.18773946360153257,0.01532567049808429,0.0015325670498084292,Peak,Wednesday,April
2024-04-03 15:00:00,182,655,12,1,850,87,527,7,1,622,29.0,86,53,9.5,1472,False,15,269,1182,19,2,2024-04-03,False,False,True,0.8029891304347826,0.1827445652173913,0.012907608695652174,0.001358695652173913,Peak,Wednesday,April
2024-04-03 16:00:00,126,363,10,1,500,105,663,10,1,779,29.1,82,51,5.8,1279,False,16,231,1026,20,2,2024-04-03,False,False,False,0.8021892103205629,0.18060985144644254,0.01563721657544957,0.001563721657544957,Peak,Wednesday,April
2024-04-03 17:00:00,156,521,11,1,689,99,641,9,1,750,29.1,79,51,4.2,1439,False,17,255,1162,20,2,2024-04-03,False,False,True,0.8075052119527449,0.17720639332870047,0.01389854065323141,0.001389854065323141,Peak,Wednesday,April
2024-04-03 18:00:00,221,843,16,1,1081,75,361,7,1,444,29.2,78,3,2.7,1525,False,18,296,1204,23,2,2024-04-03,False,False,True,0.7895081967213115,0.1940983606557377,0.015081967213114755,0.0013114754098360656,Peak,Wednesday,April
2024-04-03 19:00:00,144,474,10,1,629,69,308,7,1,385,28.6,81,3,6.2,1014,False,19,213,782,17,2,2024-04-03,False,False,False,0.7712031558185405,0.21005917159763313,0.016765285996055226,0.0019723865877712033,Peak,Wednesday,April
2024-04-03 20:00:00,135,392,10,1,538,123,808,11,1,943,27.8,85,51,6.5,1481,False,20,258,1200,21,2,2024-04-03,False,False,True,0.8102633355840648,0.17420661715057395,0.014179608372721135,0.0013504388926401081,Shoulder,Wednesday,April
2024-04-03 21:00:00,157,488,13,1,659,101,646,11,2,760,27.0,88,63,8.7,1419,False,21,258,1134,24,3,2024-04-03,False,False,True,0.7991543340380549,0.18181818181818182,0.016913319238900635,0.0021141649048625794,Shoulder,Wednesday,April
2024-04-03 22:00:00,195,719,15,1,930,67,352,6,1,426,26.4,92,51,4.1,1356,False,22,262,1071,21,2,2024-04-03,False,False,False,0.7898230088495575,0.19321533923303835,0.015486725663716814,0.0014749262536873156,Shoulder,Wednesday,April
2024-04-03 23:00:00,192,685,16,2,895,100,623,10,1,734,26.2,95,2,5.5,1629,False,23,292,1308,26,3,2024-04-03,False,False,True,0.8029465930018416,0.17925107427869857,0.01596071209330878,0.001841620626151013,Shoulder,Wednesday,April
2024-04-04 00:00:00,66,237,1,0,304,61,263,1,0,325,26.2,94,3,3.8,629,False,0,127,500,2,0,2024-04-04,False,False,False,0.794912559618442,0.20190779014308427,0.003179650238473768,0.0,Off-Peak,Thursday,April
2024-04-04 01:00:00,58,169,0,0,227,52,181,1,0,234,26.1,95,51,6.0,461,False,1,110,350,1,0,2024-04-04,False,False,False,0.7592190889370932,0.2386117136659436,0.0021691973969631237,0.0,Off-Peak,Thursday,April
2024-04-04 02:00:00,33,123,0,0,156,37,128,0,0,165,25.5,96,61,5.4,321,False,2,70,251,0,0,2024-04-04,False,False,False,0.7819314641744548,0.21806853582554517,0.0,0.0,Off-Peak,Thursday,April
2024-04-04 03:00:00,23,97,0,0,120,43,97,0,0,140,24.8,98,63,7.7,260,False,3,66,194,0,0,2024-04-04,False,False,False,0.7461538461538462,0.25384615384615383,0.0,0.0,Off-Peak,Thursday,April
2024-04-04 04:00:00,21,61,0,0,82,31,43,0,0,74,24.8,97,53,6.1,156,False,4,52,104,0,0,2024-04-04,False,False,False,0.6666666666666666,0.3333333333333333,0.0,0.0,Off-Peak,Thursday,April
2024-04-04 05:00:00,16,198,1,0,215,25,198,0,0,223,24.6,97,51,7.3,438,False,5,41,396,1,0,2024-04-04,False,False,False,0.9041095890410958,0.09360730593607305,0.00228310502283105,0.0,Shoulder,Thursday,April
2024-04-04 06:00:00,61,257,1,1,320,61,257,1,0,319,24.5,97,51,8.6,639,False,6,122,514,2,1,2024-04-04,False,False,False,0.8043818466353677,0.19092331768388107,0.003129890453834116,0.001564945226917058,Shoulder,Thursday,April
2024-04-04 07:00:00,167,668,11,0,846,89,493,7,0,589,24.6,96,3,7.2,1435,False,7,256,1161,18,0,2024-04-04,False,False,True,0.8090592334494774,0.178397212543554,0.012543554006968641,0.0,Peak,Thursday,April
2024-04-04 08:00:00,184,779,10,0,973,65,323,6,0,394,25.0,95,3,6.1,1367,False,8,249,1102,16,0,2024-04-04,False,False,False,0.8061448427212875,0.18215069495245062,0.011704462326261888,0.0,Peak,Thursday,April
2024-04-04 09:00:00,102,336,8,0,446,71,347,7,0,425,27.1,89,3,5.9,871,False,9,173,683,15,0,2024-04-04,False,False,False,0.7841561423650976,0.19862227324913892,0.01722158438576349,0.0,Shoulder,Thursday,April
2024-04-04 10:00:00,113,395,7,0,515,107,648,7,0,762,28.5,84,3,1.1,1277,False,10,220,1043,14,0,2024-04-04,False,False,False,0.8167580266249022,0.17227877838684416,0.01096319498825372,0.0,Shoulder,Thursday,April
2024-04-04 11:00:00,129,462,10,0,601,112,712,7,0,831,29.8,78,3,10.0,1432,False,11,241,1174,17,0,2024-04-04,False,False,True,0.8198324022346368,0.16829608938547486,0.011871508379888268,0.0,Peak,Thursday,April
2024-04-04 12:00:00,142,520,10,0,672,111,711,7,0,829,30.5,73,3,9.0,1501,False,12,253,1231,17,0,2024-04-04,False,False,True,0.8201199200532978,0.16855429713524317,0.011325782811459028,0.0,Peak,Thursday,April
2024-04-04 13:00:00,115,386,9,0,510,89,518,8,0,615,31.2,70,3,10.2,1125,False,13,204,904,17,0,2024-04-04,False,False,False,0.8035555555555556,0.18133333333333335,0.015111111111111112,0.0,Peak,Thursday,April
2024-04-04 14:00:00,147,578,12,0,737,82,422,7,0,511,31.4,70,3,10.4,1248,False,14,229,1000,19,0,2024-04-04,False,False,False,0.8012820512820513,0.18349358974358973,0.015224358974358974,0.0,Peak,Thursday,April
2024-04-04 15:00:00,132,478,9,0,619,96,537,7,0,640,31.2,68,3,11.2,1259,False,15,228,1015,16,0,2024-04-04,False,False,False,0.8061953931691819,0.18109610802223988,0.012708498808578236,0.0,Peak,Thursday,April
2024-04-04 16:00:00,151,601,10,0,762,119,777,7,1,904,31.1,71,51,9.7,1666,False,16,270,1378,17,1,2024-04-04,False,False,True,0.8271308523409364,0.16206482593037214,0.01020408163265306,0.0006002400960384153,Peak,Thursday,April
2024-04-04 17:00:00,159,644,12,1,816,109,671,9,2,791,31.2,73,51,8.6,1607,False,17,268,1315,21,3,2024-04-04,False,False,True,0.8182949595519602,0.16677037958929683,0.013067828251400125,0.001866832607342875,Peak,Thursday,April
2024-04-04 18:00:00,197,871,14,1,1083,77,419,7,1,504,30.0,77,51,11.9,1587,False,18,274,1290,21,2,2024-04-04,False,False,True,0.8128544423440454,0.17265280403276623,0.013232514177693762,0.001260239445494644,Peak,Thursday,April
2024-04-04 19:00:00,161,669,12,1,843,71,375,6,1,453,29.1,82,3,12.3,1296,False,19,232,1044,18,2,2024-04-04,False,False,False,0.8055555555555556,0.17901234567901234,0.013888888888888888,0.0015432098765432098,Peak,Thursday,April
2024-04-04 20:00:00,174,702,13,1,890,118,753,9,1,881,28.7,85,3,12.4,1771,False,20,292,1455,22,2,2024-04-04,False,False,True,0.8215697346132129,0.16487859966120835,0.012422360248447204,0.001129305477131564,Shoulder,Thursday,April
2024-04-04 21:00:00,135,503,9,1,648,105,634,9,1,749,26.8,91,61,5.1,1397,False,21,240,1137,18,2,2024-04-04,False,False,True,0.8138869005010737,0.1717967072297781,0.012884753042233358,0.0014316392269148174,Shoulder,Thursday,April
2024-04-04 22:00:00,113,377,8,1,499,107,676,9,1,793,26.9,91,3,0.4,1292,False,22,220,1053,17,2,2024-04-04,False,False,False,0.815015479876161,0.17027863777089783,0.013157894736842105,0.0015479876160990713,Shoulder,Thursday,April
2024-04-04 23:00:00,124,423,10,1,558,73,351,8,1,433,26.3,96,3,5.9,991,False,23,197,774,18,2,2024-04-04,False,False,False,0.781029263370333,0.1987891019172553,0.018163471241170535,0.0020181634712411706,Shoulder,Thursday,April
2024-04-05 00:00:00,79,142,3,0,224,59,184,1,0,244,26.0,97,51,5.4,468,False,0,138,326,4,0,2024-04-05,False,False,False,0.6965811965811965,0.2948717948717949,0.008547008547008548,0.0,Off-Peak,Friday,April
2024-04-05 01:00:00,69,140,4,0,213,93,123,2,0,218,25.6,97,51,7.6,431,False,1,162,263,6,0,2024-04-05,False,False,False,0.6102088167053364,0.37587006960556846,0.013921113689095127,0.0,Off-Peak,Friday,April
2024-04-05 02:00:00,81,107,3,0,191,92,110,2,0,204,25.4,96,63,1.9,395,False,2,173,217,5,0,2024-04-05,False,False,False,0.549367088607595,0.4379746835443038,0.012658227848101266,0.0,Off-Peak,Friday,April
2024-04-05 03:00:00,129,107,3,0,239,52,50,2,0,104,25.4,95,61,3.4,343,False,3,181,157,5,0,2024-04-05,False,False,False,0.4577259475218659,0.5276967930029155,0.014577259475218658,0.0,Off-Peak,Friday,April
2024-04-05 04:00:00,70,245,3,1,319,54,193,2,0,249,24.9,99,53,9.0,568,False,4,124,438,5,1,2024-04-05,False,False,False,0.7711267605633803,0.21830985915492956,0.008802816901408451,0.0017605633802816902,Off-Peak,Friday,April
2024-04-05 05:00:00,57,182,4,2,245,86,316,2,0,404,24.8,97,61,4.4,649,False,5,143,498,6,2,2024-04-05,False,False,False,0.7673343605546995,0.22033898305084745,0.009244992295839754,0.0030816640986132513,Shoulder,Friday,April
2024-04-05 06:00:00,63,464,3,1,531,112,426,2,0,540,24.7,97,3,5.3,1071,False,6,175,890,5,1,2024-04-05,False,False,False,0.830999066293184,0.16339869281045752,0.004668534080298786,0.0009337068160597573,Shoulder,Friday,April
2024-04-05 07:00:00,65,348,4,1,418,39,345,4,1,389,24.4,98,3,6.5,807,False,7,104,693,8,2,2024-04-05,False,False,False,0.8587360594795539,0.1288723667905824,0.009913258983890954,0.0024783147459727386,Peak,Friday,April
2024-04-05 08:00:00,64,221,3,1,289,40,356,2,0,398,24.7,95,3,5.1,687,False,8,104,577,5,1,2024-04-05,False,False,False,0.8398835516739447,0.15138282387190685,0.00727802037845706,0.001455604075691412,Peak,Friday,April
2024-04-05 09:00:00,46,205,3,1,255,88,330,2,0,420,27.7,89,3,5.2,675,False,9,134,535,5,1,2024-04-05,False,False,False,0.7925925925925926,0.1985185185185185,0.007407407407407408,0.0014814814814814814,Shoulder,Friday,April
2024-04-05 10:00:00,84,297,4,1,386,55,193,2,0,250,29.4,82,3,1.9,636,False,10,139,490,6,1,2024-04-05,False,False,False,0.7704402515723271,0.21855345911949686,0.009433962264150943,0.0015723270440251573,Shoulder,Friday,April
2024-04-05 11:00:00,135,483,3,1,622,115,444,2,0,561,30.8,76,3,3.0,1183,False,11,250,927,5,1,2024-04-05,False,False,False,0.7836010143702451,0.21132713440405748,0.00422654268808115,0.0008453085376162299,Peak,Friday,April
2024-04-05 12:00:00,80,282,3,1,366,63,222,2,0,287,31.8,72,1,2.4,653,False,12,143,504,5,1,2024-04-05,False,False,False,0.7718223583460949,0.21898928024502298,0.007656967840735069,0.0015313935681470138,Peak,Friday,April
2024-04-05 13:00:00,44,238,3,1,286,45,155,2,0,202,31.3,74,53,7.9,488,False,13,89,393,5,1,2024-04-05,False,False,False,0.805327868852459,0.18237704918032788,0.010245901639344262,0.0020491803278688526,Peak,Friday,April
2024-04-05 14:00:00,99,163,3,1,266,91,338,2,0,431,29.9,81,63,9.2,697,False,14,190,501,5,1,2024-04-05,False,False,False,0.7187948350071736,0.27259684361549497,0.007173601147776184,0.0014347202295552368,Peak,Friday,April
2024-04-05 15:00:00,90,322,3,1,416,85,311,2,0,398,30.8,78,51,8.5,814,False,15,175,633,5,1,2024-04-05,False,False,False,0.7776412776412777,0.214987714987715,0.006142506142506142,0.0012285012285012285,Peak,Friday,April
2024-04-05 16:00:00,37,284,3,1,325,115,444,2,1,562,30.7,78,51,9.3,887,False,16,152,728,5,2,2024-04-05,False,False,False,0.8207440811724915,0.1713641488162345,0.005636978579481398,0.002254791431792559,Peak,Friday,April
2024-04-05 17:00:00,38,272,3,1,314,67,235,3,1,306,30.2,79,51,9.5,620,False,17,105,507,6,2,2024-04-05,False,False,False,0.817741935483871,0.1693548387096774,0.00967741935483871,0.0032258064516129032,Peak,Friday,April
2024-04-05 18:00:00,86,295,3,1,385,62,224,3,1,290,29.9,79,51,12.7,675,False,18,148,519,6,2,2024-04-05,False,False,False,0.7688888888888888,0.21925925925925926,0.008888888888888889,0.002962962962962963,Peak,Friday,April
2024-04-05 19:00:00,49,173,3,1,226,90,331,3,1,425,28.8,80,3,15.0,651,False,19,139,504,6,2,2024-04-05,False,False,False,0.7741935483870968,0.21351766513056836,0.009216589861751152,0.0030721966205837174,Peak,Friday,April
2024-04-05 20:00:00,122,439,4,1,566,19,211,4,1,235,28.5,81,3,13.6,801,False,20,141,650,8,2,2024-04-05,False,False,False,0.8114856429463171,0.1760299625468165,0.009987515605493134,0.0024968789013732834,Shoulder,Friday,April
2024-04-05 21:00:00,54,208,4,1,267,94,349,3,1,447,28.5,87,3,8.9,714,False,21,148,557,7,2,2024-04-05,False,False,False,0.7801120448179272,0.20728291316526612,0.00980392156862745,0.0028011204481792717,Shoulder,Friday,April
2024-04-05 22:00:00,153,557,4,1,715,82,279,3,1,365,26.6,90,63,13.3,1080,False,22,235,836,7,2,2024-04-05,False,False,False,0.774074074074074,0.2175925925925926,0.006481481481481481,0.001851851851851852,Shoulder,Friday,April
2024-04-05 23:00:00,52,149,4,1,206,47,154,3,1,205,26.4,89,51,6.6,411,False,23,99,303,7,2,2024-04-05,False,False,False,0.7372262773722628,0.24087591240875914,0.0170316301703163,0.004866180048661801,Shoulder,Friday,April
2024-04-06 00:00:00,109,193,224,0,526,109,131,224,0,464,25.9,93,51,2.3,990,True,0,218,324,448,0,2024-04-06,False,False,False,0.32727272727272727,0.2202020202020202,0.45252525252525255,0.0,Off-Peak,Saturday,April
2024-04-06 01:00:00,105,168,216,0,489,105,140,216,0,461,24.9,93,61,3.4,950,True,1,210,308,432,0,2024-04-06,False,False,False,0.32421052631578945,0.22105263157894736,0.45473684210526316,0.0,Off-Peak,Saturday,April
2024-04-06 02:00:00,120,174,229,0,523,120,83,229,0,432,24.9,95,51,1.1,955,True,2,240,257,458,0,2024-04-06,False,False,False,0.26910994764397905,0.2513089005235602,0.47958115183246075,0.0,Off-Peak,Saturday,April
2024-04-06 03:00:00,82,83,194,0,359,82,53,194,0,329,24.4,98,51,7.6,688,True,3,164,136,388,0,2024-04-06,False,False,False,0.19767441860465115,0.23837209302325582,0.563953488372093,0.0,Off-Peak,Saturday,April
2024-04-06 04:00:00,73,53,186,0,312,73,141,186,0,400,24.4,97,3,0.8,712,True,4,146,194,372,0,2024-04-06,False,False,False,0.27247191011235955,0.2050561797752809,0.5224719101123596,0.0,Off-Peak,Saturday,April
2024-04-06 05:00:00,72,202,184,0,458,72,168,184,0,424,23.9,99,3,2.9,882,True,5,144,370,368,0,2024-04-06,False,False,False,0.41950113378684806,0.16326530612244897,0.41723356009070295,0.0,Shoulder,Saturday,April
2024-04-06 06:00:00,70,489,186,1,746,70,310,186,1,567,24.6,96,3,1.8,1313,True,6,140,799,372,2,2024-04-06,False,False,False,0.6085300837776085,0.10662604722010663,0.2833206397562833,0.0015232292460015233,Shoulder,Saturday,April
2024-04-06 07:00:00,62,356,173,0,591,62,168,173,0,403,24.0,97,3,3.3,994,True,7,124,524,346,0,2024-04-06,False,False,False,0.5271629778672032,0.12474849094567404,0.34808853118712274,0.0,Peak,Saturday,April
2024-04-06 08:00:00,94,310,205,0,609,94,273,205,0,572,25.3,94,3,4.5,1181,True,8,188,583,410,0,2024-04-06,False,False,False,0.49364944961896695,0.15918712955122777,0.3471634208298052,0.0,Peak,Saturday,April
2024-04-06 09:00:00,54,309,164,0,527,54,181,164,0,399,26.8,86,3,10.6,926,True,9,108,490,328,0,2024-04-06,False,False,False,0.5291576673866091,0.11663066954643629,0.3542116630669546,0.0,Shoulder,Saturday,April
2024-04-06 10:00:00,27,203,138,0,368,27,202,138,0,367,28.1,79,3,6.1,735,True,10,54,405,276,0,2024-04-06,False,False,False,0.5510204081632653,0.07346938775510205,0.37551020408163266,0.0,Shoulder,Saturday,April
2024-04-06 11:00:00,72,199,185,1,457,72,199,185,1,457,30.0,75,51,1.8,914,True,11,144,398,370,2,2024-04-06,False,False,False,0.43544857768052514,0.1575492341356674,0.4048140043763676,0.002188183807439825,Peak,Saturday,April
2024-04-06 12:00:00,90,252,204,1,547,90,252,204,1,547,31.1,72,2,5.2,1094,True,12,180,504,408,2,2024-04-06,False,False,False,0.4606946983546618,0.16453382084095064,0.37294332723948814,0.0018281535648994515,Peak,Saturday,April
2024-04-06 13:00:00,94,262,202,1,559,94,262,202,1,559,31.4,71,3,8.0,1118,True,13,188,524,404,2,2024-04-06,False,False,False,0.46869409660107336,0.16815742397137745,0.3613595706618962,0.0017889087656529517,Peak,Saturday,April
2024-04-06 14:00:00,68,181,180,1,430,68,309,180,1,558,30.4,75,53,10.1,988,True,14,136,490,360,2,2024-04-06,False,False,False,0.4959514170040486,0.13765182186234817,0.3643724696356275,0.0020242914979757085,Peak,Saturday,April
2024-04-06 15:00:00,35,452,153,1,641,35,356,153,1,545,29.5,78,55,7.4,1186,True,15,70,808,306,2,2024-04-06,False,False,False,0.6812816188870152,0.05902192242833052,0.2580101180438449,0.0016863406408094434,Peak,Saturday,April
2024-04-06 16:00:00,64,232,177,1,474,64,452,177,1,694,30.2,77,51,4.9,1168,True,16,128,684,354,2,2024-04-06,False,False,False,0.5856164383561644,0.1095890410958904,0.3030821917808219,0.0017123287671232876,Peak,Saturday,April
2024-04-06 17:00:00,51,131,166,1,349,51,232,166,1,450,30.6,75,0,7.1,799,True,17,102,363,332,2,2024-04-06,False,False,False,0.45431789737171463,0.1276595744680851,0.41551939924906134,0.0025031289111389237,Peak,Saturday,April
2024-04-06 18:00:00,53,140,169,1,363,53,203,169,1,426,30.1,77,1,7.9,789,True,18,106,343,338,2,2024-04-06,False,False,False,0.4347275031685678,0.13434727503168567,0.42839036755386567,0.0025348542458808617,Peak,Saturday,April
2024-04-06 19:00:00,148,141,250,1,540,148,174,250,1,573,29.0,80,3,6.6,1113,True,19,296,315,500,2,2024-04-06,False,False,False,0.2830188679245283,0.265947888589398,0.44923629829290207,0.0017969451931716084,Peak,Saturday,April
2024-04-06 20:00:00,63,168,175,1,407,63,193,175,1,432,28.4,84,3,6.1,839,True,20,126,361,350,2,2024-04-06,False,False,False,0.4302741358760429,0.1501787842669845,0.4171632896305125,0.0023837902264600714,Shoulder,Saturday,April
2024-04-06 21:00:00,106,310,215,1,632,106,310,215,1,632,29.1,83,3,9.2,1264,True,21,212,620,430,2,2024-04-06,False,False,False,0.49050632911392406,0.16772151898734178,0.3401898734177215,0.0015822784810126582,Shoulder,Saturday,April
2024-04-06 22:00:00,65,175,178,1,419,65,175,178,1,419,27.8,92,3,4.6,838,True,22,130,350,356,2,2024-04-06,False,False,False,0.41766109785202865,0.15513126491646778,0.42482100238663484,0.002386634844868735,Shoulder,Saturday,April
2024-04-06 23:00:00,163,273,261,1,698,163,489,261,1,914,26.6,88,53,9.1,1612,True,23,326,762,522,2,2024-04-06,False,False,True,0.47270471464019853,0.2022332506203474,0.3238213399503722,0.0012406947890818859,Shoulder,Saturday,April
2024-04-07 00:00:00,126,217,3,0,346,50,142,1,0,193,26.0,95,51,9.7,539,True,0,176,359,4,0,2024-04-07,False,False,False,0.6660482374768089,0.32653061224489793,0.0074211502782931356,0.0,Off-Peak,Sunday,April
2024-04-07 01:00:00,104,138,3,0,245,71,155,2,0,228,26.0,96,1,4.1,473,True,1,175,293,5,0,2024-04-07,False,False,False,0.6194503171247357,0.3699788583509514,0.010570824524312896,0.0,Off-Peak,Sunday,April
2024-04-07 02:00:00,81,72,5,1,159,105,57,2,0,164,25.9,94,1,5.0,323,True,2,186,129,7,1,2024-04-07,False,False,False,0.3993808049535604,0.5758513931888545,0.021671826625386997,0.0030959752321981426,Off-Peak,Sunday,April
2024-04-07 03:00:00,37,84,3,0,124,101,141,2,0,244,25.9,91,3,10.8,368,True,3,138,225,5,0,2024-04-07,False,False,False,0.6114130434782609,0.375,0.01358695652173913,0.0,Off-Peak,Sunday,April
2024-04-07 04:00:00,156,89,4,0,249,53,145,2,0,200,25.7,92,3,11.3,449,True,4,209,234,6,0,2024-04-07,False,False,False,0.5211581291759465,0.46547884187082406,0.013363028953229399,0.0,Off-Peak,Sunday,April
2024-04-07 05:00:00,100,280,3,0,383,48,143,2,0,193,25.8,91,2,11.6,576,True,5,148,423,5,0,2024-04-07,False,False,False,0.734375,0.2569444444444444,0.008680555555555556,0.0,Shoulder,Sunday,April
2024-04-07 06:00:00,117,332,3,0,452,132,439,2,0,573,25.8,90,1,12.9,1025,True,6,249,771,5,0,2024-04-07,False,False,False,0.7521951219512195,0.24292682926829268,0.004878048780487805,0.0,Shoulder,Sunday,April
2024-04-07 07:00:00,99,274,3,0,376,107,343,2,0,452,25.5,91,2,12.3,828,True,7,206,617,5,0,2024-04-07,False,False,False,0.7451690821256038,0.24879227053140096,0.006038647342995169,0.0,Peak,Sunday,April
2024-04-07 08:00:00,84,228,3,0,315,47,277,2,0,326,26.0,90,3,11.8,641,True,8,131,505,5,0,2024-04-07,False,False,False,0.7878315132605305,0.20436817472698907,0.0078003120124804995,0.0,Peak,Sunday,April
2024-04-07 09:00:00,79,214,3,0,296,65,191,2,0,258,28.8,86,51,6.7,554,True,9,144,405,5,0,2024-04-07,False,False,False,0.7310469314079422,0.259927797833935,0.009025270758122744,0.0,Shoulder,Sunday,April
2024-04-07 10:00:00,109,305,3,0,417,88,343,2,0,433,30.4,77,1,9.2,850,True,10,197,648,5,0,2024-04-07,False,False,False,0.7623529411764706,0.23176470588235293,0.0058823529411764705,0.0,Shoulder,Sunday,April
2024-04-07 11:00:00,56,289,4,1,350,79,230,2,0,311,31.6,68,51,2.7,661,True,11,135,519,6,1,2024-04-07,False,False,False,0.7851739788199698,0.2042360060514372,0.009077155824508321,0.0015128593040847202,Peak,Sunday,April
2024-04-07 12:00:00,133,373,3,1,510,116,382,2,0,500,28.3,82,53,11.8,1010,True,12,249,755,5,1,2024-04-07,False,False,False,0.7475247524752475,0.24653465346534653,0.0049504950495049506,0.0009900990099009901,Peak,Sunday,April
2024-04-07 13:00:00,76,431,3,1,511,98,324,2,0,424,29.4,79,51,9.4,935,True,13,174,755,5,1,2024-04-07,False,False,False,0.8074866310160428,0.18609625668449198,0.0053475935828877,0.0010695187165775401,Peak,Sunday,April
2024-04-07 14:00:00,117,330,3,1,451,107,344,2,0,453,30.5,78,1,2.5,904,True,14,224,674,5,1,2024-04-07,False,False,False,0.745575221238938,0.24778761061946902,0.0055309734513274336,0.0011061946902654867,Peak,Sunday,April
2024-04-07 15:00:00,40,449,3,1,493,102,328,2,0,432,30.8,78,51,7.9,925,True,15,142,777,5,1,2024-04-07,False,False,False,0.84,0.1535135135135135,0.005405405405405406,0.001081081081081081,Peak,Sunday,April
2024-04-07 16:00:00,130,369,3,1,503,27,328,2,0,357,31.5,72,51,5.5,860,True,16,157,697,5,1,2024-04-07,False,False,False,0.8104651162790698,0.18255813953488373,0.005813953488372093,0.0011627906976744186,Peak,Sunday,April
2024-04-07 17:00:00,137,388,3,1,529,66,191,3,0,260,31.2,72,51,3.4,789,True,17,203,579,6,1,2024-04-07,False,False,False,0.7338403041825095,0.2572877059569075,0.0076045627376425855,0.0012674271229404308,Peak,Sunday,April
2024-04-07 18:00:00,69,174,3,1,247,135,454,3,0,592,30.7,75,3,5.1,839,True,18,204,628,6,1,2024-04-07,False,False,False,0.7485101311084624,0.2431466030989273,0.007151370679380214,0.0011918951132300357,Peak,Sunday,April
2024-04-07 19:00:00,80,215,3,1,299,79,242,2,0,323,29.3,83,61,8.0,622,True,19,159,457,5,1,2024-04-07,False,False,False,0.7347266881028939,0.25562700964630225,0.008038585209003215,0.001607717041800643,Peak,Sunday,April
2024-04-07 20:00:00,76,198,3,1,278,68,198,2,1,269,28.2,89,61,6.6,547,True,20,144,396,5,2,2024-04-07,False,False,False,0.7239488117001828,0.263254113345521,0.009140767824497258,0.003656307129798903,Shoulder,Sunday,April
2024-04-07 21:00:00,33,360,3,1,397,121,379,2,1,503,30.0,87,3,5.0,900,True,21,154,739,5,2,2024-04-07,False,False,False,0.8211111111111111,0.1711111111111111,0.005555555555555556,0.0022222222222222222,Shoulder,Sunday,April
2024-04-07 22:00:00,150,200,3,1,354,104,328,2,1,435,27.7,86,53,9.4,789,True,22,254,528,5,2,2024-04-07,False,False,False,0.6692015209125475,0.32192648922686945,0.0063371356147021544,0.0025348542458808617,Shoulder,Sunday,April
2024-04-07 23:00:00,115,315,4,1,435,56,220,3,2,281,26.3,90,53,10.6,716,True,23,171,535,7,3,2024-04-07,False,False,False,0.7472067039106145,0.2388268156424581,0.009776536312849162,0.004189944134078212,Shoulder,Sunday,April
2024-04-08 00:00:00,181,166,3,0,350,147,196,3,0,346,26.3,90,3,4.5,696,False,0,328,362,6,0,2024-04-08,False,False,False,0.5201149425287356,0.47126436781609193,0.008620689655172414,0.0,Off-Peak,Monday,April
2024-04-08 01:00:00,75,163,5,0,243,110,177,4,1,292,26.0,92,3,3.9,535,False,1,185,340,9,1,2024-04-08,False,False,False,0.6355140186915887,0.34579439252336447,0.016822429906542057,0.001869158878504673,Off-Peak,Monday,April
2024-04-08 02:00:00,58,76,4,1,139,101,111,3,0,215,25.7,94,3,10.8,354,False,2,159,187,7,1,2024-04-08,False,False,False,0.5282485875706214,0.4491525423728814,0.01977401129943503,0.002824858757062147,Off-Peak,Monday,April
2024-04-08 03:00:00,44,119,3,1,167,135,100,4,0,239,26.0,91,3,10.7,406,False,3,179,219,7,1,2024-04-08,False,False,False,0.5394088669950738,0.4408866995073892,0.017241379310344827,0.0024630541871921183,Off-Peak,Monday,April
2024-04-08 04:00:00,57,109,4,1,171,103,147,3,0,253,25.8,91,51,9.2,424,False,4,160,256,7,1,2024-04-08,False,False,False,0.6037735849056604,0.37735849056603776,0.01650943396226415,0.0023584905660377358,Off-Peak,Monday,April
2024-04-08 05:00:00,47,356,4,1,408,36,430,3,0,469,25.7,92,51,5.5,877,False,5,83,786,7,1,2024-04-08,False,False,False,0.8962371721778791,0.09464082098061574,0.00798175598631699,0.0011402508551881414,Shoulder,Monday,April
2024-04-08 06:00:00,159,529,4,1,693,51,627,3,0,681,25.4,94,3,3.8,1374,False,6,210,1156,7,1,2024-04-08,False,False,True,0.8413391557496361,0.15283842794759825,0.005094614264919942,0.000727802037845706,Shoulder,Monday,April
2024-04-08 07:00:00,162,544,3,1,710,134,563,3,0,700,25.5,94,3,5.7,1410,False,7,296,1107,6,1,2024-04-08,False,False,True,0.7851063829787234,0.2099290780141844,0.00425531914893617,0.0007092198581560284,Peak,Monday,April
2024-04-08 08:00:00,121,407,4,1,533,103,426,3,0,532,26.0,92,3,6.8,1065,False,8,224,833,7,1,2024-04-08,False,False,False,0.7821596244131456,0.21032863849765257,0.006572769953051643,0.0009389671361502347,Peak,Monday,April
2024-04-08 09:00:00,59,226,4,2,291,39,126,4,0,169,27.1,87,55,11.8,460,False,9,98,352,8,2,2024-04-08,False,False,False,0.7652173913043478,0.21304347826086956,0.017391304347826087,0.004347826086956522,Shoulder,Monday,April
2024-04-08 10:00:00,106,327,4,1,438,140,581,3,1,725,27.1,86,51,8.9,1163,False,10,246,908,7,2,2024-04-08,False,False,False,0.7807394668959587,0.2115219260533104,0.0060189165950128975,0.0017196904557179708,Shoulder,Monday,April
2024-04-08 11:00:00,81,237,5,1,324,94,380,3,1,478,28.3,83,51,4.1,802,False,11,175,617,8,2,2024-04-08,False,False,False,0.7693266832917706,0.21820448877805487,0.00997506234413965,0.0024937655860349127,Peak,Monday,April
2024-04-08 12:00:00,102,310,5,1,418,127,518,3,1,649,29.6,80,51,3.2,1067,False,12,229,828,8,2,2024-04-08,False,False,False,0.7760074976569822,0.21462043111527648,0.007497656982193065,0.0018744142455482662,Peak,Monday,April
2024-04-08 13:00:00,146,487,5,1,639,39,578,4,1,622,31.0,73,51,8.0,1261,False,13,185,1065,9,2,2024-04-08,False,False,False,0.8445678033306899,0.14670896114195084,0.007137192704203013,0.0015860428231562252,Peak,Monday,April
2024-04-08 14:00:00,134,447,5,1,587,54,461,3,1,519,31.2,72,51,9.5,1106,False,14,188,908,8,2,2024-04-08,False,False,False,0.8209764918625678,0.16998191681735986,0.007233273056057866,0.0018083182640144665,Peak,Monday,April
2024-04-08 15:00:00,126,414,5,1,546,94,378,3,1,476,30.7,75,51,10.5,1022,False,15,220,792,8,2,2024-04-08,False,False,False,0.7749510763209393,0.21526418786692758,0.007827788649706457,0.0019569471624266144,Peak,Monday,April
2024-04-08 16:00:00,120,648,5,1,774,125,511,3,1,640,31.0,71,2,9.5,1414,False,16,245,1159,8,2,2024-04-08,False,False,True,0.8196605374823197,0.17326732673267325,0.005657708628005658,0.0014144271570014145,Peak,Monday,April
2024-04-08 17:00:00,110,650,5,1,766,96,379,4,1,480,31.0,71,51,8.3,1246,False,17,206,1029,9,2,2024-04-08,False,False,False,0.8258426966292135,0.1653290529695024,0.0072231139646869984,0.0016051364365971107,Peak,Monday,April
2024-04-08 18:00:00,86,613,5,1,705,35,131,3,1,170,29.1,77,63,5.9,875,False,18,121,744,8,2,2024-04-08,False,False,False,0.8502857142857143,0.1382857142857143,0.009142857142857144,0.002285714285714286,Peak,Monday,April
2024-04-08 19:00:00,84,249,6,1,340,105,439,3,1,548,27.6,88,51,10.9,888,False,19,189,688,9,2,2024-04-08,False,False,False,0.7747747747747747,0.21283783783783783,0.010135135135135136,0.0022522522522522522,Peak,Monday,April
2024-04-08 20:00:00,191,262,6,1,460,37,420,3,1,461,27.1,89,3,7.2,921,False,20,228,682,9,2,2024-04-08,False,False,False,0.740499457111835,0.247557003257329,0.009771986970684038,0.002171552660152009,Shoulder,Monday,April
2024-04-08 21:00:00,33,392,5,1,431,73,265,3,1,342,26.7,90,3,5.5,773,False,21,106,657,8,2,2024-04-08,False,False,False,0.8499353169469599,0.1371280724450194,0.01034928848641656,0.00258732212160414,Shoulder,Monday,April
2024-04-08 22:00:00,113,361,5,1,480,37,114,3,1,155,26.2,94,53,6.3,635,False,22,150,475,8,2,2024-04-08,False,False,False,0.7480314960629921,0.23622047244094488,0.012598425196850394,0.0031496062992125984,Shoulder,Monday,April
2024-04-08 23:00:00,193,164,7,1,365,62,198,3,1,264,25.4,95,65,6.9,629,False,23,255,362,10,2,2024-04-08,False,False,False,0.575516693163752,0.40540540540540543,0.01589825119236884,0.003179650238473768,Shoulder,Monday,April
2024-04-09 00:00:00,103,157,4,0,264,97,204,2,0,303,25.4,94,61,7.0,567,False,0,200,361,6,0,2024-04-09,False,True,False,0.63668430335097,0.3527336860670194,0.010582010582010581,0.0,Off-Peak,Tuesday,April
2024-04-09 01:00:00,52,127,3,0,182,73,170,2,0,245,25.3,96,3,0.0,427,False,1,125,297,5,0,2024-04-09,False,True,False,0.6955503512880562,0.2927400468384075,0.0117096018735363,0.0,Off-Peak,Tuesday,April
2024-04-09 02:00:00,127,89,4,1,221,97,121,3,0,221,25.1,96,3,4.1,442,False,2,224,210,7,1,2024-04-09,False,True,False,0.4751131221719457,0.5067873303167421,0.01583710407239819,0.0022624434389140274,Off-Peak,Tuesday,April
2024-04-09 03:00:00,94,86,4,1,185,120,113,2,0,235,24.8,97,2,4.9,420,False,3,214,199,6,1,2024-04-09,False,True,False,0.4738095238095238,0.5095238095238095,0.014285714285714285,0.002380952380952381,Off-Peak,Tuesday,April
2024-04-09 04:00:00,137,152,4,1,294,47,81,3,0,131,24.5,98,3,5.1,425,False,4,184,233,7,1,2024-04-09,False,True,False,0.548235294117647,0.4329411764705882,0.01647058823529412,0.002352941176470588,Off-Peak,Tuesday,April
2024-04-09 05:00:00,118,417,4,1,540,125,193,4,1,323,24.5,98,3,4.3,863,False,5,243,610,8,2,2024-04-09,False,True,False,0.7068366164542295,0.28157589803012745,0.009269988412514484,0.002317497103128621,Shoulder,Tuesday,April
2024-04-09 06:00:00,80,785,4,1,870,89,540,3,0,632,24.7,97,51,8.7,1502,False,6,169,1325,7,1,2024-04-09,False,True,True,0.8821571238348869,0.11251664447403462,0.004660452729693742,0.0006657789613848203,Shoulder,Tuesday,April
2024-04-09 07:00:00,48,533,3,1,585,54,507,4,0,565,24.7,97,51,6.9,1150,False,7,102,1040,7,1,2024-04-09,False,True,False,0.9043478260869565,0.08869565217391304,0.00608695652173913,0.0008695652173913044,Peak,Tuesday,April
2024-04-09 08:00:00,146,365,4,1,516,101,425,3,0,529,25.3,95,51,7.5,1045,False,8,247,790,7,1,2024-04-09,False,True,False,0.7559808612440191,0.23636363636363636,0.0066985645933014355,0.0009569377990430622,Peak,Tuesday,April
2024-04-09 09:00:00,61,198,3,1,263,39,408,3,0,450,27.9,90,3,10.2,713,False,9,100,606,6,1,2024-04-09,False,True,False,0.8499298737727911,0.1402524544179523,0.008415147265077139,0.001402524544179523,Shoulder,Tuesday,April
2024-04-09 10:00:00,87,302,4,1,394,94,371,3,0,468,30.0,79,3,10.0,862,False,10,181,673,7,1,2024-04-09,False,True,False,0.7807424593967517,0.2099767981438515,0.008120649651972157,0.001160092807424594,Shoulder,Tuesday,April
2024-04-09 11:00:00,32,273,3,1,309,34,405,3,0,442,31.3,70,51,9.8,751,False,11,66,678,6,1,2024-04-09,False,True,False,0.9027962716378163,0.08788282290279627,0.007989347536617843,0.0013315579227696406,Peak,Tuesday,April
2024-04-09 12:00:00,32,332,3,1,368,49,182,3,0,234,32.1,67,51,2.9,602,False,12,81,514,6,1,2024-04-09,False,True,False,0.8538205980066446,0.1345514950166113,0.009966777408637873,0.0016611295681063123,Peak,Tuesday,April
2024-04-09 13:00:00,115,408,4,1,528,91,369,3,0,463,29.8,75,63,10.0,991,False,13,206,777,7,1,2024-04-09,False,True,False,0.7840565085771948,0.20787083753784055,0.007063572149344097,0.0010090817356205853,Peak,Tuesday,April
2024-04-09 14:00:00,68,224,3,1,296,84,340,3,1,428,27.8,87,63,3.4,724,False,14,152,564,6,2,2024-04-09,False,True,False,0.7790055248618785,0.20994475138121546,0.008287292817679558,0.0027624309392265192,Peak,Tuesday,April
2024-04-09 15:00:00,78,256,5,1,340,77,308,3,1,389,27.3,84,65,7.4,729,False,15,155,564,8,2,2024-04-09,False,True,False,0.7736625514403292,0.21262002743484226,0.010973936899862825,0.0027434842249657062,Peak,Tuesday,April
2024-04-09 16:00:00,52,737,4,1,794,131,564,3,1,699,27.2,86,51,9.3,1493,False,16,183,1301,7,2,2024-04-09,False,True,True,0.8713998660415271,0.12257200267916946,0.004688546550569324,0.0013395847287340924,Peak,Tuesday,April
2024-04-09 17:00:00,170,627,6,1,804,50,186,3,1,240,27.4,88,51,6.9,1044,False,17,220,813,9,2,2024-04-09,False,True,False,0.7787356321839081,0.210727969348659,0.008620689655172414,0.0019157088122605363,Peak,Tuesday,April
2024-04-09 18:00:00,109,383,5,1,498,95,390,3,1,489,28.2,85,3,6.8,987,False,18,204,773,8,2,2024-04-09,False,True,False,0.7831813576494427,0.2066869300911854,0.008105369807497468,0.002026342451874367,Peak,Tuesday,April
2024-04-09 19:00:00,82,90,4,1,177,137,574,3,1,715,28.1,86,3,4.0,892,False,19,219,664,7,2,2024-04-09,False,True,False,0.7443946188340808,0.24551569506726456,0.007847533632286996,0.002242152466367713,Peak,Tuesday,April
2024-04-09 20:00:00,38,452,5,1,496,53,354,3,1,411,26.3,92,63,3.9,907,False,20,91,806,8,2,2024-04-09,False,True,False,0.8886438809261301,0.10033076074972437,0.008820286659316428,0.002205071664829107,Shoulder,Tuesday,April
2024-04-09 21:00:00,210,487,8,2,707,115,481,3,1,600,26.9,90,51,7.0,1307,False,21,325,968,11,3,2024-04-09,False,True,False,0.740627390971691,0.2486610558530987,0.008416220351951033,0.0022953328232593728,Shoulder,Tuesday,April
2024-04-09 22:00:00,48,271,5,1,325,28,302,3,1,334,26.6,93,51,4.0,659,False,22,76,573,8,2,2024-04-09,False,True,False,0.8694992412746586,0.11532625189681335,0.012139605462822459,0.0030349013657056147,Shoulder,Tuesday,April
2024-04-09 23:00:00,201,151,7,1,360,81,314,3,1,399,26.5,94,3,8.9,759,False,23,282,465,10,2,2024-04-09,False,True,False,0.6126482213438735,0.3715415019762846,0.013175230566534914,0.002635046113306983,Shoulder,Tuesday,April
2024-04-10 00:00:00,147,168,2,0,317,78,204,1,0,283,26.4,93,3,9.7,600,False,0,225,372,3,0,2024-04-10,True,True,False,0.62,0.375,0.005,0.0,Off-Peak,Wednesday,April
2024-04-10 01:00:00,42,109,2,0,153,67,100,1,0,168,26.3,95,3,6.5,321,False,1,109,209,3,0,2024-04-10,True,True,False,0.6510903426791277,0.3395638629283489,0.009345794392523364,0.0,Off-Peak,Wednesday,April
2024-04-10 02:00:00,118,99,2,0,219,56,84,1,0,141,26.0,96,3,7.1,360,False,2,174,183,3,0,2024-04-10,True,True,False,0.5083333333333333,0.48333333333333334,0.008333333333333333,0.0,Off-Peak,Wednesday,April
2024-04-10 03:00:00,84,97,2,0,183,31,145,1,0,177,25.7,98,3,5.8,360,False,3,115,242,3,0,2024-04-10,True,True,False,0.6722222222222223,0.3194444444444444,0.008333333333333333,0.0,Off-Peak,Wednesday,April
2024-04-10 04:00:00,98,91,2,0,191,38,150,1,0,189,25.3,98,3,4.6,380,False,4,136,241,3,0,2024-04-10,True,True,False,0.6342105263157894,0.35789473684210527,0.007894736842105263,0.0,Off-Peak,Wednesday,April
2024-04-10 05:00:00,172,550,2,0,724,45,576,1,0,622,25.1,96,3,7.5,1346,False,5,217,1126,3,0,2024-04-10,True,True,False,0.836552748885587,0.1612184249628529,0.002228826151560178,0.0,Shoulder,Wednesday,April
2024-04-10 06:00:00,56,356,2,1,415,142,583,1,0,726,25.1,95,3,8.9,1141,False,6,198,939,3,1,2024-04-10,True,True,False,0.8229623137598597,0.17353198948290974,0.0026292725679228747,0.0008764241893076249,Shoulder,Wednesday,April
2024-04-10 07:00:00,75,212,2,1,290,115,464,1,0,580,24.8,96,3,9.4,870,False,7,190,676,3,1,2024-04-10,True,True,False,0.7770114942528735,0.21839080459770116,0.0034482758620689655,0.0011494252873563218,Peak,Wednesday,April
2024-04-10 08:00:00,180,572,2,1,755,53,375,1,0,429,25.5,93,3,9.5,1184,False,8,233,947,3,1,2024-04-10,True,True,False,0.799831081081081,0.19679054054054054,0.002533783783783784,0.0008445945945945946,Peak,Wednesday,April
2024-04-10 09:00:00,114,344,2,1,461,69,256,2,0,327,26.6,91,51,11.5,788,False,9,183,600,4,1,2024-04-10,True,True,False,0.7614213197969543,0.23223350253807107,0.005076142131979695,0.0012690355329949238,Shoulder,Wednesday,April
2024-04-10 10:00:00,130,402,2,1,535,93,364,2,1,460,26.9,88,51,6.1,995,False,10,223,766,4,2,2024-04-10,True,True,False,0.7698492462311558,0.2241206030150754,0.004020100502512563,0.0020100502512562816,Shoulder,Wednesday,April
2024-04-10 11:00:00,127,387,2,1,517,80,303,2,1,386,28.3,86,51,6.6,903,False,11,207,690,4,2,2024-04-10,True,True,False,0.7641196013289037,0.2292358803986711,0.004429678848283499,0.0022148394241417496,Peak,Wednesday,April
2024-04-10 12:00:00,55,460,3,1,519,91,353,2,1,447,29.9,81,51,4.5,966,False,12,146,813,5,2,2024-04-10,True,True,False,0.8416149068322981,0.15113871635610765,0.005175983436853002,0.002070393374741201,Peak,Wednesday,April
2024-04-10 13:00:00,39,293,2,1,335,104,420,2,1,527,30.3,76,53,0.8,862,False,13,143,713,4,2,2024-04-10,True,True,False,0.8271461716937355,0.16589327146171692,0.004640371229698376,0.002320185614849188,Peak,Wednesday,April
2024-04-10 14:00:00,192,608,2,1,803,118,244,2,1,365,27.6,84,61,11.0,1168,False,14,310,852,4,2,2024-04-10,True,True,False,0.7294520547945206,0.2654109589041096,0.003424657534246575,0.0017123287671232876,Peak,Wednesday,April
2024-04-10 15:00:00,135,416,3,2,556,92,880,3,2,977,27.1,87,53,3.6,1533,False,15,227,1296,6,4,2024-04-10,True,True,True,0.8454011741682974,0.14807566862361382,0.003913894324853229,0.002609262883235486,Peak,Wednesday,April
2024-04-10 16:00:00,45,629,2,1,677,99,595,2,1,697,28.5,83,3,10.7,1374,False,16,144,1224,4,2,2024-04-10,True,True,True,0.8908296943231441,0.10480349344978165,0.002911208151382824,0.001455604075691412,Peak,Wednesday,April
2024-04-10 17:00:00,52,567,3,1,623,50,474,2,1,527,29.1,79,3,11.8,1150,False,17,102,1041,5,2,2024-04-10,True,True,False,0.9052173913043479,0.08869565217391304,0.004347826086956522,0.0017391304347826088,Peak,Wednesday,April
2024-04-10 18:00:00,133,404,3,1,541,63,357,2,1,423,28.0,83,53,14.4,964,False,18,196,761,5,2,2024-04-10,True,True,False,0.7894190871369294,0.2033195020746888,0.005186721991701245,0.002074688796680498,Peak,Wednesday,April
2024-04-10 19:00:00,197,546,3,1,747,45,299,2,1,347,27.5,84,3,7.5,1094,False,19,242,845,5,2,2024-04-10,True,True,False,0.7723948811700183,0.22120658135283364,0.004570383912248629,0.0018281535648994515,Peak,Wednesday,April
2024-04-10 20:00:00,39,142,3,1,185,140,233,3,1,377,27.1,86,3,6.0,562,False,20,179,375,6,2,2024-04-10,True,True,False,0.6672597864768683,0.3185053380782918,0.010676156583629894,0.0035587188612099642,Shoulder,Wednesday,April
2024-04-10 21:00:00,64,243,3,1,311,47,146,2,1,196,27.1,92,3,4.7,507,False,21,111,389,5,2,2024-04-10,True,True,False,0.7672583826429981,0.21893491124260356,0.009861932938856016,0.0039447731755424065,Shoulder,Wednesday,April
2024-04-10 22:00:00,173,133,3,1,310,207,179,2,1,389,26.9,93,3,4.5,699,False,22,380,312,5,2,2024-04-10,True,True,False,0.44635193133047213,0.5436337625178826,0.00715307582260372,0.002861230329041488,Shoulder,Wednesday,April
2024-04-10 23:00:00,181,145,4,1,331,149,189,2,1,341,26.5,95,3,3.7,672,False,23,330,334,6,2,2024-04-10,True,True,False,0.49702380952380953,0.49107142857142855,0.008928571428571428,0.002976190476190476,Shoulder,Wednesday,April
2024-04-11 00:00:00,150,293,2,0,445,112,226,1,0,339,26.3,95,3,5.5,784,False,0,262,519,3,0,2024-04-11,True,True,False,0.6619897959183674,0.33418367346938777,0.003826530612244898,0.0,Off-Peak,Thursday,April
2024-04-11 01:00:00,114,150,3,1,268,52,191,2,0,245,26.2,94,3,7.9,513,False,1,166,341,5,1,2024-04-11,True,True,False,0.6647173489278753,0.3235867446393762,0.009746588693957114,0.001949317738791423,Off-Peak,Thursday,April
2024-04-11 02:00:00,97,109,2,0,208,45,107,2,0,154,25.8,95,3,8.4,362,False,2,142,216,4,0,2024-04-11,True,True,False,0.5966850828729282,0.39226519337016574,0.011049723756906077,0.0,Off-Peak,Thursday,April
2024-04-11 03:00:00,137,98,3,0,238,30,98,2,0,130,25.4,96,3,5.9,368,False,3,167,196,5,0,2024-04-11,True,True,False,0.532608695652174,0.453804347826087,0.01358695652173913,0.0,Off-Peak,Thursday,April
2024-04-11 04:00:00,120,87,2,0,209,48,164,2,0,214,25.3,94,1,7.2,423,False,4,168,251,4,0,2024-04-11,True,True,False,0.5933806146572104,0.3971631205673759,0.009456264775413711,0.0,Off-Peak,Thursday,April
2024-04-11 05:00:00,134,513,2,0,649,116,371,2,0,489,25.2,93,3,10.0,1138,False,5,250,884,4,0,2024-04-11,True,True,False,0.7768014059753954,0.21968365553602812,0.0035149384885764497,0.0,Shoulder,Thursday,April
2024-04-11 06:00:00,34,580,2,0,616,110,649,2,0,761,25.0,92,3,11.7,1377,False,6,144,1229,4,0,2024-04-11,True,True,True,0.8925199709513435,0.10457516339869281,0.002904865649963689,0.0,Shoulder,Thursday,April
2024-04-11 07:00:00,116,446,2,0,564,75,511,3,2,591,24.8,91,3,10.2,1155,False,7,191,957,5,2,2024-04-11,True,True,False,0.8285714285714286,0.16536796536796536,0.004329004329004329,0.0017316017316017316,Peak,Thursday,April
2024-04-11 08:00:00,43,138,2,0,183,134,515,2,1,652,25.3,90,3,10.7,835,False,8,177,653,4,1,2024-04-11,True,True,False,0.7820359281437126,0.2119760479041916,0.004790419161676647,0.0011976047904191617,Peak,Thursday,April
2024-04-11 09:00:00,141,551,2,0,694,41,420,2,1,464,27.2,82,3,15.1,1158,False,9,182,971,4,1,2024-04-11,True,True,False,0.8385146804835925,0.15716753022452504,0.0034542314335060447,0.0008635578583765112,Shoulder,Thursday,April
2024-04-11 10:00:00,105,394,3,0,502,107,248,2,1,358,28.3,79,1,15.0,860,False,10,212,642,5,1,2024-04-11,True,True,False,0.7465116279069768,0.24651162790697675,0.005813953488372093,0.0011627906976744186,Shoulder,Thursday,April
2024-04-11 11:00:00,107,406,3,0,516,91,178,2,1,272,29.7,74,51,16.8,788,False,11,198,584,5,1,2024-04-11,True,True,False,0.7411167512690355,0.2512690355329949,0.006345177664974619,0.0012690355329949238,Peak,Thursday,April
2024-04-11 12:00:00,86,308,3,0,397,115,550,2,1,668,30.4,70,51,17.1,1065,False,12,201,858,5,1,2024-04-11,True,True,False,0.8056338028169014,0.18873239436619718,0.004694835680751174,0.0009389671361502347,Peak,Thursday,April
2024-04-11 13:00:00,114,435,4,0,553,118,562,2,1,683,30.7,70,3,12.9,1236,False,13,232,997,6,1,2024-04-11,True,True,False,0.8066343042071198,0.18770226537216828,0.0048543689320388345,0.0008090614886731392,Peak,Thursday,April
2024-04-11 14:00:00,113,413,3,0,529,29,342,2,1,374,30.0,73,51,9.5,903,False,14,142,755,5,1,2024-04-11,True,True,False,0.8361018826135105,0.15725359911406422,0.005537098560354375,0.0011074197120708748,Peak,Thursday,April
2024-04-11 15:00:00,105,526,3,0,634,81,536,2,1,620,27.7,82,55,10.6,1254,False,15,186,1062,5,1,2024-04-11,True,True,False,0.84688995215311,0.14832535885167464,0.003987240829346092,0.0007974481658692185,Peak,Thursday,April
2024-04-11 16:00:00,125,519,3,0,647,60,526,3,1,590,28.1,82,53,5.2,1237,False,16,185,1045,6,1,2024-04-11,True,True,False,0.8447857720291027,0.14955537590945836,0.004850444624090542,0.0008084074373484236,Peak,Thursday,April
2024-04-11 17:00:00,47,369,3,1,420,112,554,2,1,669,28.2,83,3,7.9,1089,False,17,159,923,5,2,2024-04-11,True,True,False,0.8475665748393021,0.14600550964187328,0.004591368227731864,0.0018365472910927456,Peak,Thursday,April
2024-04-11 18:00:00,30,430,3,1,464,109,517,2,1,629,28.0,83,3,8.4,1093,False,18,139,947,5,2,2024-04-11,True,True,False,0.8664226898444648,0.12717291857273558,0.004574565416285453,0.0018298261665141812,Peak,Thursday,April
2024-04-11 19:00:00,137,468,3,1,609,98,447,3,1,549,27.5,85,3,11.3,1158,False,19,235,915,6,2,2024-04-11,True,True,False,0.7901554404145078,0.20293609671848015,0.0051813471502590676,0.0017271157167530224,Peak,Thursday,April
2024-04-11 20:00:00,116,397,3,1,517,87,394,2,1,484,27.5,87,3,6.8,1001,False,20,203,791,5,2,2024-04-11,True,True,False,0.7902097902097902,0.20279720279720279,0.004995004995004995,0.001998001998001998,Shoulder,Thursday,April
2024-04-11 21:00:00,35,459,3,1,498,64,285,2,1,352,26.7,93,51,5.1,850,False,21,99,744,5,2,2024-04-11,True,True,False,0.8752941176470588,0.11647058823529412,0.0058823529411764705,0.002352941176470588,Shoulder,Thursday,April
2024-04-11 22:00:00,81,434,3,1,519,47,191,2,1,241,26.1,96,3,3.2,760,False,22,128,625,5,2,2024-04-11,True,True,False,0.8223684210526315,0.16842105263157894,0.006578947368421052,0.002631578947368421,Shoulder,Thursday,April
2024-04-11 23:00:00,103,379,3,1,486,73,320,2,1,396,25.6,97,3,3.3,882,False,23,176,699,5,2,2024-04-11,True,True,False,0.7925170068027211,0.19954648526077098,0.005668934240362812,0.0022675736961451248,Shoulder,Thursday,April
2024-04-12 00:00:00,117,241,3,0,361,50,243,1,0,294,25.9,97,3,5.7,655,False,0,167,484,4,0,2024-04-12,False,False,False,0.7389312977099237,0.2549618320610687,0.0061068702290076335,0.0,Off-Peak,Friday,April
2024-04-12 01:00:00,64,209,3,0,276,93,191,2,0,286,25.7,96,2,5.1,562,False,1,157,400,5,0,2024-04-12,False,False,False,0.7117437722419929,0.2793594306049822,0.008896797153024912,0.0,Off-Peak,Friday,April
2024-04-12 02:00:00,104,125,3,0,232,65,122,2,0,189,25.4,94,2,5.4,421,False,2,169,247,5,0,2024-04-12,False,False,False,0.5866983372921615,0.4014251781472684,0.011876484560570071,0.0,Off-Peak,Friday,April
2024-04-12 03:00:00,72,102,3,0,177,65,331,2,1,399,25.1,90,2,7.3,576,False,3,137,433,5,1,2024-04-12,False,False,False,0.7517361111111112,0.2378472222222222,0.008680555555555556,0.001736111111111111,Off-Peak,Friday,April
2024-04-12 04:00:00,86,300,3,0,389,85,430,2,1,518,24.9,90,3,8.4,907,False,4,171,730,5,1,2024-04-12,False,False,False,0.804851157662624,0.18853362734288864,0.005512679162072767,0.0011025358324145535,Off-Peak,Friday,April
2024-04-12 05:00:00,136,427,3,0,566,78,406,2,1,487,24.8,91,3,9.2,1053,False,5,214,833,5,1,2024-04-12,False,False,False,0.7910731244064577,0.20322886989553657,0.004748338081671415,0.000949667616334283,Shoulder,Friday,April
2024-04-12 06:00:00,124,501,3,0,628,53,268,2,1,324,24.7,93,3,10.3,952,False,6,177,769,5,1,2024-04-12,False,False,False,0.8077731092436975,0.18592436974789917,0.005252100840336135,0.0010504201680672268,Shoulder,Friday,April
2024-04-12 07:00:00,153,578,3,0,734,122,680,2,1,805,24.8,93,3,11.5,1539,False,7,275,1258,5,1,2024-04-12,False,False,True,0.8174139051332033,0.17868745938921377,0.003248862897985705,0.000649772579597141,Peak,Friday,April
2024-04-12 08:00:00,87,298,3,0,388,122,657,3,2,784,25.7,91,3,12.6,1172,False,8,209,955,6,2,2024-04-12,False,False,False,0.8148464163822525,0.17832764505119453,0.005119453924914676,0.0017064846416382253,Peak,Friday,April
2024-04-12 09:00:00,44,451,3,0,498,43,333,3,1,380,27.1,83,51,9.7,878,False,9,87,784,6,1,2024-04-12,False,False,False,0.8929384965831435,0.09908883826879271,0.00683371298405467,0.0011389521640091116,Shoulder,Friday,April
2024-04-12 10:00:00,143,528,4,0,675,91,474,2,1,568,28.6,79,51,8.2,1243,False,10,234,1002,6,1,2024-04-12,False,False,False,0.8061142397425584,0.18825422365245373,0.004827031375703942,0.0008045052292839903,Shoulder,Friday,April
2024-04-12 11:00:00,82,378,3,0,463,104,556,2,1,663,30.0,75,51,11.6,1126,False,11,186,934,5,1,2024-04-12,False,False,False,0.8294849023090586,0.16518650088809947,0.004440497335701598,0.0008880994671403197,Peak,Friday,April
2024-04-12 12:00:00,95,334,3,0,432,49,241,3,1,294,30.1,72,51,7.9,726,False,12,144,575,6,1,2024-04-12,False,False,False,0.7920110192837465,0.19834710743801653,0.008264462809917356,0.0013774104683195593,Peak,Friday,April
2024-04-12 13:00:00,159,602,3,0,764,116,618,2,1,737,27.1,82,63,9.4,1501,False,13,275,1220,5,1,2024-04-12,False,False,True,0.8127914723517655,0.18321119253830778,0.0033311125916055963,0.0006662225183211193,Peak,Friday,April
2024-04-12 14:00:00,142,529,3,0,674,63,309,2,1,375,26.2,90,55,5.9,1049,False,14,205,838,5,1,2024-04-12,False,False,False,0.7988560533841754,0.1954242135367016,0.004766444232602479,0.0009532888465204957,Peak,Friday,April
2024-04-12 15:00:00,105,374,3,0,482,56,264,2,1,323,27.0,87,53,1.0,805,False,15,161,638,5,1,2024-04-12,False,False,False,0.7925465838509317,0.2,0.006211180124223602,0.0012422360248447205,Peak,Friday,April
2024-04-12 16:00:00,138,510,3,0,651,100,515,2,1,618,28.3,81,51,4.0,1269,False,16,238,1025,5,1,2024-04-12,False,False,False,0.8077226162332545,0.1875492513790386,0.003940110323089046,0.0007880220646178094,Peak,Friday,April
2024-04-12 17:00:00,121,431,4,0,556,71,370,2,1,444,27.6,83,51,6.9,1000,False,17,192,801,6,1,2024-04-12,False,False,False,0.801,0.192,0.006,0.001,Peak,Friday,April
2024-04-12 18:00:00,144,535,3,0,682,63,298,2,1,364,26.6,93,55,5.5,1046,False,18,207,833,5,1,2024-04-12,False,False,False,0.7963671128107075,0.19789674952198852,0.004780114722753346,0.0009560229445506692,Peak,Friday,April
2024-04-12 19:00:00,119,430,3,1,553,104,563,2,1,670,26.5,91,51,2.3,1223,False,19,223,993,5,2,2024-04-12,False,False,False,0.8119378577269011,0.18233851185609157,0.004088307440719542,0.001635322976287817,Peak,Friday,April
2024-04-12 20:00:00,38,283,3,1,325,63,302,3,1,369,25.8,96,3,3.3,694,False,20,101,585,6,2,2024-04-12,False,False,False,0.8429394812680115,0.14553314121037464,0.008645533141210375,0.002881844380403458,Shoulder,Friday,April
2024-04-12 21:00:00,119,429,3,1,552,68,335,3,1,407,27.0,93,3,11.8,959,False,21,187,764,6,2,2024-04-12,False,False,False,0.7966631908237748,0.19499478623566216,0.006256517205422315,0.0020855057351407717,Shoulder,Friday,April
2024-04-12 22:00:00,91,306,3,1,401,63,317,3,1,384,26.6,92,3,11.3,785,False,22,154,623,6,2,2024-04-12,False,False,False,0.7936305732484077,0.1961783439490446,0.007643312101910828,0.0025477707006369425,Shoulder,Friday,April
2024-04-12 23:00:00,116,395,4,2,517,29,473,3,1,506,26.2,94,3,9.1,1023,False,23,145,868,7,3,2024-04-12,False,False,False,0.8484848484848485,0.14173998044965788,0.006842619745845552,0.002932551319648094,Shoulder,Friday,April
2024-04-13 00:00:00,83,297,4,0,384,36,115,2,0,153,25.7,96,3,6.9,537,True,0,119,412,6,0,2024-04-13,False,False,False,0.7672253258845437,0.22160148975791433,0.0111731843575419,0.0,Off-Peak,Saturday,April
2024-04-13 01:00:00,132,161,5,0,298,43,136,3,1,183,25.3,97,3,5.0,481,True,1,175,297,8,1,2024-04-13,False,False,False,0.6174636174636174,0.36382536382536385,0.016632016632016633,0.002079002079002079,Off-Peak,Saturday,April
2024-04-13 02:00:00,43,127,3,0,173,37,118,2,0,157,24.9,98,3,4.3,330,True,2,80,245,5,0,2024-04-13,False,False,False,0.7424242424242424,0.24242424242424243,0.015151515151515152,0.0,Off-Peak,Saturday,April
2024-04-13 03:00:00,113,129,5,0,247,100,93,2,1,196,24.8,99,3,3.3,443,True,3,213,222,7,1,2024-04-13,False,False,False,0.5011286681715575,0.48081264108352145,0.01580135440180587,0.002257336343115124,Off-Peak,Saturday,April
2024-04-13 04:00:00,101,155,4,0,260,122,72,2,1,197,25.0,99,3,1.8,457,True,4,223,227,6,1,2024-04-13,False,False,False,0.49671772428884026,0.487964989059081,0.01312910284463895,0.002188183807439825,Off-Peak,Saturday,April
2024-04-13 05:00:00,117,197,4,0,318,129,90,3,1,223,24.7,98,3,3.3,541,True,5,246,287,7,1,2024-04-13,False,False,False,0.5304990757855823,0.45471349353049906,0.012939001848428836,0.0018484288354898336,Shoulder,Saturday,April
2024-04-13 06:00:00,68,232,3,0,303,32,528,3,1,564,24.7,95,2,5.0,867,True,6,100,760,6,1,2024-04-13,False,False,False,0.8765859284890427,0.11534025374855825,0.006920415224913495,0.0011534025374855825,Shoulder,Saturday,April
2024-04-13 07:00:00,42,645,3,0,690,151,623,3,1,778,24.9,93,3,6.0,1468,True,7,193,1268,6,1,2024-04-13,False,False,True,0.8637602179836512,0.13147138964577657,0.004087193460490463,0.0006811989100817438,Peak,Saturday,April
2024-04-13 08:00:00,60,435,4,0,499,121,487,3,1,612,25.9,90,3,9.3,1111,True,8,181,922,7,1,2024-04-13,False,False,False,0.8298829882988299,0.1629162916291629,0.0063006300630063005,0.0009000900090009,Peak,Saturday,April
2024-04-13 09:00:00,52,494,5,0,551,69,255,3,1,328,28.3,84,3,12.2,879,True,9,121,749,8,1,2024-04-13,False,False,False,0.8521046643913538,0.13765642775881684,0.009101251422070534,0.0011376564277588168,Shoulder,Saturday,April
2024-04-13 10:00:00,168,357,6,1,532,65,238,3,1,307,30.0,76,3,13.7,839,True,10,233,595,9,2,2024-04-13,False,False,False,0.7091775923718713,0.27771156138259834,0.010727056019070322,0.0023837902264600714,Shoulder,Saturday,April
2024-04-13 11:00:00,88,318,4,0,410,69,255,3,1,328,31.2,70,3,15.1,738,True,11,157,573,7,1,2024-04-13,False,False,False,0.7764227642276422,0.2127371273712737,0.009485094850948509,0.0013550135501355014,Peak,Saturday,April
2024-04-13 12:00:00,145,554,5,0,704,65,229,3,1,298,31.8,68,2,13.8,1002,True,12,210,783,8,1,2024-04-13,False,False,False,0.781437125748503,0.20958083832335328,0.007984031936127744,0.000998003992015968,Peak,Saturday,April
2024-04-13 13:00:00,78,271,4,0,353,143,585,3,1,732,32.8,64,51,8.9,1085,True,13,221,856,7,1,2024-04-13,False,False,False,0.7889400921658987,0.20368663594470046,0.0064516129032258064,0.0009216589861751152,Peak,Saturday,April
2024-04-13 14:00:00,79,278,4,0,361,137,550,3,1,691,31.9,67,51,7.5,1052,True,14,216,828,7,1,2024-04-13,False,False,False,0.7870722433460076,0.20532319391634982,0.006653992395437262,0.0009505703422053232,Peak,Saturday,April
2024-04-13 15:00:00,90,316,5,0,411,29,489,4,1,523,29.6,80,51,8.7,934,True,15,119,805,9,1,2024-04-13,False,False,False,0.8618843683083511,0.12740899357601712,0.009635974304068522,0.0010706638115631692,Peak,Saturday,April
2024-04-13 16:00:00,106,376,6,0,488,33,391,3,1,428,28.5,82,63,10.7,916,True,16,139,767,9,1,2024-04-13,False,False,False,0.8373362445414847,0.1517467248908297,0.009825327510917031,0.001091703056768559,Peak,Saturday,April
2024-04-13 17:00:00,142,532,5,0,679,120,475,3,1,599,27.9,86,51,8.7,1278,True,17,262,1007,8,1,2024-04-13,False,False,False,0.7879499217527387,0.20500782472613457,0.006259780907668232,0.000782472613458529,Peak,Saturday,April
2024-04-13 18:00:00,105,387,6,1,499,132,525,3,1,661,27.8,83,51,6.2,1160,True,18,237,912,9,2,2024-04-13,False,False,False,0.7862068965517242,0.2043103448275862,0.007758620689655172,0.0017241379310344827,Peak,Saturday,April
2024-04-13 19:00:00,134,498,6,1,639,29,86,3,1,119,27.2,84,3,3.0,758,True,19,163,584,9,2,2024-04-13,False,False,False,0.7704485488126649,0.21503957783641162,0.011873350923482849,0.002638522427440633,Peak,Saturday,April
2024-04-13 20:00:00,50,416,6,1,473,116,454,3,1,574,26.6,91,51,2.2,1047,True,20,166,870,9,2,2024-04-13,False,False,False,0.830945558739255,0.15854823304680038,0.008595988538681949,0.0019102196752626551,Shoulder,Saturday,April
2024-04-13 21:00:00,106,373,6,1,486,77,282,4,1,364,26.3,93,51,5.9,850,True,21,183,655,10,2,2024-04-13,False,False,False,0.7705882352941177,0.21529411764705883,0.011764705882352941,0.002352941176470588,Shoulder,Saturday,April
2024-04-13 22:00:00,129,467,6,1,603,148,592,3,1,744,25.4,95,3,9.9,1347,True,22,277,1059,9,2,2024-04-13,False,False,False,0.7861915367483296,0.2056421677802524,0.0066815144766146995,0.0014847809948032665,Shoulder,Saturday,April
2024-04-13 23:00:00,65,214,6,1,286,140,561,3,1,705,24.9,96,3,5.2,991,True,23,205,775,9,2,2024-04-13,False,False,False,0.7820383451059536,0.20686175580222,0.009081735620585268,0.0020181634712411706,Shoulder,Saturday,April
2024-04-14 00:00:00,48,186,1,0,235,48,338,1,0,387,24.8,96,3,6.8,622,True,0,96,524,2,0,2024-04-14,False,False,False,0.842443729903537,0.15434083601286175,0.003215434083601286,0.0,Off-Peak,Sunday,April
2024-04-14 01:00:00,107,157,1,0,265,107,132,1,0,240,24.6,97,3,8.1,505,True,1,214,289,2,0,2024-04-14,False,False,False,0.5722772277227722,0.42376237623762375,0.0039603960396039604,0.0,Off-Peak,Sunday,April
2024-04-14 02:00:00,95,97,1,0,193,95,97,1,0,193,24.4,98,3,2.9,386,True,2,190,194,2,0,2024-04-14,False,False,False,0.5025906735751295,0.49222797927461137,0.0051813471502590676,0.0,Off-Peak,Sunday,April
2024-04-14 03:00:00,38,95,2,1,136,38,95,2,1,136,24.5,99,3,5.7,272,True,3,76,190,4,2,2024-04-14,False,False,False,0.6985294117647058,0.27941176470588236,0.014705882352941176,0.007352941176470588,Off-Peak,Sunday,April
2024-04-14 04:00:00,124,92,1,1,218,124,58,1,1,184,24.4,98,3,3.4,402,True,4,248,150,2,2,2024-04-14,False,False,False,0.373134328358209,0.6169154228855721,0.004975124378109453,0.004975124378109453,Off-Peak,Sunday,April
2024-04-14 05:00:00,26,58,1,1,86,26,92,1,1,120,24.3,98,3,3.9,206,True,5,52,150,2,2,2024-04-14,False,False,False,0.7281553398058253,0.2524271844660194,0.009708737864077669,0.009708737864077669,Shoulder,Sunday,April
2024-04-14 06:00:00,119,132,1,1,253,119,386,1,1,507,24.6,98,3,4.3,760,True,6,238,518,2,2,2024-04-14,False,False,False,0.6815789473684211,0.3131578947368421,0.002631578947368421,0.002631578947368421,Shoulder,Sunday,April
2024-04-14 07:00:00,38,403,1,1,443,38,403,1,1,443,25.2,97,3,9.7,886,True,7,76,806,2,2,2024-04-14,False,False,False,0.909706546275395,0.08577878103837472,0.002257336343115124,0.002257336343115124,Peak,Sunday,April
2024-04-14 08:00:00,77,233,1,1,312,77,233,1,1,312,25.9,94,3,10.4,624,True,8,154,466,2,2,2024-04-14,False,False,False,0.7467948717948718,0.2467948717948718,0.003205128205128205,0.003205128205128205,Peak,Sunday,April
2024-04-14 09:00:00,81,244,1,1,327,81,244,1,1,327,25.7,93,65,5.5,654,True,9,162,488,2,2,2024-04-14,False,False,False,0.746177370030581,0.24770642201834864,0.0030581039755351682,0.0030581039755351682,Shoulder,Sunday,April
2024-04-14 10:00:00,55,338,1,1,395,55,157,1,1,214,25.7,91,61,6.2,609,True,10,110,495,2,2,2024-04-14,False,False,False,0.812807881773399,0.180623973727422,0.003284072249589491,0.003284072249589491,Shoulder,Sunday,April
2024-04-14 11:00:00,66,300,1,1,368,66,186,1,1,254,26.4,88,51,11.4,622,True,11,132,486,2,2,2024-04-14,False,False,False,0.7813504823151125,0.21221864951768488,0.003215434083601286,0.003215434083601286,Peak,Sunday,April
2024-04-14 12:00:00,37,386,1,1,425,37,300,1,1,339,28.1,83,51,11.9,764,True,12,74,686,2,2,2024-04-14,False,False,False,0.8979057591623036,0.0968586387434555,0.002617801047120419,0.002617801047120419,Peak,Sunday,April
2024-04-14 13:00:00,159,523,1,1,684,159,523,1,1,684,29.7,78,51,10.6,1368,True,13,318,1046,2,2,2024-04-14,False,False,False,0.7646198830409356,0.2324561403508772,0.0014619883040935672,0.0014619883040935672,Peak,Sunday,April
2024-04-14 14:00:00,67,196,2,1,266,67,196,2,1,266,31.1,72,51,8.2,532,True,14,134,392,4,2,2024-04-14,False,False,False,0.7368421052631579,0.2518796992481203,0.007518796992481203,0.0037593984962406013,Peak,Sunday,April
2024-04-14 15:00:00,136,440,2,1,579,136,440,2,1,579,31.4,71,51,5.8,1158,True,15,272,880,4,2,2024-04-14,False,False,False,0.7599309153713298,0.23488773747841105,0.0034542314335060447,0.0017271157167530224,Peak,Sunday,April
2024-04-14 16:00:00,125,400,2,1,528,125,400,2,1,528,29.4,74,61,8.3,1056,True,16,250,800,4,2,2024-04-14,False,False,False,0.7575757575757576,0.23674242424242425,0.003787878787878788,0.001893939393939394,Peak,Sunday,April
2024-04-14 17:00:00,93,288,2,1,384,93,288,2,1,384,27.4,87,61,8.7,768,True,17,186,576,4,2,2024-04-14,False,False,False,0.75,0.2421875,0.005208333333333333,0.0026041666666666665,Peak,Sunday,April
2024-04-14 18:00:00,84,254,3,2,343,84,254,3,2,343,26.9,91,53,5.6,686,True,18,168,508,6,4,2024-04-14,False,False,False,0.7405247813411079,0.24489795918367346,0.008746355685131196,0.0058309037900874635,Peak,Sunday,April
2024-04-14 19:00:00,68,192,2,1,263,68,192,2,1,263,26.8,92,51,3.1,526,True,19,136,384,4,2,2024-04-14,False,False,False,0.7300380228136882,0.2585551330798479,0.0076045627376425855,0.0038022813688212928,Peak,Sunday,April
2024-04-14 20:00:00,110,346,2,1,459,110,346,2,1,459,26.3,95,3,3.3,918,True,20,220,692,4,2,2024-04-14,False,False,False,0.7538126361655774,0.23965141612200436,0.004357298474945534,0.002178649237472767,Shoulder,Sunday,April
2024-04-14 21:00:00,91,281,2,1,375,91,281,2,1,375,26.5,95,51,9.9,750,True,21,182,562,4,2,2024-04-14,False,False,False,0.7493333333333333,0.24266666666666667,0.005333333333333333,0.0026666666666666666,Shoulder,Sunday,April
2024-04-14 22:00:00,96,297,2,1,396,96,297,2,1,396,25.6,96,63,6.8,792,True,22,192,594,4,2,2024-04-14,False,False,False,0.75,0.24242424242424243,0.005050505050505051,0.0025252525252525255,Shoulder,Sunday,April
2024-04-14 23:00:00,90,272,2,1,365,90,272,2,1,365,25.6,95,53,8.7,730,True,23,180,544,4,2,2024-04-14,False,False,False,0.7452054794520548,0.2465753424657534,0.005479452054794521,0.0027397260273972603,Shoulder,Sunday,April
2024-04-15 00:00:00,140,267,6,0,413,114,217,4,0,335,25.2,96,3,8.2,748,False,0,254,484,10,0,2024-04-15,True,True,False,0.6470588235294118,0.339572192513369,0.013368983957219251,0.0,Off-Peak,Monday,April
2024-04-15 01:00:00,148,190,6,0,344,80,213,4,0,297,25.0,96,3,8.4,641,False,1,228,403,10,0,2024-04-15,True,True,False,0.6287051482059283,0.35569422776911075,0.015600624024960999,0.0,Off-Peak,Monday,April
2024-04-15 02:00:00,73,183,5,0,261,98,152,4,0,254,24.8,97,3,6.6,515,False,2,171,335,9,0,2024-04-15,True,True,False,0.6504854368932039,0.3320388349514563,0.017475728155339806,0.0,Off-Peak,Monday,April
2024-04-15 03:00:00,72,123,6,0,201,50,134,3,0,187,24.8,97,3,7.8,388,False,3,122,257,9,0,2024-04-15,True,True,False,0.6623711340206185,0.31443298969072164,0.023195876288659795,0.0,Off-Peak,Monday,April
2024-04-15 04:00:00,175,155,6,0,336,32,103,3,0,138,25.0,96,3,7.0,474,False,4,207,258,9,0,2024-04-15,True,True,False,0.5443037974683544,0.43670886075949367,0.0189873417721519,0.0,Off-Peak,Monday,April
2024-04-15 05:00:00,55,552,5,0,612,85,453,5,0,543,24.9,97,3,7.7,1155,False,5,140,1005,10,0,2024-04-15,True,True,False,0.8701298701298701,0.12121212121212122,0.008658008658008658,0.0,Shoulder,Monday,April
2024-04-15 06:00:00,76,700,5,0,781,95,514,4,0,613,24.7,97,3,7.2,1394,False,6,171,1214,9,0,2024-04-15,True,True,True,0.8708751793400287,0.12266857962697274,0.006456241032998565,0.0,Shoulder,Monday,April
2024-04-15 07:00:00,141,586,7,0,734,108,624,5,0,737,24.8,96,3,9.4,1471,False,7,249,1210,12,0,2024-04-15,True,True,True,0.822569680489463,0.16927260367097213,0.008157715839564922,0.0,Peak,Monday,April
2024-04-15 08:00:00,182,728,6,1,917,75,401,3,0,479,25.5,94,3,10.1,1396,False,8,257,1129,9,1,2024-04-15,True,True,True,0.8087392550143266,0.1840974212034384,0.0064469914040114614,0.0007163323782234957,Peak,Monday,April
2024-04-15 09:00:00,108,404,7,1,520,98,527,4,0,629,26.3,93,51,11.2,1149,False,9,206,931,11,1,2024-04-15,True,True,False,0.8102697998259356,0.17928633594429938,0.009573542210617928,0.0008703220191470844,Shoulder,Monday,April
2024-04-15 10:00:00,52,119,5,1,177,50,558,3,0,611,27.6,88,3,8.6,788,False,10,102,677,8,1,2024-04-15,True,True,False,0.8591370558375635,0.12944162436548223,0.01015228426395939,0.0012690355329949238,Shoulder,Monday,April
2024-04-15 11:00:00,92,339,5,1,437,127,699,4,0,830,29.6,77,51,10.9,1267,False,11,219,1038,9,1,2024-04-15,True,True,False,0.819258089976322,0.1728492501973165,0.007103393843725336,0.0007892659826361484,Peak,Monday,April
2024-04-15 12:00:00,41,239,5,1,286,92,476,6,1,575,31.2,69,51,10.7,861,False,12,133,715,11,2,2024-04-15,True,True,False,0.8304297328687572,0.15447154471544716,0.012775842044134728,0.0023228803716608595,Peak,Monday,April
2024-04-15 13:00:00,123,463,6,1,593,100,539,6,0,645,31.5,68,51,8.9,1238,False,13,223,1002,12,1,2024-04-15,True,True,False,0.8093699515347335,0.1801292407108239,0.009693053311793215,0.0008077544426494346,Peak,Monday,April
2024-04-15 14:00:00,109,416,6,1,532,106,564,6,0,676,31.9,66,51,6.7,1208,False,14,215,980,12,1,2024-04-15,True,True,False,0.8112582781456954,0.17798013245033112,0.009933774834437087,0.0008278145695364238,Peak,Monday,April
2024-04-15 15:00:00,199,803,6,1,1009,75,399,5,0,479,31.5,71,51,7.6,1488,False,15,274,1202,11,1,2024-04-15,True,True,True,0.8077956989247311,0.18413978494623656,0.00739247311827957,0.0006720430107526882,Peak,Monday,April
2024-04-15 16:00:00,154,602,7,1,764,51,435,4,1,491,30.4,75,63,11.3,1255,False,16,205,1037,11,2,2024-04-15,True,True,False,0.8262948207171315,0.16334661354581673,0.008764940239043825,0.0015936254980079682,Peak,Monday,April
2024-04-15 17:00:00,174,681,7,1,863,27,522,4,1,554,27.4,86,65,6.0,1417,False,17,201,1203,11,2,2024-04-15,True,True,True,0.8489767113620325,0.14184897671136204,0.0077628793225123505,0.0014114326040931546,Peak,Monday,April
2024-04-15 18:00:00,144,553,7,1,705,46,222,4,1,273,26.9,88,53,4.7,978,False,18,190,775,11,2,2024-04-15,True,True,False,0.7924335378323109,0.19427402862985685,0.011247443762781187,0.002044989775051125,Peak,Monday,April
2024-04-15 19:00:00,94,347,7,1,449,124,671,5,1,801,27.1,86,51,0.8,1250,False,19,218,1018,12,2,2024-04-15,True,True,False,0.8144,0.1744,0.0096,0.0016,Peak,Monday,April
2024-04-15 20:00:00,56,552,7,1,616,126,686,6,1,819,26.5,91,3,3.3,1435,False,20,182,1238,13,2,2024-04-15,True,True,True,0.8627177700348432,0.12682926829268293,0.009059233449477353,0.0013937282229965157,Shoulder,Monday,April
2024-04-15 21:00:00,119,446,8,1,574,103,565,5,1,674,26.2,96,51,4.0,1248,False,21,222,1011,13,2,2024-04-15,True,True,False,0.8100961538461539,0.1778846153846154,0.010416666666666666,0.0016025641025641025,Shoulder,Monday,April
2024-04-15 22:00:00,40,275,7,1,323,58,282,6,1,347,26.0,95,51,11.1,670,False,22,98,557,13,2,2024-04-15,True,True,False,0.8313432835820895,0.14626865671641792,0.019402985074626865,0.0029850746268656717,Shoulder,Monday,April
2024-04-15 23:00:00,133,482,9,2,626,36,249,5,1,291,26.0,93,3,4.8,917,False,23,169,731,14,3,2024-04-15,True,True,False,0.797164667393675,0.18429661941112324,0.015267175572519083,0.003271537622682661,Shoulder,Monday,April
2024-04-16 00:00:00,169,196,6,0,371,75,186,3,0,264,26.0,93,3,7.6,635,False,0,244,382,9,0,2024-04-16,False,False,False,0.6015748031496063,0.384251968503937,0.014173228346456693,0.0,Off-Peak,Tuesday,April
2024-04-16 01:00:00,115,192,5,0,312,65,165,3,0,233,25.8,93,3,6.4,545,False,1,180,357,8,0,2024-04-16,False,False,False,0.655045871559633,0.3302752293577982,0.014678899082568808,0.0,Off-Peak,Tuesday,April
2024-04-16 02:00:00,148,188,5,0,341,28,112,3,0,143,25.5,94,3,6.4,484,False,2,176,300,8,0,2024-04-16,False,False,False,0.6198347107438017,0.36363636363636365,0.01652892561983471,0.0,Off-Peak,Tuesday,April
2024-04-16 03:00:00,108,167,5,0,280,73,99,3,0,175,25.3,95,3,5.1,455,False,3,181,266,8,0,2024-04-16,False,False,False,0.5846153846153846,0.3978021978021978,0.017582417582417582,0.0,Off-Peak,Tuesday,April
2024-04-16 04:00:00,57,165,6,0,228,65,90,4,1,160,25.0,96,3,6.9,388,False,4,122,255,10,1,2024-04-16,False,False,False,0.6572164948453608,0.31443298969072164,0.02577319587628866,0.002577319587628866,Off-Peak,Tuesday,April
2024-04-16 05:00:00,130,258,5,0,393,110,592,5,2,709,25.0,96,3,4.7,1102,False,5,240,850,10,2,2024-04-16,False,False,False,0.7713248638838476,0.2177858439201452,0.009074410163339383,0.0018148820326678765,Shoulder,Tuesday,April
2024-04-16 06:00:00,71,504,4,0,579,136,750,4,1,891,24.5,97,2,5.4,1470,False,6,207,1254,8,1,2024-04-16,False,False,True,0.8530612244897959,0.14081632653061224,0.005442176870748299,0.0006802721088435374,Shoulder,Tuesday,April
2024-04-16 07:00:00,168,678,6,0,852,38,572,3,1,614,24.7,96,1,4.1,1466,False,7,206,1250,9,1,2024-04-16,False,False,True,0.8526603001364257,0.14051841746248295,0.006139154160982265,0.0006821282401091405,Peak,Tuesday,April
2024-04-16 08:00:00,52,585,5,0,642,108,414,4,1,527,25.7,93,2,5.7,1169,False,8,160,999,9,1,2024-04-16,False,False,False,0.8545765611633875,0.13686911890504705,0.007698887938408896,0.000855431993156544,Peak,Tuesday,April
2024-04-16 09:00:00,141,561,6,0,708,82,317,4,1,404,27.1,91,3,2.6,1112,False,9,223,878,10,1,2024-04-16,False,False,False,0.789568345323741,0.20053956834532374,0.008992805755395683,0.0008992805755395684,Shoulder,Tuesday,April
2024-04-16 10:00:00,149,585,7,0,741,126,665,5,1,797,28.9,85,3,8.9,1538,False,10,275,1250,12,1,2024-04-16,False,False,True,0.812743823146944,0.1788036410923277,0.007802340702210663,0.0006501950585175553,Shoulder,Tuesday,April
2024-04-16 11:00:00,70,253,5,0,328,126,673,4,1,804,30.3,78,51,7.0,1132,False,11,196,926,9,1,2024-04-16,False,False,False,0.8180212014134276,0.17314487632508835,0.007950530035335688,0.0008833922261484099,Peak,Tuesday,April
2024-04-16 12:00:00,153,603,6,1,763,27,369,3,1,400,31.5,70,3,7.2,1163,False,12,180,972,9,2,2024-04-16,False,False,False,0.8357695614789338,0.15477214101461736,0.007738607050730868,0.0017196904557179708,Peak,Tuesday,April
2024-04-16 13:00:00,72,253,5,1,331,124,647,4,1,776,31.4,70,51,4.0,1107,False,13,196,900,9,2,2024-04-16,False,False,False,0.8130081300813008,0.17705510388437218,0.008130081300813009,0.0018066847335140017,Peak,Tuesday,April
2024-04-16 14:00:00,145,675,6,1,827,43,197,4,1,245,28.9,83,61,12.1,1072,False,14,188,872,10,2,2024-04-16,False,False,False,0.8134328358208955,0.17537313432835822,0.009328358208955223,0.0018656716417910447,Peak,Tuesday,April
2024-04-16 15:00:00,57,575,7,1,640,101,533,5,1,640,28.5,85,51,11.6,1280,False,15,158,1108,12,2,2024-04-16,False,False,False,0.865625,0.1234375,0.009375,0.0015625,Peak,Tuesday,April
2024-04-16 16:00:00,78,281,5,1,365,111,579,6,1,697,28.6,84,51,4.3,1062,False,16,189,860,11,2,2024-04-16,False,False,False,0.8097928436911488,0.17796610169491525,0.010357815442561206,0.0018832391713747645,Peak,Tuesday,April
2024-04-16 17:00:00,136,534,6,1,677,101,523,5,1,630,27.9,84,53,8.0,1307,False,17,237,1057,11,2,2024-04-16,False,False,False,0.8087222647283856,0.18133129303749043,0.008416220351951033,0.001530221882172915,Peak,Tuesday,April
2024-04-16 18:00:00,143,559,6,1,709,91,460,5,1,557,25.9,91,63,3.7,1266,False,18,234,1019,11,2,2024-04-16,False,False,False,0.8048973143759873,0.1848341232227488,0.008688783570300158,0.001579778830963665,Peak,Tuesday,April
2024-04-16 19:00:00,104,400,7,2,513,41,385,4,1,431,25.5,95,63,3.9,944,False,19,145,785,11,3,2024-04-16,False,False,False,0.8315677966101694,0.15360169491525424,0.011652542372881356,0.0031779661016949155,Peak,Tuesday,April
2024-04-16 20:00:00,50,416,6,1,473,26,327,5,1,359,25.4,95,63,0.8,832,False,20,76,743,11,2,2024-04-16,False,False,False,0.8930288461538461,0.09134615384615384,0.013221153846153846,0.002403846153846154,Shoulder,Tuesday,April
2024-04-16 21:00:00,102,362,9,1,474,83,412,5,1,501,26.1,97,51,5.2,975,False,21,185,774,14,2,2024-04-16,False,False,False,0.7938461538461539,0.18974358974358974,0.014358974358974359,0.0020512820512820513,Shoulder,Tuesday,April
2024-04-16 22:00:00,134,517,7,1,659,99,506,6,1,612,25.8,94,3,6.5,1271,False,22,233,1023,13,2,2024-04-16,False,False,False,0.8048780487804879,0.18332022029897718,0.010228166797797011,0.0015735641227380016,Shoulder,Tuesday,April
2024-04-16 23:00:00,61,454,6,1,522,79,388,7,1,475,25.3,95,3,5.2,997,False,23,140,842,13,2,2024-04-16,False,False,False,0.8445336008024072,0.14042126379137412,0.013039117352056168,0.0020060180541624875,Shoulder,Tuesday,April
2024-04-17 00:00:00,170,361,6,0,537,122,265,4,0,391,25.3,94,3,4.3,928,False,0,292,626,10,0,2024-04-17,False,False,False,0.6745689655172413,0.3146551724137931,0.010775862068965518,0.0,Off-Peak,Wednesday,April
2024-04-17 01:00:00,120,272,5,0,397,54,195,3,0,252,25.4,93,3,6.1,649,False,1,174,467,8,0,2024-04-17,False,False,False,0.7195685670261941,0.26810477657935283,0.012326656394453005,0.0,Off-Peak,Wednesday,April
2024-04-17 02:00:00,169,249,5,0,423,120,197,4,0,321,24.8,96,63,2.7,744,False,2,289,446,9,0,2024-04-17,False,False,False,0.5994623655913979,0.38844086021505375,0.012096774193548387,0.0,Off-Peak,Wednesday,April
2024-04-17 03:00:00,214,180,6,1,401,88,164,5,0,257,25.0,96,51,3.9,658,False,3,302,344,11,1,2024-04-17,False,False,False,0.5227963525835866,0.45896656534954405,0.016717325227963525,0.001519756838905775,Off-Peak,Wednesday,April
2024-04-17 04:00:00,72,150,5,0,227,79,129,5,0,213,25.0,97,51,1.1,440,False,4,151,279,10,0,2024-04-17,False,False,False,0.634090909090909,0.3431818181818182,0.022727272727272728,0.0,Off-Peak,Wednesday,April
2024-04-17 05:00:00,85,310,4,0,399,66,338,5,0,409,25.1,96,51,2.7,808,False,5,151,648,9,0,2024-04-17,False,False,False,0.801980198019802,0.18688118811881188,0.011138613861386138,0.0,Shoulder,Wednesday,April
2024-04-17 06:00:00,95,546,5,0,646,72,656,3,0,731,25.4,94,51,3.1,1377,False,6,167,1202,8,0,2024-04-17,False,False,True,0.8729121278140886,0.12127814088598403,0.005809731299927378,0.0,Shoulder,Wednesday,April
2024-04-17 07:00:00,60,708,6,0,774,96,531,4,0,631,24.9,96,63,6.8,1405,False,7,156,1239,10,0,2024-04-17,False,False,True,0.8818505338078292,0.1110320284697509,0.0071174377224199285,0.0,Peak,Wednesday,April
2024-04-17 08:00:00,135,546,5,0,686,42,396,3,0,441,25.1,96,51,1.1,1127,False,8,177,942,8,0,2024-04-17,False,False,False,0.8358473824312334,0.15705412599822538,0.00709849157054126,0.0,Peak,Wednesday,April
2024-04-17 09:00:00,151,456,9,0,616,61,308,3,0,372,25.8,93,51,2.5,988,False,9,212,764,12,0,2024-04-17,False,False,False,0.7732793522267206,0.2145748987854251,0.012145748987854251,0.0,Shoulder,Wednesday,April
2024-04-17 10:00:00,177,581,7,0,765,122,646,6,1,775,26.6,91,51,6.2,1540,False,10,299,1227,13,1,2024-04-17,False,False,True,0.7967532467532468,0.19415584415584416,0.008441558441558441,0.0006493506493506494,Shoulder,Wednesday,April
2024-04-17 11:00:00,109,420,5,0,534,105,574,4,0,683,27.4,88,51,6.1,1217,False,11,214,994,9,0,2024-04-17,False,False,False,0.8167625308134757,0.17584223500410848,0.007395234182415777,0.0,Peak,Wednesday,April
2024-04-17 12:00:00,198,637,6,0,841,65,331,3,0,399,28.7,81,51,4.0,1240,False,12,263,968,9,0,2024-04-17,False,False,False,0.7806451612903226,0.2120967741935484,0.007258064516129033,0.0,Peak,Wednesday,April
2024-04-17 13:00:00,121,389,6,1,517,108,576,4,1,689,29.7,78,51,2.2,1206,False,13,229,965,10,2,2024-04-17,False,False,False,0.8001658374792703,0.18988391376451078,0.008291873963515755,0.001658374792703151,Peak,Wednesday,April
2024-04-17 14:00:00,142,424,5,1,572,116,626,4,1,747,30.4,75,51,0.8,1319,False,14,258,1050,9,2,2024-04-17,False,False,False,0.796057619408643,0.1956027293404094,0.006823351023502654,0.001516300227445034,Peak,Wednesday,April
2024-04-17 15:00:00,100,284,5,1,390,54,647,3,1,705,30.5,74,51,5.0,1095,False,15,154,931,8,2,2024-04-17,False,False,False,0.8502283105022831,0.14063926940639268,0.0073059360730593605,0.0018264840182648401,Peak,Wednesday,April
2024-04-17 16:00:00,188,625,6,1,820,103,561,5,1,670,30.5,75,51,4.9,1490,False,16,291,1186,11,2,2024-04-17,False,False,True,0.7959731543624161,0.1953020134228188,0.00738255033557047,0.0013422818791946308,Peak,Wednesday,April
2024-04-17 17:00:00,123,355,6,1,485,33,450,5,1,489,30.2,76,51,3.6,974,False,17,156,805,11,2,2024-04-17,False,False,False,0.8264887063655031,0.1601642710472279,0.011293634496919919,0.002053388090349076,Peak,Wednesday,April
2024-04-17 18:00:00,98,270,6,1,375,71,358,4,1,434,29.4,80,53,6.4,809,False,18,169,628,10,2,2024-04-17,False,False,False,0.7762669962917181,0.2088998763906057,0.012360939431396786,0.002472187886279357,Peak,Wednesday,April
2024-04-17 19:00:00,262,879,7,1,1149,66,303,5,1,375,28.3,85,3,7.4,1524,False,19,328,1182,12,2,2024-04-17,False,False,True,0.7755905511811023,0.2152230971128609,0.007874015748031496,0.0013123359580052493,Peak,Wednesday,April
2024-04-17 20:00:00,77,206,6,1,290,93,477,5,1,576,27.8,87,3,4.4,866,False,20,170,683,11,2,2024-04-17,False,False,False,0.7886836027713626,0.19630484988452657,0.012702078521939953,0.0023094688221709007,Shoulder,Wednesday,April
2024-04-17 21:00:00,160,516,6,1,683,43,431,4,1,479,27.4,93,3,3.1,1162,False,21,203,947,10,2,2024-04-17,False,False,False,0.814974182444062,0.1746987951807229,0.008605851979345954,0.0017211703958691911,Shoulder,Wednesday,April
2024-04-17 22:00:00,95,281,6,1,383,37,250,5,1,293,26.1,95,63,6.8,676,False,22,132,531,11,2,2024-04-17,False,False,False,0.7855029585798816,0.1952662721893491,0.016272189349112426,0.0029585798816568047,Shoulder,Wednesday,April
2024-04-17 23:00:00,91,251,7,1,350,94,487,6,1,588,25.8,95,51,2.9,938,False,23,185,738,13,2,2024-04-17,False,False,False,0.7867803837953091,0.19722814498933902,0.013859275053304905,0.0021321961620469083,Shoulder,Wednesday,April
2024-04-18 00:00:00,205,226,8,0,439,116,313,5,0,434,25.5,96,3,2.2,873,False,0,321,539,13,0,2024-04-18,False,False,False,0.6174112256586484,0.36769759450171824,0.014891179839633447,0.0,Off-Peak,Thursday,April
2024-04-18 01:00:00,122,235,6,0,363,93,277,3,0,373,25.3,97,3,3.9,736,False,1,215,512,9,0,2024-04-18,False,False,False,0.6956521739130435,0.2921195652173913,0.012228260869565218,0.0,Off-Peak,Thursday,April
2024-04-18 02:00:00,85,127,7,0,219,60,196,4,0,260,25.1,97,3,4.7,479,False,2,145,323,11,0,2024-04-18,False,False,False,0.6743215031315241,0.302713987473904,0.022964509394572025,0.0,Off-Peak,Thursday,April
2024-04-18 03:00:00,81,94,6,0,181,40,171,4,0,215,24.9,97,3,5.1,396,False,3,121,265,10,0,2024-04-18,False,False,False,0.6691919191919192,0.3055555555555556,0.025252525252525252,0.0,Off-Peak,Thursday,April
2024-04-18 04:00:00,72,272,6,0,350,97,156,4,0,257,24.7,98,3,3.0,607,False,4,169,428,10,0,2024-04-18,False,False,False,0.7051070840197694,0.2784184514003295,0.016474464579901153,0.0,Off-Peak,Thursday,April
2024-04-18 05:00:00,41,431,6,0,478,46,194,3,0,243,24.5,98,3,3.0,721,False,5,87,625,9,0,2024-04-18,False,False,False,0.8668515950069348,0.12066574202496533,0.012482662968099861,0.0,Shoulder,Thursday,April
2024-04-18 06:00:00,115,404,6,0,525,41,159,3,0,203,24.6,98,3,2.6,728,False,6,156,563,9,0,2024-04-18,False,False,False,0.7733516483516484,0.21428571428571427,0.012362637362637362,0.0,Shoulder,Thursday,April
2024-04-18 07:00:00,128,614,5,0,747,127,667,4,0,798,24.3,98,63,7.1,1545,False,7,255,1281,9,0,2024-04-18,False,False,True,0.829126213592233,0.1650485436893204,0.005825242718446602,0.0,Peak,Thursday,April
2024-04-18 08:00:00,166,582,6,0,754,115,206,4,0,325,24.0,97,63,7.2,1079,False,8,281,788,10,0,2024-04-18,False,False,False,0.7303058387395737,0.26042632066728455,0.009267840593141797,0.0,Peak,Thursday,April
2024-04-18 09:00:00,142,490,6,0,638,34,466,5,0,505,24.2,99,63,13.8,1143,False,9,176,956,11,0,2024-04-18,False,False,False,0.8363954505686789,0.15398075240594924,0.009623797025371828,0.0,Shoulder,Thursday,April
2024-04-18 10:00:00,135,218,5,0,358,123,612,5,0,740,25.1,95,51,7.3,1098,False,10,258,830,10,0,2024-04-18,False,False,False,0.75591985428051,0.23497267759562843,0.009107468123861567,0.0,Shoulder,Thursday,April
2024-04-18 11:00:00,172,255,6,0,433,41,170,4,0,215,26.3,91,3,6.1,648,False,11,213,425,10,0,2024-04-18,False,False,False,0.6558641975308642,0.3287037037037037,0.015432098765432098,0.0,Peak,Thursday,April
2024-04-18 12:00:00,147,506,7,0,660,77,375,4,0,456,28.1,86,3,6.1,1116,False,12,224,881,11,0,2024-04-18,False,False,False,0.7894265232974911,0.2007168458781362,0.00985663082437276,0.0,Peak,Thursday,April
2024-04-18 13:00:00,50,464,7,0,521,41,485,4,0,530,29.8,80,3,1.1,1051,False,13,91,949,11,0,2024-04-18,False,False,False,0.9029495718363464,0.08658420551855375,0.010466222645099905,0.0,Peak,Thursday,April
2024-04-18 14:00:00,130,442,7,0,579,37,631,5,0,673,30.5,76,51,3.0,1252,False,14,167,1073,12,0,2024-04-18,False,False,False,0.8570287539936102,0.13338658146964857,0.009584664536741214,0.0,Peak,Thursday,April
2024-04-18 15:00:00,190,666,7,0,863,123,645,6,0,774,30.4,75,51,6.9,1637,False,15,313,1311,13,0,2024-04-18,False,False,True,0.8008552229688455,0.1912034208918754,0.00794135613927917,0.0,Peak,Thursday,April
2024-04-18 16:00:00,106,715,6,0,827,132,700,7,1,840,30.1,76,53,7.6,1667,False,16,238,1415,13,1,2024-04-18,False,False,True,0.8488302339532093,0.14277144571085784,0.007798440311937612,0.0005998800239952009,Peak,Thursday,April
2024-04-18 17:00:00,77,374,7,2,460,63,641,5,1,710,29.8,78,51,8.3,1170,False,17,140,1015,12,3,2024-04-18,False,False,False,0.8675213675213675,0.11965811965811966,0.010256410256410256,0.002564102564102564,Peak,Thursday,April
2024-04-18 18:00:00,103,331,7,1,442,141,783,5,1,930,29.2,79,3,8.8,1372,False,18,244,1114,12,2,2024-04-18,False,False,False,0.8119533527696793,0.17784256559766765,0.008746355685131196,0.0014577259475218659,Peak,Thursday,April
2024-04-18 19:00:00,166,567,9,1,743,91,468,5,1,565,28.3,83,3,6.2,1308,False,19,257,1035,14,2,2024-04-18,False,False,False,0.7912844036697247,0.19648318042813456,0.010703363914373088,0.0015290519877675841,Peak,Thursday,April
2024-04-18 20:00:00,161,551,9,1,722,45,128,5,1,179,27.8,84,3,5.4,901,False,20,206,679,14,2,2024-04-18,False,False,False,0.753607103218646,0.2286348501664817,0.01553829078801332,0.0022197558268590455,Shoulder,Thursday,April
2024-04-18 21:00:00,201,707,9,1,918,97,485,6,1,589,28.2,85,3,7.5,1507,False,21,298,1192,15,2,2024-04-18,False,False,True,0.7909754479097545,0.19774386197743862,0.009953550099535502,0.0013271400132714001,Shoulder,Thursday,April
2024-04-18 22:00:00,137,451,7,1,596,115,605,7,1,728,28.0,88,3,4.9,1324,False,22,252,1056,14,2,2024-04-18,False,False,False,0.797583081570997,0.1903323262839879,0.010574018126888218,0.0015105740181268882,Shoulder,Thursday,April
2024-04-18 23:00:00,77,345,7,1,430,105,534,6,1,646,27.0,93,3,6.5,1076,False,23,182,879,13,2,2024-04-18,False,False,False,0.8169144981412639,0.1691449814126394,0.012081784386617101,0.0018587360594795538,Shoulder,Thursday,April
2024-04-19 00:00:00,97,571,7,0,675,85,314,4,0,403,27.7,89,3,2.9,1078,False,0,182,885,11,0,2024-04-19,False,False,False,0.8209647495361782,0.16883116883116883,0.01020408163265306,0.0,Off-Peak,Friday,April
2024-04-19 01:00:00,61,415,7,0,483,51,225,5,0,281,25.9,95,55,5.0,764,False,1,112,640,12,0,2024-04-19,False,False,False,0.837696335078534,0.14659685863874344,0.015706806282722512,0.0,Off-Peak,Friday,April
2024-04-19 02:00:00,49,139,6,0,194,40,122,5,0,167,25.4,95,51,5.9,361,False,2,89,261,11,0,2024-04-19,False,False,False,0.7229916897506925,0.24653739612188366,0.030470914127423823,0.0,Off-Peak,Friday,April
2024-04-19 03:00:00,70,185,8,0,263,24,117,6,0,147,25.3,96,51,6.2,410,False,3,94,302,14,0,2024-04-19,False,False,False,0.7365853658536585,0.22926829268292684,0.03414634146341464,0.0,Off-Peak,Friday,April
2024-04-19 04:00:00,62,189,8,1,260,24,420,5,0,449,24.9,98,51,2.8,709,False,4,86,609,13,1,2024-04-19,False,False,False,0.8589562764456982,0.12129760225669958,0.018335684062059238,0.0014104372355430183,Off-Peak,Friday,April
2024-04-19 05:00:00,202,150,6,0,358,71,452,5,0,528,25.1,97,51,4.2,886,False,5,273,602,11,0,2024-04-19,False,False,False,0.6794582392776524,0.30812641083521447,0.012415349887133182,0.0,Shoulder,Friday,April
2024-04-19 06:00:00,184,180,8,0,372,71,431,5,0,507,25.1,98,51,4.1,879,False,6,255,611,13,0,2024-04-19,False,False,False,0.6951080773606371,0.2901023890784983,0.01478953356086462,0.0,Shoulder,Friday,April
2024-04-19 07:00:00,130,730,7,0,867,92,582,5,0,679,24.9,98,3,5.0,1546,False,7,222,1312,12,0,2024-04-19,False,False,True,0.8486416558861578,0.14359637774902975,0.007761966364812419,0.0,Peak,Friday,April
2024-04-19 08:00:00,157,663,7,0,827,76,601,5,0,682,25.4,97,3,5.5,1509,False,8,233,1264,12,0,2024-04-19,False,False,True,0.8376408217362492,0.15440689198144467,0.007952286282306162,0.0,Peak,Friday,April
2024-04-19 09:00:00,64,557,6,0,627,96,568,5,0,669,26.7,95,51,5.6,1296,False,9,160,1125,11,0,2024-04-19,False,False,False,0.8680555555555556,0.12345679012345678,0.008487654320987654,0.0,Shoulder,Friday,April
2024-04-19 10:00:00,138,484,9,0,631,88,529,4,0,621,27.9,92,3,1.8,1252,False,10,226,1013,13,0,2024-04-19,False,False,False,0.8091054313099042,0.1805111821086262,0.010383386581469648,0.0,Shoulder,Friday,April
2024-04-19 11:00:00,118,450,6,1,575,98,391,5,1,495,28.6,89,3,6.6,1070,False,11,216,841,11,2,2024-04-19,False,False,False,0.7859813084112149,0.20186915887850468,0.010280373831775701,0.001869158878504673,Peak,Friday,April
2024-04-19 12:00:00,159,213,7,1,380,91,473,4,1,569,29.1,86,51,6.2,949,False,12,250,686,11,2,2024-04-19,False,False,False,0.7228661749209695,0.26343519494204426,0.011591148577449948,0.002107481559536354,Peak,Friday,April
2024-04-19 13:00:00,219,790,10,1,1020,87,551,5,1,644,29.2,84,51,6.3,1664,False,13,306,1341,15,2,2024-04-19,False,False,True,0.8058894230769231,0.18389423076923078,0.009014423076923076,0.001201923076923077,Peak,Friday,April
2024-04-19 14:00:00,109,366,8,1,484,45,248,5,1,299,30.2,76,51,5.4,783,False,14,154,614,13,2,2024-04-19,False,False,False,0.7841634738186463,0.1966794380587484,0.016602809706257982,0.002554278416347382,Peak,Friday,April
2024-04-19 15:00:00,68,205,6,1,280,93,577,6,1,677,30.6,73,51,4.0,957,False,15,161,782,12,2,2024-04-19,False,False,False,0.8171368861024033,0.16823406478578892,0.012539184952978056,0.0020898641588296763,Peak,Friday,April
2024-04-19 16:00:00,112,369,8,1,490,95,600,7,2,704,31.0,71,51,5.4,1194,False,16,207,969,15,3,2024-04-19,False,False,False,0.8115577889447236,0.17336683417085427,0.01256281407035176,0.002512562814070352,Peak,Friday,April
2024-04-19 17:00:00,150,523,11,1,685,91,590,6,1,688,30.8,70,51,4.9,1373,False,17,241,1113,17,2,2024-04-19,False,False,False,0.8106336489439184,0.1755280407865987,0.012381646030589949,0.0014566642388929353,Peak,Friday,April
2024-04-19 18:00:00,108,361,8,1,478,56,633,7,1,697,29.3,77,63,4.7,1175,False,18,164,994,15,2,2024-04-19,False,False,False,0.8459574468085106,0.13957446808510637,0.01276595744680851,0.001702127659574468,Peak,Friday,April
2024-04-19 19:00:00,133,469,8,1,611,52,309,6,1,368,28.5,85,3,4.0,979,False,19,185,778,14,2,2024-04-19,False,False,False,0.7946884576098059,0.18896833503575078,0.014300306435137897,0.0020429009193054137,Peak,Friday,April
2024-04-19 20:00:00,226,827,10,1,1064,59,342,7,1,409,28.0,86,3,5.6,1473,False,20,285,1169,17,2,2024-04-19,False,False,True,0.7936184657162254,0.1934826883910387,0.011541072640868975,0.0013577732518669382,Shoulder,Friday,April
2024-04-19 21:00:00,125,426,9,1,561,55,319,6,1,381,26.5,92,3,5.8,942,False,21,180,745,15,2,2024-04-19,False,False,False,0.7908704883227177,0.1910828025477707,0.01592356687898089,0.0021231422505307855,Shoulder,Friday,April
2024-04-19 22:00:00,182,648,10,1,841,69,551,5,1,626,26.8,90,51,9.9,1467,False,22,251,1199,15,2,2024-04-19,False,False,True,0.8173142467620995,0.1710974778459441,0.010224948875255624,0.0013633265167007499,Shoulder,Friday,April
2024-04-19 23:00:00,52,325,7,1,385,69,290,8,1,368,26.8,95,51,5.8,753,False,23,121,615,15,2,2024-04-19,False,False,False,0.8167330677290837,0.16069057104913678,0.0199203187250996,0.0026560424966799467,Shoulder,Friday,April
2024-04-20 00:00:00,180,365,4,0,549,111,292,3,0,406,26.8,96,51,3.3,955,True,0,291,657,7,0,2024-04-20,False,False,False,0.6879581151832461,0.30471204188481676,0.007329842931937173,0.0,Off-Peak,Saturday,April
2024-04-20 01:00:00,101,257,4,0,362,53,187,2,0,242,26.6,97,51,7.0,604,True,1,154,444,6,0,2024-04-20,False,False,False,0.7350993377483444,0.25496688741721857,0.009933774834437087,0.0,Off-Peak,Saturday,April
2024-04-20 02:00:00,71,163,3,0,237,70,140,2,0,212,26.0,96,3,6.1,449,True,2,141,303,5,0,2024-04-20,False,False,False,0.6748329621380846,0.31403118040089084,0.011135857461024499,0.0,Off-Peak,Saturday,April
2024-04-20 03:00:00,43,76,5,0,124,73,132,4,0,209,25.6,96,3,4.1,333,True,3,116,208,9,0,2024-04-20,False,False,False,0.6246246246246246,0.3483483483483483,0.02702702702702703,0.0,Off-Peak,Saturday,April
2024-04-20 04:00:00,65,72,3,0,140,78,96,3,0,177,25.4,96,3,5.3,317,True,4,143,168,6,0,2024-04-20,False,False,False,0.5299684542586751,0.45110410094637227,0.01892744479495268,0.0,Off-Peak,Saturday,April
2024-04-20 05:00:00,156,153,5,0,314,43,146,3,0,192,25.4,93,0,5.8,506,True,5,199,299,8,0,2024-04-20,False,False,False,0.5909090909090909,0.3932806324110672,0.015810276679841896,0.0,Shoulder,Saturday,April
2024-04-20 06:00:00,132,487,4,0,623,81,269,3,0,353,25.2,93,2,5.2,976,True,6,213,756,7,0,2024-04-20,False,False,False,0.7745901639344263,0.2182377049180328,0.007172131147540984,0.0,Shoulder,Saturday,April
2024-04-20 07:00:00,193,526,5,0,724,60,496,3,0,559,24.8,94,2,3.3,1283,True,7,253,1022,8,0,2024-04-20,False,False,False,0.7965705378020265,0.19719407638347622,0.006235385814497272,0.0,Peak,Saturday,April
2024-04-20 08:00:00,185,504,4,1,694,48,436,3,1,488,25.3,93,61,5.2,1182,True,8,233,940,7,2,2024-04-20,False,False,False,0.7952622673434856,0.19712351945854484,0.005922165820642978,0.001692047377326565,Peak,Saturday,April
2024-04-20 09:00:00,190,518,4,1,713,97,368,3,1,469,26.1,94,51,15.5,1182,True,9,287,886,7,2,2024-04-20,False,False,False,0.7495769881556683,0.2428087986463621,0.005922165820642978,0.001692047377326565,Shoulder,Saturday,April
2024-04-20 10:00:00,145,388,4,1,538,125,202,3,1,331,26.4,93,53,11.4,869,True,10,270,590,7,2,2024-04-20,False,False,False,0.6789413118527042,0.31070195627157654,0.00805523590333717,0.0023014959723820483,Shoulder,Saturday,April
2024-04-20 11:00:00,148,391,6,2,547,92,348,3,1,444,26.1,93,63,6.5,991,True,11,240,739,9,3,2024-04-20,False,False,False,0.7457114026236125,0.24217961654894046,0.009081735620585268,0.0030272452068617556,Peak,Saturday,April
2024-04-20 12:00:00,128,336,5,1,470,100,383,3,1,487,26.8,90,61,3.1,957,True,12,228,719,8,2,2024-04-20,False,False,False,0.7513061650992685,0.23824451410658307,0.008359456635318705,0.0020898641588296763,Peak,Saturday,April
2024-04-20 13:00:00,97,243,4,1,345,120,460,3,1,584,28.1,86,51,10.1,929,True,13,217,703,7,2,2024-04-20,False,False,False,0.7567276641550054,0.23358449946178686,0.007534983853606028,0.002152852529601722,Peak,Saturday,April
2024-04-20 14:00:00,68,422,4,1,495,141,532,3,1,677,29.4,81,51,11.0,1172,True,14,209,954,7,2,2024-04-20,False,False,False,0.8139931740614335,0.17832764505119453,0.005972696245733789,0.0017064846416382253,Peak,Saturday,April
2024-04-20 15:00:00,92,221,4,1,318,93,352,3,1,449,29.8,79,3,10.8,767,True,15,185,573,7,2,2024-04-20,False,False,False,0.7470664928292047,0.24119947848761408,0.009126466753585397,0.002607561929595828,Peak,Saturday,April
2024-04-20 16:00:00,166,451,5,1,623,94,367,3,1,465,29.5,80,3,8.7,1088,True,16,260,818,8,2,2024-04-20,False,False,False,0.7518382352941176,0.23897058823529413,0.007352941176470588,0.001838235294117647,Peak,Saturday,April
2024-04-20 17:00:00,115,302,5,1,423,88,322,3,1,414,29.0,81,51,8.4,837,True,17,203,624,8,2,2024-04-20,False,False,False,0.7455197132616488,0.24253285543608125,0.009557945041816009,0.0023894862604540022,Peak,Saturday,April
2024-04-20 18:00:00,136,148,4,1,289,138,532,3,1,674,28.2,86,3,9.3,963,True,18,274,680,7,2,2024-04-20,False,False,False,0.7061266874350987,0.284527518172378,0.007268951194184839,0.0020768431983385254,Peak,Saturday,April
2024-04-20 19:00:00,133,347,5,1,486,41,250,4,2,297,27.8,87,51,9.0,783,True,19,174,597,9,3,2024-04-20,False,False,False,0.7624521072796935,0.2222222222222222,0.011494252873563218,0.0038314176245210726,Peak,Saturday,April
2024-04-20 20:00:00,175,475,5,1,656,37,280,3,1,321,27.9,85,3,9.5,977,True,20,212,755,8,2,2024-04-20,False,False,False,0.7727737973387923,0.21699078812691913,0.008188331627430911,0.0020470829068577278,Shoulder,Saturday,April
2024-04-20 21:00:00,37,344,5,1,387,83,291,3,1,378,26.8,94,53,5.9,765,True,21,120,635,8,2,2024-04-20,False,False,False,0.8300653594771242,0.1568627450980392,0.01045751633986928,0.00261437908496732,Shoulder,Saturday,April
2024-04-20 22:00:00,77,176,6,1,260,112,429,3,1,545,25.7,96,61,5.6,805,True,22,189,605,9,2,2024-04-20,False,False,False,0.7515527950310559,0.23478260869565218,0.011180124223602485,0.002484472049689441,Shoulder,Saturday,April
2024-04-20 23:00:00,168,441,8,1,618,129,496,3,1,629,25.9,96,53,6.7,1247,True,23,297,937,11,2,2024-04-20,False,False,False,0.7514033680834001,0.23817161186848437,0.008821170809943865,0.0016038492381716118,Shoulder,Saturday,April
2024-04-21 00:00:00,153,328,4,0,485,128,191,2,0,321,26.0,97,51,3.2,806,True,0,281,519,6,0,2024-04-21,False,False,False,0.6439205955334988,0.34863523573200994,0.007444168734491315,0.0,Off-Peak,Sunday,April
2024-04-21 01:00:00,79,131,3,0,213,148,114,2,0,264,25.3,99,53,6.8,477,True,1,227,245,5,0,2024-04-21,False,False,False,0.5136268343815513,0.4758909853249476,0.010482180293501049,0.0,Off-Peak,Sunday,April
2024-04-21 02:00:00,59,140,3,0,202,138,110,2,0,250,24.9,97,51,7.1,452,True,2,197,250,5,0,2024-04-21,False,False,False,0.5530973451327433,0.4358407079646018,0.011061946902654867,0.0,Off-Peak,Sunday,April
2024-04-21 03:00:00,153,108,4,0,265,142,121,2,0,265,24.8,96,3,4.8,530,True,3,295,229,6,0,2024-04-21,False,False,False,0.4320754716981132,0.5566037735849056,0.011320754716981131,0.0,Off-Peak,Sunday,April
2024-04-21 04:00:00,120,69,4,0,193,96,87,2,0,185,24.6,97,3,2.5,378,True,4,216,156,6,0,2024-04-21,False,False,False,0.4126984126984127,0.5714285714285714,0.015873015873015872,0.0,Off-Peak,Sunday,April
2024-04-21 05:00:00,101,190,4,0,295,40,92,2,0,134,24.3,98,3,2.9,429,True,5,141,282,6,0,2024-04-21,False,False,False,0.6573426573426573,0.32867132867132864,0.013986013986013986,0.0,Shoulder,Sunday,April
2024-04-21 06:00:00,58,202,3,0,263,78,117,2,0,197,24.5,97,3,3.6,460,True,6,136,319,5,0,2024-04-21,False,False,False,0.6934782608695652,0.2956521739130435,0.010869565217391304,0.0,Shoulder,Sunday,April
2024-04-21 07:00:00,78,414,3,0,495,113,419,4,0,536,24.5,97,3,3.3,1031,True,7,191,833,7,0,2024-04-21,False,False,False,0.8079534432589719,0.18525703200775945,0.006789524733268671,0.0,Peak,Sunday,April
2024-04-21 08:00:00,50,420,3,0,473,47,360,2,0,409,25.3,94,3,4.5,882,True,8,97,780,5,0,2024-04-21,False,False,False,0.8843537414965986,0.10997732426303855,0.005668934240362812,0.0,Peak,Sunday,April
2024-04-21 09:00:00,124,335,4,0,463,47,310,3,0,360,25.3,96,65,8.4,823,True,9,171,645,7,0,2024-04-21,False,False,False,0.7837181044957473,0.2077764277035237,0.00850546780072904,0.0,Shoulder,Sunday,April
2024-04-21 10:00:00,172,477,5,1,655,113,313,4,1,431,25.7,91,65,9.7,1086,True,10,285,790,9,2,2024-04-21,False,False,False,0.7274401473296501,0.26243093922651933,0.008287292817679558,0.001841620626151013,Shoulder,Sunday,April
2024-04-21 11:00:00,143,384,5,0,532,47,246,3,1,297,26.3,90,51,4.0,829,True,11,190,630,8,1,2024-04-21,False,False,False,0.7599517490952955,0.22919179734620024,0.009650180940892641,0.0012062726176115801,Peak,Sunday,April
2024-04-21 12:00:00,163,454,4,1,622,180,109,3,1,293,28.3,87,3,5.4,915,True,12,343,563,7,2,2024-04-21,False,False,False,0.6153005464480874,0.37486338797814206,0.007650273224043716,0.002185792349726776,Peak,Sunday,April
2024-04-21 13:00:00,157,425,4,1,587,76,199,5,1,281,30.4,78,51,7.3,868,True,13,233,624,9,2,2024-04-21,False,False,False,0.7188940092165899,0.2684331797235023,0.010368663594470046,0.002304147465437788,Peak,Sunday,April
2024-04-21 14:00:00,90,235,4,1,330,99,270,4,1,374,32.1,70,51,7.2,704,True,14,189,505,8,2,2024-04-21,False,False,False,0.7173295454545454,0.2684659090909091,0.011363636363636364,0.002840909090909091,Peak,Sunday,April
2024-04-21 15:00:00,54,126,4,1,185,92,395,3,1,491,32.3,70,3,6.5,676,True,15,146,521,7,2,2024-04-21,False,False,False,0.7707100591715976,0.21597633136094674,0.010355029585798817,0.0029585798816568047,Peak,Sunday,April
2024-04-21 16:00:00,124,329,4,1,458,51,531,7,1,590,31.2,75,61,7.6,1048,True,16,175,860,11,2,2024-04-21,False,False,False,0.8206106870229007,0.16698473282442747,0.01049618320610687,0.0019083969465648854,Peak,Sunday,April
2024-04-21 17:00:00,101,258,6,1,366,40,263,3,1,307,29.5,83,63,6.8,673,True,17,141,521,9,2,2024-04-21,False,False,False,0.774145616641902,0.20950965824665677,0.01337295690936107,0.0029717682020802376,Peak,Sunday,April
2024-04-21 18:00:00,75,182,5,1,263,78,197,1,1,277,28.6,79,63,3.4,540,True,18,153,379,6,2,2024-04-21,False,False,False,0.7018518518518518,0.2833333333333333,0.011111111111111112,0.003703703703703704,Peak,Sunday,April
2024-04-21 19:00:00,113,297,6,1,417,213,642,1,1,857,27.7,87,61,7.6,1274,True,19,326,939,7,2,2024-04-21,False,False,False,0.7370486656200942,0.25588697017268447,0.005494505494505495,0.0015698587127158557,Peak,Sunday,April
2024-04-21 20:00:00,126,334,5,1,466,153,438,3,1,595,26.0,95,63,4.8,1061,True,20,279,772,8,2,2024-04-21,False,False,False,0.7276154571159283,0.2629594721960415,0.007540056550424128,0.001885014137606032,Shoulder,Sunday,April
2024-04-21 21:00:00,85,209,5,1,300,51,425,2,1,479,26.3,96,65,11.6,779,True,21,136,634,7,2,2024-04-21,False,False,False,0.8138639281129654,0.17458279845956354,0.008985879332477536,0.0025673940949935813,Shoulder,Sunday,April
2024-04-21 22:00:00,119,267,5,1,392,129,363,3,1,496,26.4,96,63,5.5,888,True,22,248,630,8,2,2024-04-21,False,False,False,0.7094594594594594,0.27927927927927926,0.009009009009009009,0.0022522522522522522,Shoulder,Sunday,April
2024-04-21 23:00:00,35,311,4,1,351,113,313,1,0,427,25.8,97,65,1.1,778,True,23,148,624,5,1,2024-04-21,False,False,False,0.8020565552699229,0.19023136246786632,0.006426735218508998,0.0012853470437017994,Shoulder,Sunday,April
2024-04-22 00:00:00,159,538,10,0,707,128,186,6,0,320,25.5,97,63,7.4,1027,False,0,287,724,16,0,2024-04-22,False,False,False,0.7049659201557936,0.27945472249269715,0.01557935735150925,0.0,Off-Peak,Monday,April
2024-04-22 01:00:00,54,117,3,0,174,89,176,4,0,269,24.8,98,63,8.2,443,False,1,143,293,7,0,2024-04-22,False,False,False,0.6613995485327314,0.3227990970654628,0.01580135440180587,0.0,Off-Peak,Monday,April
2024-04-22 02:00:00,37,113,10,0,160,69,170,7,0,246,24.6,97,51,6.2,406,False,2,106,283,17,0,2024-04-22,False,False,False,0.6970443349753694,0.26108374384236455,0.04187192118226601,0.0,Off-Peak,Monday,April
2024-04-22 03:00:00,37,118,9,0,164,33,132,6,0,171,24.4,98,3,6.4,335,False,3,70,250,15,0,2024-04-22,False,False,False,0.746268656716418,0.208955223880597,0.04477611940298507,0.0,Off-Peak,Monday,April
2024-04-22 04:00:00,35,128,8,0,171,25,131,2,0,158,24.4,97,3,2.4,329,False,4,60,259,10,0,2024-04-22,False,False,False,0.7872340425531915,0.182370820668693,0.030395136778115502,0.0,Off-Peak,Monday,April
2024-04-22 05:00:00,112,188,7,0,307,40,114,2,0,156,24.3,97,3,3.7,463,False,5,152,302,9,0,2024-04-22,False,False,False,0.652267818574514,0.3282937365010799,0.019438444924406047,0.0,Shoulder,Monday,April
2024-04-22 06:00:00,92,582,7,0,681,103,518,7,0,628,24.3,97,3,4.6,1309,False,6,195,1100,14,0,2024-04-22,False,False,False,0.8403361344537815,0.1489686783804431,0.0106951871657754,0.0,Shoulder,Monday,April
2024-04-22 07:00:00,145,494,4,0,643,108,709,2,0,819,24.2,98,3,3.8,1462,False,7,253,1203,6,0,2024-04-22,False,False,True,0.8228454172366622,0.17305061559507523,0.004103967168262654,0.0,Peak,Monday,April
2024-04-22 08:00:00,144,459,3,0,606,118,595,8,0,721,25.0,94,3,7.7,1327,False,8,262,1054,11,0,2024-04-22,False,False,False,0.7942727957799548,0.1974378296910324,0.008289374529012811,0.0,Peak,Monday,April
2024-04-22 09:00:00,134,382,5,0,521,110,564,8,0,682,27.1,89,3,13.8,1203,False,9,244,946,13,0,2024-04-22,False,False,False,0.7863674147963424,0.2028262676641729,0.010806317539484621,0.0,Shoulder,Monday,April
2024-04-22 10:00:00,169,314,11,0,494,92,466,5,0,563,28.4,84,3,9.3,1057,False,10,261,780,16,0,2024-04-22,False,False,False,0.7379375591296121,0.2469252601702933,0.015137180700094607,0.0,Shoulder,Monday,April
2024-04-22 11:00:00,104,357,7,0,468,23,437,2,0,462,29.4,80,3,9.1,930,False,11,127,794,9,0,2024-04-22,False,False,False,0.853763440860215,0.13655913978494624,0.00967741935483871,0.0,Peak,Monday,April
2024-04-22 12:00:00,211,426,13,1,651,100,505,7,1,613,30.8,76,51,2.5,1264,False,12,311,931,20,2,2024-04-22,False,False,False,0.7365506329113924,0.24604430379746836,0.015822784810126583,0.0015822784810126582,Peak,Monday,April
2024-04-22 13:00:00,208,535,14,2,759,131,657,9,1,798,31.5,75,51,4.6,1557,False,13,339,1192,23,3,2024-04-22,False,False,True,0.7655748233782916,0.21772639691714837,0.014771997430956968,0.0019267822736030828,Peak,Monday,April
2024-04-22 14:00:00,159,689,11,1,860,83,410,7,1,501,29.6,78,61,12.0,1361,False,14,242,1099,18,2,2024-04-22,False,False,False,0.807494489346069,0.1778104335047759,0.01322556943423953,0.0014695077149155032,Peak,Monday,April
2024-04-22 15:00:00,124,713,8,1,846,39,647,4,2,692,29.0,83,53,3.2,1538,False,15,163,1360,12,3,2024-04-22,False,False,True,0.8842652795838751,0.10598179453836151,0.007802340702210663,0.0019505851755526658,Peak,Monday,April
2024-04-22 16:00:00,95,705,7,1,808,64,621,5,1,691,29.5,82,51,1.5,1499,False,16,159,1326,12,2,2024-04-22,False,False,True,0.8845897264843229,0.10607071380920614,0.008005336891260841,0.00133422281521014,Peak,Monday,April
2024-04-22 17:00:00,170,568,12,1,751,36,351,3,1,391,28.4,83,53,9.7,1142,False,17,206,919,15,2,2024-04-22,False,False,False,0.8047285464098074,0.18038528896672504,0.013134851138353765,0.0017513134851138354,Peak,Monday,April
2024-04-22 18:00:00,78,258,8,1,345,140,699,10,1,850,28.3,84,51,2.8,1195,False,18,218,957,18,2,2024-04-22,False,False,False,0.800836820083682,0.18242677824267783,0.01506276150627615,0.0016736401673640166,Peak,Monday,April
2024-04-22 19:00:00,49,157,4,1,211,66,542,5,1,614,27.9,87,3,3.1,825,False,19,115,699,9,2,2024-04-22,False,False,False,0.8472727272727273,0.1393939393939394,0.01090909090909091,0.0024242424242424242,Peak,Monday,April
2024-04-22 20:00:00,163,549,12,1,725,27,331,2,1,361,27.1,92,3,4.0,1086,False,20,190,880,14,2,2024-04-22,False,False,False,0.8103130755064457,0.17495395948434622,0.01289134438305709,0.001841620626151013,Shoulder,Monday,April
2024-04-22 21:00:00,207,319,16,1,543,39,318,5,1,363,26.7,92,3,3.1,906,False,21,246,637,21,2,2024-04-22,False,False,False,0.7030905077262694,0.271523178807947,0.023178807947019868,0.002207505518763797,Shoulder,Monday,April
2024-04-22 22:00:00,40,487,3,1,531,126,179,10,1,316,26.2,93,61,3.7,847,False,22,166,666,13,2,2024-04-22,False,False,False,0.7863046044864227,0.1959858323494687,0.015348288075560802,0.0023612750885478157,Shoulder,Monday,April
2024-04-22 23:00:00,136,460,12,1,609,143,198,13,1,355,25.9,93,51,5.7,964,False,23,279,658,25,2,2024-04-22,False,False,False,0.6825726141078838,0.2894190871369295,0.025933609958506226,0.002074688796680498,Shoulder,Monday,April
2024-04-23 00:00:00,92,277,13,0,382,123,243,7,0,373,25.4,95,51,10.2,755,False,0,215,520,20,0,2024-04-23,False,False,False,0.6887417218543046,0.2847682119205298,0.026490066225165563,0.0,Off-Peak,Tuesday,April
2024-04-23 01:00:00,67,154,10,1,232,28,208,2,0,238,25.3,95,51,6.2,470,False,1,95,362,12,1,2024-04-23,False,False,False,0.7702127659574468,0.20212765957446807,0.02553191489361702,0.002127659574468085,Off-Peak,Tuesday,April
2024-04-23 02:00:00,52,147,8,0,207,50,139,3,0,192,24.9,98,3,4.4,399,False,2,102,286,11,0,2024-04-23,False,False,False,0.7167919799498746,0.2556390977443609,0.02756892230576441,0.0,Off-Peak,Tuesday,April
2024-04-23 03:00:00,55,116,9,0,180,91,138,5,0,234,24.8,98,3,3.4,414,False,3,146,254,14,0,2024-04-23,False,False,False,0.6135265700483091,0.3526570048309179,0.033816425120772944,0.0,Off-Peak,Tuesday,April
2024-04-23 04:00:00,41,206,8,0,255,78,267,4,0,349,24.8,96,3,4.0,604,False,4,119,473,12,0,2024-04-23,False,False,False,0.7831125827814569,0.19701986754966888,0.019867549668874173,0.0,Off-Peak,Tuesday,April
2024-04-23 05:00:00,99,294,7,0,400,45,394,4,0,443,24.6,97,3,4.1,843,False,5,144,688,11,0,2024-04-23,False,False,False,0.8161328588374852,0.1708185053380783,0.013048635824436536,0.0,Shoulder,Tuesday,April
2024-04-23 06:00:00,169,505,9,0,683,29,452,2,0,483,24.4,97,3,3.3,1166,False,6,198,957,11,0,2024-04-23,False,False,False,0.8207547169811321,0.16981132075471697,0.009433962264150943,0.0,Shoulder,Tuesday,April
2024-04-23 07:00:00,180,530,9,0,719,79,604,5,0,688,24.7,96,3,6.4,1407,False,7,259,1134,14,0,2024-04-23,False,False,True,0.8059701492537313,0.18407960199004975,0.009950248756218905,0.0,Peak,Tuesday,April
2024-04-23 08:00:00,178,525,9,0,712,54,715,3,0,772,25.2,96,3,5.8,1484,False,8,232,1240,12,0,2024-04-23,False,False,True,0.8355795148247979,0.15633423180592992,0.008086253369272238,0.0,Peak,Tuesday,April
2024-04-23 09:00:00,175,472,4,0,651,62,304,5,0,371,25.8,91,3,11.9,1022,False,9,237,776,9,0,2024-04-23,False,False,False,0.7592954990215264,0.2318982387475538,0.008806262230919765,0.0,Shoulder,Tuesday,April
2024-04-23 10:00:00,163,492,9,0,664,46,229,3,0,278,27.1,87,3,3.8,942,False,10,209,721,12,0,2024-04-23,False,False,False,0.7653927813163482,0.2218683651804671,0.012738853503184714,0.0,Shoulder,Tuesday,April
2024-04-23 11:00:00,178,537,11,0,726,143,703,8,0,854,29.0,80,3,8.7,1580,False,11,321,1240,19,0,2024-04-23,False,False,True,0.7848101265822784,0.20316455696202532,0.012025316455696202,0.0,Peak,Tuesday,April
2024-04-23 12:00:00,97,290,5,0,392,145,393,9,0,547,31.0,73,3,4.2,939,False,12,242,683,14,0,2024-04-23,False,False,False,0.7273695420660277,0.2577209797657082,0.014909478168264111,0.0,Peak,Tuesday,April
2024-04-23 13:00:00,99,292,6,0,397,71,341,4,0,416,31.8,71,51,2.4,813,False,13,170,633,10,0,2024-04-23,False,False,False,0.7785977859778598,0.2091020910209102,0.012300123001230012,0.0,Peak,Tuesday,April
2024-04-23 14:00:00,108,322,7,0,437,115,558,8,0,681,32.0,71,3,7.9,1118,False,14,223,880,15,0,2024-04-23,False,False,False,0.7871198568872988,0.19946332737030412,0.013416815742397137,0.0,Peak,Tuesday,April
2024-04-23 15:00:00,185,556,11,0,752,89,432,6,0,527,31.3,76,53,8.5,1279,False,15,274,988,17,0,2024-04-23,False,False,False,0.7724784988272088,0.2142298670836591,0.013291634089132134,0.0,Peak,Tuesday,April
2024-04-23 16:00:00,156,530,3,0,689,113,543,8,0,664,29.1,83,63,4.6,1353,False,16,269,1073,11,0,2024-04-23,False,False,False,0.7930524759793053,0.19881744271988175,0.008130081300813009,0.0,Peak,Tuesday,April
2024-04-23 17:00:00,152,538,3,0,693,117,572,8,0,697,29.9,79,51,3.9,1390,False,17,269,1110,11,0,2024-04-23,False,False,True,0.7985611510791367,0.19352517985611511,0.007913669064748202,0.0,Peak,Tuesday,April
2024-04-23 18:00:00,181,695,5,0,881,59,282,5,0,346,29.8,76,53,5.2,1227,False,18,240,977,10,0,2024-04-23,False,False,False,0.7962510187449062,0.19559902200489,0.008149959250203748,0.0,Peak,Tuesday,April
2024-04-23 19:00:00,113,342,7,1,463,67,327,4,1,399,28.9,86,51,3.1,862,False,19,180,669,11,2,2024-04-23,False,False,False,0.7761020881670534,0.2088167053364269,0.012761020881670533,0.002320185614849188,Peak,Tuesday,April
2024-04-23 20:00:00,232,460,6,1,699,124,595,9,1,729,27.9,92,51,4.4,1428,False,20,356,1055,15,2,2024-04-23,False,False,True,0.738795518207283,0.24929971988795518,0.01050420168067227,0.0014005602240896359,Shoulder,Tuesday,April
2024-04-23 21:00:00,140,415,8,1,564,115,557,9,1,682,26.3,90,3,8.4,1246,False,21,255,972,17,2,2024-04-23,False,False,False,0.7800963081861958,0.20465489566613163,0.013643659711075442,0.0016051364365971107,Shoulder,Tuesday,April
2024-04-23 22:00:00,138,407,9,1,555,70,330,5,1,406,26.5,91,3,12.1,961,False,22,208,737,14,2,2024-04-23,False,False,False,0.7669094693028096,0.21644120707596254,0.014568158168574402,0.002081165452653486,Shoulder,Tuesday,April
2024-04-23 23:00:00,217,652,14,1,884,91,428,9,2,530,26.3,92,51,9.2,1414,False,23,308,1080,23,3,2024-04-23,False,False,True,0.7637906647807637,0.21782178217821782,0.016265912305516265,0.0021216407355021216,Shoulder,Tuesday,April
2024-04-24 00:00:00,188,234,7,0,429,131,203,1,0,335,25.9,94,3,8.7,764,False,0,319,437,8,0,2024-04-24,False,False,False,0.5719895287958116,0.4175392670157068,0.010471204188481676,0.0,Off-Peak,Wednesday,April
2024-04-24 01:00:00,189,177,7,0,373,94,197,2,0,293,25.6,95,3,8.3,666,False,1,283,374,9,0,2024-04-24,False,False,False,0.5615615615615616,0.42492492492492495,0.013513513513513514,0.0,Off-Peak,Wednesday,April
2024-04-24 02:00:00,54,176,3,0,233,72,197,3,0,272,25.4,95,3,7.9,505,False,2,126,373,6,0,2024-04-24,False,False,False,0.7386138613861386,0.2495049504950495,0.011881188118811881,0.0,Off-Peak,Wednesday,April
2024-04-24 03:00:00,58,165,3,0,226,60,171,4,0,235,25.2,96,3,6.6,461,False,3,118,336,7,0,2024-04-24,False,False,False,0.7288503253796096,0.2559652928416486,0.015184381778741865,0.0,Off-Peak,Wednesday,April
2024-04-24 04:00:00,73,127,5,0,205,96,159,3,0,258,25.0,96,3,5.1,463,False,4,169,286,8,0,2024-04-24,False,False,False,0.6177105831533477,0.3650107991360691,0.017278617710583154,0.0,Off-Peak,Wednesday,April
2024-04-24 05:00:00,40,629,6,0,675,109,143,3,0,255,25.0,96,3,6.1,930,False,5,149,772,9,0,2024-04-24,False,False,False,0.8301075268817204,0.16021505376344086,0.00967741935483871,0.0,Shoulder,Wednesday,April
2024-04-24 06:00:00,157,833,7,0,997,233,309,5,0,547,24.8,96,3,8.5,1544,False,6,390,1142,12,0,2024-04-24,False,False,True,0.7396373056994818,0.25259067357512954,0.007772020725388601,0.0,Shoulder,Wednesday,April
2024-04-24 07:00:00,179,591,7,0,777,48,753,2,0,803,24.8,96,3,10.1,1580,False,7,227,1344,9,0,2024-04-24,False,False,True,0.850632911392405,0.14367088607594936,0.00569620253164557,0.0,Peak,Wednesday,April
2024-04-24 08:00:00,178,589,7,0,774,228,770,6,0,1004,24.4,96,51,11.3,1778,False,8,406,1359,13,0,2024-04-24,False,False,True,0.764341957255343,0.2283464566929134,0.007311586051743532,0.0,Peak,Wednesday,April
2024-04-24 09:00:00,144,467,6,0,617,226,230,6,0,462,27.1,92,3,4.6,1079,False,9,370,697,12,0,2024-04-24,False,False,False,0.6459684893419834,0.34291010194624655,0.011121408711770158,0.0,Shoulder,Wednesday,April
2024-04-24 10:00:00,149,505,2,0,656,61,345,2,0,408,28.6,84,3,4.3,1064,False,10,210,850,4,0,2024-04-24,False,False,False,0.7988721804511278,0.19736842105263158,0.0037593984962406013,0.0,Shoulder,Wednesday,April
2024-04-24 11:00:00,85,520,3,0,608,53,204,3,0,260,27.3,86,53,15.7,868,False,11,138,724,6,0,2024-04-24,False,False,False,0.8341013824884793,0.15898617511520738,0.0069124423963133645,0.0,Peak,Wednesday,April
2024-04-24 12:00:00,152,479,2,0,633,163,233,4,0,400,28.0,85,51,0.0,1033,False,12,315,712,6,0,2024-04-24,False,False,False,0.6892545982575025,0.30493707647628265,0.005808325266214908,0.0,Peak,Wednesday,April
2024-04-24 13:00:00,102,340,5,0,447,72,461,2,0,535,29.7,79,51,6.5,982,False,13,174,801,7,0,2024-04-24,False,False,False,0.8156822810590632,0.17718940936863545,0.007128309572301426,0.0,Peak,Wednesday,April
2024-04-24 14:00:00,49,366,2,0,417,146,533,5,0,684,30.2,76,51,7.5,1101,False,14,195,899,7,0,2024-04-24,False,False,False,0.8165304268846503,0.1771117166212534,0.006357856494096276,0.0,Peak,Wednesday,April
2024-04-24 15:00:00,111,615,5,0,731,65,740,3,0,808,30.8,74,3,8.1,1539,False,15,176,1355,8,0,2024-04-24,False,False,True,0.8804418453541261,0.11435997400909681,0.005198180636777128,0.0,Peak,Wednesday,April
2024-04-24 16:00:00,85,280,6,0,371,62,951,2,0,1015,31.0,72,3,9.2,1386,False,16,147,1231,8,0,2024-04-24,False,False,True,0.8881673881673882,0.10606060606060606,0.005772005772005772,0.0,Peak,Wednesday,April
2024-04-24 17:00:00,136,434,6,1,577,153,508,4,1,666,30.5,75,3,8.5,1243,False,17,289,942,10,2,2024-04-24,False,False,False,0.7578439259855189,0.2325020112630732,0.008045052292839904,0.0016090104585679806,Peak,Wednesday,April
2024-04-24 18:00:00,191,624,8,1,824,129,429,5,1,564,30.2,77,3,6.6,1388,False,18,320,1053,13,2,2024-04-24,False,False,True,0.7586455331412104,0.23054755043227665,0.009365994236311239,0.001440922190201729,Peak,Wednesday,April
2024-04-24 19:00:00,91,292,6,2,391,260,837,10,1,1108,29.2,83,3,6.7,1499,False,19,351,1129,16,3,2024-04-24,False,False,True,0.7531687791861241,0.2341561040693796,0.01067378252168112,0.0020013342228152103,Peak,Wednesday,April
2024-04-24 20:00:00,88,285,4,1,378,134,436,4,1,575,28.5,87,3,5.9,953,False,20,222,721,8,2,2024-04-24,False,False,False,0.7565582371458552,0.23294858342077648,0.008394543546694649,0.002098635886673662,Shoulder,Wednesday,April
2024-04-24 21:00:00,236,779,12,1,1028,290,424,9,1,724,27.3,97,3,2.5,1752,False,21,526,1203,21,2,2024-04-24,False,False,True,0.6866438356164384,0.3002283105022831,0.011986301369863013,0.001141552511415525,Shoulder,Wednesday,April
2024-04-24 22:00:00,86,273,5,1,365,53,317,3,2,375,27.0,98,3,1.8,740,False,22,139,590,8,3,2024-04-24,False,False,False,0.7972972972972973,0.18783783783783783,0.010810810810810811,0.004054054054054054,Shoulder,Wednesday,April
2024-04-24 23:00:00,256,281,14,1,552,155,511,6,1,673,27.1,98,3,3.7,1225,False,23,411,792,20,2,2024-04-24,False,False,False,0.6465306122448979,0.3355102040816327,0.0163265306122449,0.0016326530612244899,Shoulder,Wednesday,April
2024-04-25 00:00:00,175,302,10,0,487,168,159,4,0,331,27.2,96,3,4.3,818,False,0,343,461,14,0,2024-04-25,False,False,False,0.5635696821515892,0.4193154034229829,0.017114914425427872,0.0,Off-Peak,Thursday,April
2024-04-25 01:00:00,116,196,7,0,319,58,144,4,0,206,26.9,96,3,3.3,525,False,1,174,340,11,0,2024-04-25,False,False,False,0.6476190476190476,0.3314285714285714,0.02095238095238095,0.0,Off-Peak,Thursday,April
2024-04-25 02:00:00,104,157,6,0,267,59,131,6,0,196,27.1,96,3,7.2,463,False,2,163,288,12,0,2024-04-25,False,False,False,0.6220302375809935,0.35205183585313177,0.02591792656587473,0.0,Off-Peak,Thursday,April
2024-04-25 03:00:00,66,121,7,0,194,57,125,2,0,184,26.8,97,3,6.9,378,False,3,123,246,9,0,2024-04-25,False,False,False,0.6507936507936508,0.3253968253968254,0.023809523809523808,0.0,Off-Peak,Thursday,April
2024-04-25 04:00:00,37,221,4,0,262,69,129,2,0,200,26.6,97,0,4.3,462,False,4,106,350,6,0,2024-04-25,False,False,False,0.7575757575757576,0.22943722943722944,0.012987012987012988,0.0,Off-Peak,Thursday,April
2024-04-25 05:00:00,47,302,5,0,354,65,129,3,0,197,26.2,98,2,6.0,551,False,5,112,431,8,0,2024-04-25,False,False,False,0.7822141560798548,0.20326678765880218,0.014519056261343012,0.0,Shoulder,Thursday,April
2024-04-25 06:00:00,49,586,3,0,638,178,687,4,0,869,26.1,98,0,8.3,1507,False,6,227,1273,7,0,2024-04-25,False,False,True,0.8447246184472462,0.15063039150630392,0.0046449900464499,0.0,Shoulder,Thursday,April
2024-04-25 07:00:00,165,673,8,0,846,295,732,7,0,1034,26.1,97,2,7.2,1880,False,7,460,1405,15,0,2024-04-25,False,False,True,0.7473404255319149,0.24468085106382978,0.007978723404255319,0.0,Peak,Thursday,April
2024-04-25 08:00:00,134,552,3,0,689,158,718,2,0,878,26.8,95,3,4.6,1567,False,8,292,1270,5,0,2024-04-25,False,False,True,0.8104658583280153,0.18634333120612637,0.003190810465858328,0.0,Peak,Thursday,April
2024-04-25 09:00:00,201,348,11,0,560,233,541,2,0,776,27.6,94,53,3.0,1336,False,9,434,889,13,0,2024-04-25,False,False,False,0.6654191616766467,0.3248502994011976,0.009730538922155689,0.0,Shoulder,Thursday,April
2024-04-25 10:00:00,67,221,4,0,292,58,419,3,1,481,28.9,91,51,4.4,773,False,10,125,640,7,1,2024-04-25,False,False,False,0.8279430789133247,0.16170763260025872,0.009055627425614488,0.00129366106080207,Shoulder,Thursday,April
2024-04-25 11:00:00,90,160,3,0,253,170,394,4,0,568,29.7,84,51,7.0,821,False,11,260,554,7,0,2024-04-25,False,False,False,0.6747868453105969,0.3166869671132765,0.008526187576126675,0.0,Peak,Thursday,April
2024-04-25 12:00:00,92,303,5,0,400,288,667,7,0,962,30.4,79,51,5.2,1362,False,12,380,970,12,0,2024-04-25,False,False,False,0.7121879588839941,0.2790014684287812,0.00881057268722467,0.0,Peak,Thursday,April
2024-04-25 13:00:00,78,257,5,0,340,135,311,4,0,450,31.2,73,51,1.8,790,False,13,213,568,9,0,2024-04-25,False,False,False,0.7189873417721518,0.26962025316455696,0.01139240506329114,0.0,Peak,Thursday,April
2024-04-25 14:00:00,159,529,10,0,698,101,231,3,0,335,31.5,72,3,3.0,1033,False,14,260,760,13,0,2024-04-25,False,False,False,0.7357212003872217,0.25169409486931266,0.012584704743465635,0.0,Peak,Thursday,April
2024-04-25 15:00:00,59,725,4,0,788,320,743,9,0,1072,31.3,76,51,7.4,1860,False,15,379,1468,13,0,2024-04-25,False,False,True,0.789247311827957,0.20376344086021506,0.006989247311827957,0.0,Peak,Thursday,April
2024-04-25 16:00:00,80,758,5,0,843,281,652,8,0,941,28.0,85,63,5.8,1784,False,16,361,1410,13,0,2024-04-25,False,False,True,0.7903587443946188,0.2023542600896861,0.0072869955156950675,0.0,Peak,Thursday,April
2024-04-25 17:00:00,229,768,14,0,1011,254,592,7,0,853,28.5,83,51,3.1,1864,False,17,483,1360,21,0,2024-04-25,False,False,True,0.7296137339055794,0.25912017167381973,0.011266094420600859,0.0,Peak,Thursday,April
2024-04-25 18:00:00,217,459,17,1,694,292,677,9,0,978,27.1,88,53,7.1,1672,False,18,509,1136,26,1,2024-04-25,False,False,True,0.6794258373205742,0.30442583732057416,0.01555023923444976,0.0005980861244019139,Peak,Thursday,April
2024-04-25 19:00:00,119,395,7,1,522,77,171,2,1,251,27.0,87,51,1.1,773,False,19,196,566,9,2,2024-04-25,False,False,False,0.7322121604139715,0.2535575679172057,0.01164294954721863,0.00258732212160414,Peak,Thursday,April
2024-04-25 20:00:00,231,271,15,1,518,93,215,4,1,313,26.5,92,3,4.4,831,False,20,324,486,19,2,2024-04-25,False,False,False,0.5848375451263538,0.3898916967509025,0.02286401925391095,0.0024067388688327317,Shoulder,Thursday,April
2024-04-25 21:00:00,165,547,11,1,724,313,366,11,1,691,26.7,99,3,5.2,1415,False,21,478,913,22,2,2024-04-25,False,False,True,0.6452296819787986,0.33780918727915193,0.015547703180212015,0.0014134275618374558,Shoulder,Thursday,April
2024-04-25 22:00:00,91,383,6,1,481,310,385,11,1,707,26.7,98,3,5.4,1188,False,22,401,768,17,2,2024-04-25,False,False,False,0.6464646464646465,0.33754208754208753,0.01430976430976431,0.0016835016835016834,Shoulder,Thursday,April
2024-04-25 23:00:00,181,601,14,1,797,226,517,9,1,753,26.7,98,3,5.2,1550,False,23,407,1118,23,2,2024-04-25,False,False,True,0.7212903225806452,0.2625806451612903,0.014838709677419355,0.0012903225806451613,Shoulder,Thursday,April
2024-04-26 00:00:00,139,293,5,0,437,78,229,0,0,307,26.4,98,3,3.7,744,False,0,217,522,5,0,2024-04-26,False,True,False,0.7016129032258065,0.2916666666666667,0.006720430107526882,0.0,Off-Peak,Friday,April
2024-04-26 01:00:00,93,270,3,0,366,70,226,2,0,298,26.6,97,3,2.4,664,False,1,163,496,5,0,2024-04-26,False,True,False,0.7469879518072289,0.24548192771084337,0.007530120481927711,0.0,Off-Peak,Friday,April
2024-04-26 02:00:00,85,125,5,1,216,49,193,1,0,243,26.2,98,3,2.1,459,False,2,134,318,6,1,2024-04-26,False,True,False,0.6928104575163399,0.29193899782135074,0.013071895424836602,0.002178649237472767,Off-Peak,Friday,April
2024-04-26 03:00:00,67,89,3,0,159,55,164,2,0,221,26.2,98,3,1.8,380,False,3,122,253,5,0,2024-04-26,False,True,False,0.6657894736842105,0.32105263157894737,0.013157894736842105,0.0,Off-Peak,Friday,April
2024-04-26 04:00:00,39,206,5,0,250,44,145,2,0,191,26.1,99,3,4.4,441,False,4,83,351,7,0,2024-04-26,False,True,False,0.7959183673469388,0.18820861678004536,0.015873015873015872,0.0,Off-Peak,Friday,April
2024-04-26 05:00:00,31,219,8,0,258,30,155,6,1,192,25.9,99,3,4.2,450,False,5,61,374,14,1,2024-04-26,False,True,False,0.8311111111111111,0.13555555555555557,0.03111111111111111,0.0022222222222222222,Shoulder,Friday,April
2024-04-26 06:00:00,180,377,5,0,562,157,343,1,0,501,25.8,98,3,6.3,1063,False,6,337,720,6,0,2024-04-26,False,True,False,0.6773283160865475,0.31702728127939794,0.005644402634054563,0.0,Shoulder,Friday,April
2024-04-26 07:00:00,119,637,3,0,759,81,716,2,0,799,25.6,98,3,6.6,1558,False,7,200,1353,5,0,2024-04-26,False,True,True,0.868421052631579,0.12836970474967907,0.003209242618741977,0.0,Peak,Friday,April
2024-04-26 08:00:00,125,574,8,0,707,81,695,2,0,778,26.1,97,3,9.0,1485,False,8,206,1269,10,0,2024-04-26,False,True,True,0.8545454545454545,0.13872053872053872,0.006734006734006734,0.0,Peak,Friday,April
2024-04-26 09:00:00,116,403,2,0,521,100,425,2,0,527,27.7,94,3,7.5,1048,False,9,216,828,4,0,2024-04-26,False,True,False,0.7900763358778626,0.20610687022900764,0.003816793893129771,0.0,Shoulder,Friday,April
2024-04-26 10:00:00,187,604,7,0,798,37,336,2,0,375,29.2,87,3,6.3,1173,False,10,224,940,9,0,2024-04-26,False,True,False,0.8013640238704177,0.19096334185848252,0.0076726342710997444,0.0,Shoulder,Friday,April
2024-04-26 11:00:00,69,574,3,0,646,59,263,2,0,324,30.5,77,51,4.4,970,False,11,128,837,5,0,2024-04-26,False,True,False,0.8628865979381444,0.13195876288659794,0.005154639175257732,0.0,Peak,Friday,April
2024-04-26 12:00:00,182,372,7,0,561,77,323,3,0,403,31.4,70,51,5.9,964,False,12,259,695,10,0,2024-04-26,False,True,False,0.720954356846473,0.26867219917012447,0.01037344398340249,0.0,Peak,Friday,April
2024-04-26 13:00:00,178,568,7,0,753,80,358,3,0,441,31.9,66,51,4.3,1194,False,13,258,926,10,0,2024-04-26,False,True,False,0.7755443886097152,0.21608040201005024,0.008375209380234505,0.0,Peak,Friday,April
2024-04-26 14:00:00,129,405,4,0,538,85,373,3,0,461,32.3,67,51,2.8,999,False,14,214,778,7,0,2024-04-26,False,True,False,0.7787787787787788,0.21421421421421422,0.007007007007007007,0.0,Peak,Friday,April
2024-04-26 15:00:00,79,257,4,0,340,89,799,3,0,891,29.2,80,63,7.3,1231,False,15,168,1056,7,0,2024-04-26,False,True,False,0.8578391551584078,0.1364744110479285,0.005686433793663688,0.0,Peak,Friday,April
2024-04-26 16:00:00,65,203,4,0,272,39,526,4,0,569,27.9,85,51,9.3,841,False,16,104,729,8,0,2024-04-26,False,True,False,0.8668252080856124,0.12366230677764566,0.009512485136741973,0.0,Peak,Friday,April
2024-04-26 17:00:00,176,552,7,0,735,113,392,4,0,509,28.1,86,51,10.6,1244,False,17,289,944,11,0,2024-04-26,False,True,False,0.7588424437299035,0.23231511254019294,0.008842443729903537,0.0,Peak,Friday,April
2024-04-26 18:00:00,151,473,6,1,631,163,363,7,1,534,28.2,86,51,8.2,1165,False,18,314,836,13,2,2024-04-26,False,True,False,0.7175965665236052,0.26952789699570817,0.011158798283261802,0.0017167381974248926,Peak,Friday,April
2024-04-26 19:00:00,202,441,3,1,647,182,549,7,1,739,27.8,88,3,6.8,1386,False,19,384,990,10,2,2024-04-26,False,True,True,0.7142857142857143,0.27705627705627706,0.007215007215007215,0.001443001443001443,Peak,Friday,April
2024-04-26 20:00:00,127,397,5,1,530,128,316,5,1,450,27.3,90,3,4.7,980,False,20,255,713,10,2,2024-04-26,False,True,False,0.7275510204081632,0.2602040816326531,0.01020408163265306,0.0020408163265306124,Shoulder,Friday,April
2024-04-26 21:00:00,93,297,4,1,395,121,526,6,1,654,28.3,85,3,6.4,1049,False,21,214,823,10,2,2024-04-26,False,True,False,0.784556720686368,0.20400381315538607,0.009532888465204958,0.0019065776930409914,Shoulder,Friday,April
2024-04-26 22:00:00,125,397,6,1,529,60,269,3,1,333,27.9,86,3,8.2,862,False,22,185,666,9,2,2024-04-26,False,True,False,0.7726218097447796,0.21461716937354988,0.010440835266821345,0.002320185614849188,Shoulder,Friday,April
2024-04-26 23:00:00,102,322,6,1,431,84,371,4,1,460,27.0,93,3,5.8,891,False,23,186,693,10,2,2024-04-26,False,True,False,0.7777777777777778,0.20875420875420875,0.01122334455667789,0.002244668911335578,Shoulder,Friday,April
2024-04-27 00:00:00,87,275,5,1,368,117,307,2,1,427,26.9,92,3,5.0,795,True,0,204,582,7,2,2024-04-27,False,False,False,0.7320754716981132,0.25660377358490566,0.00880503144654088,0.0025157232704402514,Off-Peak,Saturday,April
2024-04-27 01:00:00,83,271,3,0,357,105,279,4,0,388,26.4,96,3,3.9,745,True,1,188,550,7,0,2024-04-27,False,False,False,0.738255033557047,0.2523489932885906,0.009395973154362415,0.0,Off-Peak,Saturday,April
2024-04-27 02:00:00,86,201,3,0,290,72,245,1,0,318,26.2,96,3,2.5,608,True,2,158,446,4,0,2024-04-27,False,False,False,0.7335526315789473,0.2598684210526316,0.006578947368421052,0.0,Off-Peak,Saturday,April
2024-04-27 03:00:00,75,238,4,0,317,40,188,3,0,231,25.7,98,3,2.4,548,True,3,115,426,7,0,2024-04-27,False,False,False,0.7773722627737226,0.20985401459854014,0.012773722627737226,0.0,Off-Peak,Saturday,April
2024-04-27 04:00:00,46,184,5,0,235,55,163,1,0,219,25.9,95,3,6.4,454,True,4,101,347,6,0,2024-04-27,False,False,False,0.76431718061674,0.22246696035242292,0.013215859030837005,0.0,Off-Peak,Saturday,April
2024-04-27 05:00:00,142,198,5,0,345,54,240,3,0,297,25.6,95,61,9.0,642,True,5,196,438,8,0,2024-04-27,False,False,False,0.6822429906542056,0.3052959501557632,0.012461059190031152,0.0,Shoulder,Saturday,April
2024-04-27 06:00:00,114,141,2,0,257,64,264,4,0,332,25.7,93,61,7.8,589,True,6,178,405,6,0,2024-04-27,False,False,False,0.6876061120543294,0.30220713073005095,0.010186757215619695,0.0,Shoulder,Saturday,April
2024-04-27 07:00:00,74,771,3,0,848,124,560,2,0,686,25.3,93,63,6.5,1534,True,7,198,1331,5,0,2024-04-27,False,False,True,0.8676662320730117,0.1290743155149935,0.003259452411994785,0.0,Peak,Saturday,April
2024-04-27 08:00:00,60,661,2,0,723,151,665,4,0,820,25.7,94,55,2.9,1543,True,8,211,1326,6,0,2024-04-27,False,False,True,0.8593648736228127,0.13674659753726506,0.0038885288399222295,0.0,Peak,Saturday,April
2024-04-27 09:00:00,61,231,2,0,294,108,480,3,0,591,26.3,89,3,3.8,885,True,9,169,711,5,0,2024-04-27,False,False,False,0.8033898305084746,0.19096045197740114,0.005649717514124294,0.0,Shoulder,Saturday,April
2024-04-27 10:00:00,124,396,6,0,526,70,295,4,0,369,27.1,88,3,3.6,895,True,10,194,691,10,0,2024-04-27,False,False,False,0.7720670391061453,0.21675977653631284,0.0111731843575419,0.0,Shoulder,Saturday,April
2024-04-27 11:00:00,241,449,9,0,699,140,630,4,0,774,28.5,83,3,8.2,1473,True,11,381,1079,13,0,2024-04-27,False,False,True,0.7325186693822132,0.25865580448065173,0.008825526137135099,0.0,Peak,Saturday,April
2024-04-27 12:00:00,209,257,7,1,474,84,365,2,1,452,30.0,77,51,5.1,926,True,12,293,622,9,2,2024-04-27,False,False,False,0.67170626349892,0.31641468682505397,0.009719222462203024,0.0021598272138228943,Peak,Saturday,April
2024-04-27 13:00:00,198,634,7,1,840,66,295,2,1,364,30.6,76,51,3.6,1204,True,13,264,929,9,2,2024-04-27,False,False,False,0.771594684385382,0.21926910299003322,0.007475083056478406,0.0016611295681063123,Peak,Saturday,April
2024-04-27 14:00:00,138,436,5,1,580,64,275,2,1,342,31.1,72,51,4.3,922,True,14,202,711,7,2,2024-04-27,False,False,False,0.7711496746203904,0.21908893709327548,0.007592190889370932,0.0021691973969631237,Peak,Saturday,April
2024-04-27 15:00:00,179,562,7,1,749,130,561,5,1,697,31.5,71,51,5.1,1446,True,15,309,1123,12,2,2024-04-27,False,False,True,0.7766251728907331,0.21369294605809128,0.008298755186721992,0.0013831258644536654,Peak,Saturday,April
2024-04-27 16:00:00,87,275,4,1,367,60,264,4,1,329,31.0,76,53,7.6,696,True,16,147,539,8,2,2024-04-27,False,False,False,0.7744252873563219,0.21120689655172414,0.011494252873563218,0.0028735632183908046,Peak,Saturday,April
2024-04-27 17:00:00,157,503,6,1,667,43,467,2,1,513,28.7,78,65,2.8,1180,True,17,200,970,8,2,2024-04-27,False,False,False,0.8220338983050848,0.1694915254237288,0.006779661016949152,0.001694915254237288,Peak,Saturday,April
2024-04-27 18:00:00,103,331,4,1,439,64,500,3,1,568,28.1,84,51,8.6,1007,True,18,167,831,7,2,2024-04-27,False,False,False,0.8252234359483615,0.16583912611717974,0.006951340615690168,0.0019860973187686196,Peak,Saturday,April
2024-04-27 19:00:00,176,563,9,1,749,113,287,4,1,405,27.4,88,3,9.6,1154,True,19,289,850,13,2,2024-04-27,False,False,False,0.7365684575389948,0.25043327556325823,0.011265164644714038,0.0017331022530329288,Peak,Saturday,April
2024-04-27 20:00:00,85,268,4,1,358,102,458,4,1,565,27.1,91,3,8.7,923,True,20,187,726,8,2,2024-04-27,False,False,False,0.7865655471289275,0.20260021668472372,0.00866738894907909,0.0021668472372697724,Shoulder,Saturday,April
2024-04-27 21:00:00,128,407,6,1,542,85,350,5,1,441,26.8,93,3,4.6,983,True,21,213,757,11,2,2024-04-27,False,False,False,0.7700915564598169,0.21668362156663276,0.011190233977619531,0.002034587995930824,Shoulder,Saturday,April
2024-04-27 22:00:00,65,363,3,1,432,59,514,4,1,578,26.7,94,3,4.6,1010,True,22,124,877,7,2,2024-04-27,False,False,False,0.8683168316831683,0.12277227722772277,0.006930693069306931,0.0019801980198019802,Shoulder,Saturday,April
2024-04-27 23:00:00,141,440,9,1,591,92,403,4,1,500,25.6,95,63,9.2,1091,True,23,233,843,13,2,2024-04-27,False,False,False,0.772685609532539,0.21356553620531624,0.011915673693858845,0.0018331805682859762,Shoulder,Saturday,April
2024-04-28 00:00:00,153,461,6,0,620,32,364,0,0,396,25.9,95,51,4.8,1016,True,0,185,825,6,0,2024-04-28,False,False,False,0.812007874015748,0.18208661417322836,0.005905511811023622,0.0,Off-Peak,Sunday,April
2024-04-28 01:00:00,78,231,3,0,312,45,168,1,0,214,25.7,96,3,3.2,526,True,1,123,399,4,0,2024-04-28,False,False,False,0.7585551330798479,0.2338403041825095,0.0076045627376425855,0.0,Off-Peak,Sunday,April
2024-04-28 02:00:00,97,195,4,0,296,156,184,4,0,344,25.7,96,3,4.4,640,True,2,253,379,8,0,2024-04-28,False,False,False,0.5921875,0.3953125,0.0125,0.0,Off-Peak,Sunday,April
2024-04-28 03:00:00,78,185,4,0,267,99,180,3,0,282,25.5,97,3,3.3,549,True,3,177,365,7,0,2024-04-28,False,False,False,0.6648451730418944,0.3224043715846995,0.012750455373406194,0.0,Off-Peak,Sunday,April
2024-04-28 04:00:00,62,178,2,0,242,66,114,2,0,182,26.1,94,3,2.9,424,True,4,128,292,4,0,2024-04-28,False,False,False,0.6886792452830188,0.3018867924528302,0.009433962264150943,0.0,Off-Peak,Sunday,April
2024-04-28 05:00:00,60,231,3,0,294,84,308,2,0,394,25.6,96,3,5.5,688,True,5,144,539,5,0,2024-04-28,False,False,False,0.7834302325581395,0.20930232558139536,0.007267441860465116,0.0,Shoulder,Sunday,April
2024-04-28 06:00:00,184,558,5,0,747,90,334,2,0,426,25.9,96,3,3.3,1173,True,6,274,892,7,0,2024-04-28,False,False,False,0.7604433077578857,0.23358908780903667,0.005967604433077579,0.0,Shoulder,Sunday,April
2024-04-28 07:00:00,162,493,6,1,662,149,544,4,0,697,25.9,95,3,6.1,1359,True,7,311,1037,10,1,2024-04-28,False,False,False,0.7630610743193524,0.2288447387785136,0.007358351729212656,0.0007358351729212656,Peak,Sunday,April
2024-04-28 08:00:00,175,535,5,1,716,50,477,1,1,529,26.8,93,3,8.7,1245,True,8,225,1012,6,2,2024-04-28,False,False,False,0.8128514056224899,0.18072289156626506,0.004819277108433735,0.001606425702811245,Peak,Sunday,April
2024-04-28 09:00:00,130,392,4,1,527,86,314,3,1,404,27.7,89,3,8.8,931,True,9,216,706,7,2,2024-04-28,False,False,False,0.7583243823845328,0.23200859291084855,0.007518796992481203,0.0021482277121374865,Shoulder,Sunday,April
2024-04-28 10:00:00,156,472,5,1,634,106,391,3,1,501,29.4,82,3,9.4,1135,True,10,262,863,8,2,2024-04-28,False,False,False,0.760352422907489,0.23083700440528634,0.007048458149779736,0.001762114537444934,Shoulder,Sunday,April
2024-04-28 11:00:00,83,244,3,1,331,90,326,2,1,419,30.5,76,3,12.2,750,True,11,173,570,5,2,2024-04-28,False,False,False,0.76,0.23066666666666666,0.006666666666666667,0.0026666666666666666,Peak,Sunday,April
2024-04-28 12:00:00,139,417,3,1,560,77,279,3,2,361,30.5,76,3,13.6,921,True,12,216,696,6,3,2024-04-28,False,False,False,0.755700325732899,0.23452768729641693,0.006514657980456026,0.003257328990228013,Peak,Sunday,April
2024-04-28 13:00:00,97,291,4,1,393,100,368,3,1,472,30.4,78,51,11.2,865,True,13,197,659,7,2,2024-04-28,False,False,False,0.761849710982659,0.2277456647398844,0.008092485549132947,0.0023121387283236996,Peak,Sunday,April
2024-04-28 14:00:00,83,247,4,1,335,94,352,3,1,450,31.1,76,51,8.8,785,True,14,177,599,7,2,2024-04-28,False,False,False,0.7630573248407644,0.22547770700636943,0.008917197452229299,0.0025477707006369425,Peak,Sunday,April
2024-04-28 15:00:00,162,495,7,1,665,105,392,3,1,501,31.3,73,3,10.2,1166,True,15,267,887,10,2,2024-04-28,False,False,False,0.7607204116638079,0.22898799313893653,0.008576329331046312,0.0017152658662092624,Peak,Sunday,April
2024-04-28 16:00:00,93,274,4,1,372,98,361,4,1,464,30.9,74,53,8.4,836,True,16,191,635,8,2,2024-04-28,False,False,False,0.7595693779904307,0.2284688995215311,0.009569377990430622,0.0023923444976076554,Peak,Sunday,April
2024-04-28 17:00:00,137,408,6,1,552,88,321,3,1,413,30.6,76,51,9.8,965,True,17,225,729,9,2,2024-04-28,False,False,False,0.755440414507772,0.23316062176165803,0.00932642487046632,0.002072538860103627,Peak,Sunday,April
2024-04-28 18:00:00,126,372,6,1,505,94,335,5,1,435,29.9,78,3,9.2,940,True,18,220,707,11,2,2024-04-28,False,False,False,0.752127659574468,0.23404255319148937,0.011702127659574468,0.002127659574468085,Peak,Sunday,April
2024-04-28 19:00:00,91,263,5,1,360,158,574,5,1,738,29.3,81,3,6.1,1098,True,19,249,837,10,2,2024-04-28,False,False,False,0.7622950819672131,0.226775956284153,0.009107468123861567,0.0018214936247723133,Peak,Sunday,April
2024-04-28 20:00:00,123,366,6,1,496,50,581,2,1,634,28.5,84,3,5.4,1130,True,20,173,947,8,2,2024-04-28,False,False,False,0.8380530973451328,0.15309734513274337,0.007079646017699115,0.0017699115044247787,Shoulder,Sunday,April
2024-04-28 21:00:00,67,291,5,1,364,70,250,4,1,325,28.7,86,3,11.3,689,True,21,137,541,9,2,2024-04-28,False,False,False,0.7851959361393324,0.1988388969521045,0.013062409288824383,0.002902757619738752,Shoulder,Sunday,April
2024-04-28 22:00:00,126,374,7,1,508,123,450,6,1,580,28.2,87,3,8.3,1088,True,22,249,824,13,2,2024-04-28,False,False,False,0.7573529411764706,0.22886029411764705,0.011948529411764705,0.001838235294117647,Shoulder,Sunday,April
2024-04-28 23:00:00,82,238,7,1,328,132,244,5,1,382,27.7,89,3,8.3,710,True,23,214,482,12,2,2024-04-28,False,False,False,0.6788732394366197,0.30140845070422534,0.016901408450704224,0.0028169014084507044,Shoulder,Sunday,April
2024-04-29 00:00:00,130,454,6,0,590,97,478,2,0,577,27.3,90,3,8.3,1167,False,0,227,932,8,0,2024-04-29,False,False,False,0.7986289631533847,0.194515852613539,0.006855184233076264,0.0,Off-Peak,Monday,April
2024-04-29 01:00:00,137,308,6,0,451,72,246,2,0,320,27.0,91,3,9.1,771,False,1,209,554,8,0,2024-04-29,False,False,False,0.7185473411154345,0.2710765239948119,0.010376134889753566,0.0,Off-Peak,Monday,April
2024-04-29 02:00:00,92,201,5,0,298,52,251,2,0,305,26.6,93,3,9.7,603,False,2,144,452,7,0,2024-04-29,False,False,False,0.7495854063018242,0.23880597014925373,0.011608623548922056,0.0,Off-Peak,Monday,April
2024-04-29 03:00:00,91,193,7,0,291,52,221,5,0,278,26.1,93,3,9.4,569,False,3,143,414,12,0,2024-04-29,False,False,False,0.7275922671353251,0.2513181019332162,0.0210896309314587,0.0,Off-Peak,Monday,April
2024-04-29 04:00:00,65,178,8,0,251,50,221,4,0,275,25.7,93,3,9.4,526,False,4,115,399,12,0,2024-04-29,False,False,False,0.7585551330798479,0.21863117870722434,0.022813688212927757,0.0,Off-Peak,Monday,April
2024-04-29 05:00:00,31,96,9,0,136,35,187,2,0,224,25.5,95,3,8.9,360,False,5,66,283,11,0,2024-04-29,False,False,False,0.7861111111111111,0.18333333333333332,0.030555555555555555,0.0,Shoulder,Monday,April
2024-04-29 06:00:00,201,674,9,0,884,47,551,3,0,601,25.3,96,3,9.5,1485,False,6,248,1225,12,0,2024-04-29,False,False,True,0.8249158249158249,0.16700336700336701,0.00808080808080808,0.0,Shoulder,Monday,April
2024-04-29 07:00:00,105,722,6,0,833,48,713,3,0,764,25.2,96,1,9.8,1597,False,7,153,1435,9,0,2024-04-29,False,False,True,0.8985597996242956,0.09580463368816532,0.005635566687539136,0.0,Peak,Monday,April
2024-04-29 08:00:00,168,562,8,0,738,156,784,7,0,947,25.9,93,3,8.9,1685,False,8,324,1346,15,0,2024-04-29,False,False,True,0.7988130563798219,0.19228486646884274,0.008902077151335312,0.0,Peak,Monday,April
2024-04-29 09:00:00,59,539,3,0,601,107,520,6,0,633,28.6,85,3,6.5,1234,False,9,166,1059,9,0,2024-04-29,False,False,False,0.8581847649918962,0.13452188006482982,0.007293354943273906,0.0,Shoulder,Monday,April
2024-04-29 10:00:00,119,398,6,0,523,46,240,2,0,288,30.1,78,1,8.5,811,False,10,165,638,8,0,2024-04-29,False,False,False,0.7866831072749692,0.2034525277435265,0.009864364981504316,0.0,Shoulder,Monday,April
2024-04-29 11:00:00,197,663,9,0,869,124,605,5,0,734,31.1,73,1,8.4,1603,False,11,321,1268,14,0,2024-04-29,False,False,True,0.7910168434185901,0.20024953212726138,0.008733624454148471,0.0,Peak,Monday,April
2024-04-29 12:00:00,190,634,9,1,834,57,291,3,1,352,31.5,71,51,11.8,1186,False,12,247,925,12,2,2024-04-29,False,False,False,0.7799325463743676,0.20826306913996628,0.01011804384485666,0.0016863406408094434,Peak,Monday,April
2024-04-29 13:00:00,129,421,7,1,558,67,835,4,1,907,31.5,71,51,12.6,1465,False,13,196,1256,11,2,2024-04-29,False,False,True,0.8573378839590444,0.13378839590443686,0.007508532423208191,0.0013651877133105802,Peak,Monday,April
2024-04-29 14:00:00,103,342,7,2,454,71,327,4,1,403,31.6,72,51,10.6,857,False,14,174,669,11,3,2024-04-29,False,False,False,0.780630105017503,0.20303383897316218,0.012835472578763127,0.003500583430571762,Peak,Monday,April
2024-04-29 15:00:00,193,305,5,1,504,145,344,8,2,499,31.2,72,61,11.8,1003,False,15,338,649,13,3,2024-04-29,False,False,False,0.6470588235294118,0.3369890329012961,0.01296111665004985,0.0029910269192422734,Peak,Monday,April
2024-04-29 16:00:00,176,653,5,1,835,73,357,3,1,434,30.6,78,51,13.5,1269,False,16,249,1010,8,2,2024-04-29,False,False,False,0.7959022852639874,0.19621749408983452,0.006304176516942475,0.0015760441292356187,Peak,Monday,April
2024-04-29 17:00:00,140,469,8,1,618,56,280,5,1,342,30.6,77,2,11.1,960,False,17,196,749,13,2,2024-04-29,False,False,False,0.7802083333333333,0.20416666666666666,0.013541666666666667,0.0020833333333333333,Peak,Monday,April
2024-04-29 18:00:00,98,318,6,1,423,110,258,6,1,375,30.5,77,3,10.2,798,False,18,208,576,12,2,2024-04-29,False,False,False,0.7218045112781954,0.2606516290726817,0.015037593984962405,0.002506265664160401,Peak,Monday,April
2024-04-29 19:00:00,163,235,3,1,402,180,891,11,1,1083,29.7,81,3,5.6,1485,False,19,343,1126,14,2,2024-04-29,False,False,True,0.7582491582491583,0.23097643097643097,0.009427609427609427,0.0013468013468013469,Peak,Monday,April
2024-04-29 20:00:00,71,348,5,1,425,183,907,9,1,1100,28.9,83,55,5.4,1525,False,20,254,1255,14,2,2024-04-29,False,False,True,0.8229508196721311,0.16655737704918033,0.009180327868852459,0.0013114754098360656,Shoulder,Monday,April
2024-04-29 21:00:00,195,654,11,1,861,34,164,3,1,202,29.4,81,3,9.1,1063,False,21,229,818,14,2,2024-04-29,False,False,False,0.7695202257761053,0.2154280338664158,0.01317027281279398,0.0018814675446848542,Shoulder,Monday,April
2024-04-29 22:00:00,56,434,4,1,495,85,412,5,1,503,29.1,85,3,9.0,998,False,22,141,846,9,2,2024-04-29,False,False,False,0.8476953907815631,0.14128256513026052,0.009018036072144289,0.002004008016032064,Shoulder,Monday,April
2024-04-29 23:00:00,218,589,14,1,822,171,307,10,1,489,28.7,88,3,7.4,1311,False,23,389,896,24,2,2024-04-29,False,False,False,0.6834477498093059,0.2967200610221205,0.018306636155606407,0.0015255530129672007,Shoulder,Monday,April
2024-04-30 00:00:00,164,347,8,0,519,149,399,2,0,550,28.4,90,3,7.5,1069,False,0,313,746,10,0,2024-04-30,False,False,False,0.6978484565014031,0.29279700654817586,0.009354536950420954,0.0,Off-Peak,Tuesday,April
2024-04-30 01:00:00,88,296,5,0,389,69,338,7,0,414,27.9,90,3,7.9,803,False,1,157,634,12,0,2024-04-30,False,False,False,0.7895392278953923,0.19551681195516812,0.014943960149439602,0.0,Off-Peak,Tuesday,April
2024-04-30 02:00:00,82,265,7,1,355,79,253,3,0,335,27.5,89,3,7.3,690,False,2,161,518,10,1,2024-04-30,False,False,False,0.7507246376811594,0.23333333333333334,0.014492753623188406,0.0014492753623188406,Off-Peak,Tuesday,April
2024-04-30 03:00:00,55,158,5,0,218,54,200,7,0,261,27.1,89,3,6.6,479,False,3,109,358,12,0,2024-04-30,False,False,False,0.7473903966597077,0.22755741127348644,0.025052192066805846,0.0,Off-Peak,Tuesday,April
2024-04-30 04:00:00,57,191,3,0,251,37,162,3,0,202,26.6,92,3,5.3,453,False,4,94,353,6,0,2024-04-30,False,False,False,0.7792494481236203,0.20750551876379691,0.013245033112582781,0.0,Off-Peak,Tuesday,April
2024-04-30 05:00:00,76,182,11,0,269,90,450,7,0,547,26.4,94,3,4.3,816,False,5,166,632,18,0,2024-04-30,False,False,False,0.7745098039215687,0.2034313725490196,0.022058823529411766,0.0,Shoulder,Tuesday,April
2024-04-30 06:00:00,131,543,6,0,680,153,709,4,0,866,26.7,91,2,1.8,1546,False,6,284,1252,10,0,2024-04-30,False,False,True,0.8098318240620958,0.18369987063389392,0.00646830530401035,0.0,Shoulder,Tuesday,April
2024-04-30 07:00:00,164,698,8,0,870,155,738,4,0,897,26.2,94,3,7.0,1767,False,7,319,1436,12,0,2024-04-30,False,False,True,0.8126768534238823,0.18053197509903793,0.006791171477079796,0.0,Peak,Tuesday,April
2024-04-30 08:00:00,209,353,6,0,568,120,773,7,0,900,27.3,90,3,6.2,1468,False,8,329,1126,13,0,2024-04-30,False,False,True,0.7670299727520435,0.22411444141689374,0.008855585831062671,0.0,Peak,Tuesday,April
2024-04-30 09:00:00,107,241,5,0,353,102,514,5,0,621,27.9,89,3,2.8,974,False,9,209,755,10,0,2024-04-30,False,False,False,0.7751540041067762,0.21457905544147843,0.01026694045174538,0.0,Shoulder,Tuesday,April
2024-04-30 10:00:00,151,507,8,0,666,133,238,4,0,375,29.5,84,3,3.2,1041,False,10,284,745,12,0,2024-04-30,False,False,False,0.7156580211335255,0.2728146013448607,0.011527377521613832,0.0,Shoulder,Tuesday,April
2024-04-30 11:00:00,197,646,11,0,854,56,265,5,0,326,30.9,79,51,7.4,1180,False,11,253,911,16,0,2024-04-30,False,False,False,0.7720338983050847,0.21440677966101696,0.013559322033898305,0.0,Peak,Tuesday,April
2024-04-30 12:00:00,48,435,4,0,487,83,395,4,0,482,30.5,80,51,6.8,969,False,12,131,830,8,0,2024-04-30,False,False,False,0.8565531475748194,0.13519091847265222,0.008255933952528379,0.0,Peak,Tuesday,April
2024-04-30 13:00:00,203,667,10,1,881,48,634,6,1,689,30.2,79,51,3.6,1570,False,13,251,1301,16,2,2024-04-30,False,False,True,0.8286624203821656,0.15987261146496815,0.01019108280254777,0.0012738853503184713,Peak,Tuesday,April
2024-04-30 14:00:00,257,860,12,1,1130,55,834,4,1,894,30.0,79,51,6.2,2024,False,14,312,1694,16,2,2024-04-30,False,False,True,0.8369565217391305,0.1541501976284585,0.007905138339920948,0.0009881422924901185,Peak,Tuesday,April
2024-04-30 15:00:00,139,700,9,1,849,154,756,8,2,920,28.8,84,61,7.3,1769,False,15,293,1456,17,3,2024-04-30,False,False,True,0.823063877897117,0.1656302996042962,0.009609949123798756,0.0016958733747880158,Peak,Tuesday,April
2024-04-30 16:00:00,107,835,3,1,946,46,223,2,1,272,29.6,82,3,0.4,1218,False,16,153,1058,5,2,2024-04-30,False,False,False,0.8686371100164204,0.12561576354679804,0.004105090311986864,0.0016420361247947454,Peak,Tuesday,April
2024-04-30 17:00:00,251,529,14,1,795,143,684,9,1,837,29.6,81,51,2.0,1632,False,17,394,1213,23,2,2024-04-30,False,False,True,0.7432598039215687,0.24142156862745098,0.014093137254901961,0.0012254901960784314,Peak,Tuesday,April
2024-04-30 18:00:00,89,276,7,1,373,42,589,2,1,634,29.6,79,51,1.8,1007,False,18,131,865,9,2,2024-04-30,False,False,False,0.858987090367428,0.1300893743793446,0.00893743793445879,0.0019860973187686196,Peak,Tuesday,April
2024-04-30 19:00:00,215,476,13,1,705,54,257,3,1,315,28.7,85,51,1.5,1020,False,19,269,733,16,2,2024-04-30,False,False,False,0.7186274509803922,0.26372549019607844,0.01568627450980392,0.00196078431372549,Peak,Tuesday,April
2024-04-30 20:00:00,164,548,9,1,722,103,481,7,1,592,27.8,93,51,2.9,1314,False,20,267,1029,16,2,2024-04-30,False,False,False,0.7831050228310502,0.20319634703196346,0.0121765601217656,0.0015220700152207,Shoulder,Tuesday,April
2024-04-30 21:00:00,149,493,9,1,652,66,280,4,1,351,28.2,91,3,2.5,1003,False,21,215,773,13,2,2024-04-30,False,False,False,0.7706879361914257,0.2143569292123629,0.01296111665004985,0.0019940179461615153,Shoulder,Tuesday,April
2024-04-30 22:00:00,78,261,6,1,346,58,310,4,1,373,28.1,89,3,7.6,719,False,22,136,571,10,2,2024-04-30,False,False,False,0.7941585535465925,0.18915159944367177,0.013908205841446454,0.0027816411682892906,Shoulder,Tuesday,April
2024-04-30 23:00:00,76,255,5,1,337,171,280,11,1,463,27.5,88,3,8.9,800,False,23,247,535,16,2,2024-04-30,False,False,False,0.66875,0.30875,0.02,0.0025,Shoulder,Tuesday,April
2024-05-01 00:00:00,21,32,3,0,56,23,73,0,0,96,27.1,90,3,5.7,152,False,0,44,105,3,0,2024-05-01,True,True,False,0.6907894736842105,0.2894736842105263,0.019736842105263157,0.0,Off-Peak,Wednesday,May
2024-05-01 01:00:00,68,26,5,0,99,49,152,1,0,202,27.0,91,3,11.1,301,False,1,117,178,6,0,2024-05-01,True,True,False,0.5913621262458472,0.38870431893687707,0.019933554817275746,0.0,Off-Peak,Wednesday,May
2024-05-01 02:00:00,58,45,1,0,104,57,179,1,0,237,26.5,91,61,0.8,341,False,2,115,224,2,0,2024-05-01,True,True,False,0.656891495601173,0.33724340175953077,0.005865102639296188,0.0,Off-Peak,Wednesday,May
2024-05-01 03:00:00,27,54,0,0,81,26,182,0,0,208,25.9,95,63,7.4,289,False,3,53,236,0,0,2024-05-01,True,True,False,0.8166089965397924,0.18339100346020762,0.0,0.0,Off-Peak,Wednesday,May
2024-05-01 04:00:00,50,134,5,1,190,48,150,1,0,199,25.8,93,3,1.3,389,False,4,98,284,6,1,2024-05-01,True,True,False,0.7300771208226221,0.2519280205655527,0.015424164524421594,0.002570694087403599,Off-Peak,Wednesday,May
2024-05-01 05:00:00,70,167,6,1,244,78,241,2,0,321,25.4,97,3,3.9,565,False,5,148,408,8,1,2024-05-01,True,True,False,0.7221238938053097,0.26194690265486725,0.01415929203539823,0.0017699115044247787,Shoulder,Wednesday,May
2024-05-01 06:00:00,85,189,4,2,280,142,346,4,0,492,25.2,96,3,5.4,772,False,6,227,535,8,2,2024-05-01,True,True,False,0.6930051813471503,0.29404145077720206,0.010362694300518135,0.0025906735751295338,Shoulder,Wednesday,May
2024-05-01 07:00:00,73,123,2,1,199,143,442,4,0,589,24.5,97,63,2.2,788,False,7,216,565,6,1,2024-05-01,True,True,False,0.7170050761421319,0.27411167512690354,0.007614213197969543,0.0012690355329949238,Peak,Wednesday,May
2024-05-01 08:00:00,32,587,4,2,625,130,520,6,1,657,25.5,94,51,1.8,1282,False,8,162,1107,10,3,2024-05-01,True,True,False,0.8634945397815913,0.12636505460218408,0.0078003120124804995,0.00234009360374415,Peak,Wednesday,May
2024-05-01 09:00:00,80,239,1,1,321,82,253,6,1,342,28.5,87,3,7.4,663,False,9,162,492,7,2,2024-05-01,True,True,False,0.7420814479638009,0.24434389140271492,0.010558069381598794,0.0030165912518853697,Shoulder,Wednesday,May
2024-05-01 10:00:00,24,347,2,0,373,68,189,4,2,263,29.8,81,3,4.7,636,False,10,92,536,6,2,2024-05-01,True,True,False,0.8427672955974843,0.14465408805031446,0.009433962264150943,0.0031446540880503146,Shoulder,Wednesday,May
2024-05-01 11:00:00,98,364,2,1,465,47,145,1,1,194,31.3,73,3,5.2,659,False,11,145,509,3,2,2024-05-01,True,True,False,0.7723823975720789,0.22003034901365706,0.004552352048558422,0.0030349013657056147,Peak,Wednesday,May
2024-05-01 12:00:00,156,531,1,1,689,54,168,4,0,226,32.0,69,51,9.7,915,False,12,210,699,5,1,2024-05-01,True,True,False,0.7639344262295082,0.22950819672131148,0.00546448087431694,0.001092896174863388,Peak,Wednesday,May
2024-05-01 13:00:00,98,250,5,2,355,74,230,2,1,307,29.7,80,63,8.0,662,False,13,172,480,7,3,2024-05-01,True,True,False,0.7250755287009063,0.2598187311178248,0.010574018126888218,0.004531722054380665,Peak,Wednesday,May
2024-05-01 14:00:00,165,235,0,0,400,56,175,3,0,234,29.9,81,53,2.3,634,False,14,221,410,3,0,2024-05-01,True,True,False,0.6466876971608833,0.34858044164037855,0.00473186119873817,0.0,Peak,Wednesday,May
2024-05-01 15:00:00,180,150,3,0,333,59,122,2,0,183,30.3,78,51,4.0,516,False,15,239,272,5,0,2024-05-01,True,True,False,0.5271317829457365,0.4631782945736434,0.009689922480620155,0.0,Peak,Wednesday,May
2024-05-01 16:00:00,159,290,2,0,451,135,480,4,2,621,30.2,77,53,1.4,1072,False,16,294,770,6,2,2024-05-01,True,True,False,0.7182835820895522,0.27425373134328357,0.005597014925373134,0.0018656716417910447,Peak,Wednesday,May
2024-05-01 17:00:00,148,345,4,1,498,148,457,4,1,610,29.7,78,51,1.1,1108,False,17,296,802,8,2,2024-05-01,True,True,False,0.723826714801444,0.26714801444043323,0.007220216606498195,0.0018050541516245488,Peak,Wednesday,May
2024-05-01 18:00:00,81,456,1,1,539,199,617,6,0,822,29.5,79,51,2.2,1361,False,18,280,1073,7,1,2024-05-01,True,True,False,0.7883908890521675,0.20573108008817045,0.005143277002204262,0.0007347538574577516,Peak,Wednesday,May
2024-05-01 19:00:00,45,463,1,0,509,48,149,1,0,198,28.9,83,51,2.5,707,False,19,93,612,2,0,2024-05-01,True,True,False,0.8656294200848657,0.13154172560113153,0.002828854314002829,0.0,Peak,Wednesday,May
2024-05-01 20:00:00,79,376,2,0,457,76,236,2,0,314,28.1,87,51,5.2,771,False,20,155,612,4,0,2024-05-01,True,True,False,0.7937743190661478,0.20103761348897536,0.005188067444876783,0.0,Shoulder,Wednesday,May
2024-05-01 21:00:00,75,342,3,1,421,64,200,1,0,265,27.0,94,63,2.6,686,False,21,139,542,4,1,2024-05-01,True,True,False,0.7900874635568513,0.20262390670553937,0.0058309037900874635,0.0014577259475218659,Shoulder,Wednesday,May
2024-05-01 22:00:00,38,125,2,1,166,39,121,1,0,161,26.6,96,51,11.6,327,False,22,77,246,3,1,2024-05-01,True,True,False,0.7522935779816514,0.23547400611620795,0.009174311926605505,0.0030581039755351682,Shoulder,Wednesday,May
2024-05-01 23:00:00,24,165,1,0,190,107,208,0,0,315,26.6,93,51,10.4,505,False,23,131,373,1,0,2024-05-01,True,True,False,0.7386138613861386,0.2594059405940594,0.0019801980198019802,0.0,Shoulder,Wednesday,May
2024-05-02 00:00:00,43,236,4,1,284,30,375,5,1,411,26.1,96,3,2.6,695,False,0,73,611,9,2,2024-05-02,False,False,False,0.879136690647482,0.10503597122302158,0.012949640287769784,0.0028776978417266188,Off-Peak,Thursday,May
2024-05-02 01:00:00,54,395,7,1,457,27,578,5,0,610,26.2,96,3,1.9,1067,False,1,81,973,12,1,2024-05-02,False,False,False,0.9119025304592315,0.07591377694470477,0.011246485473289597,0.0009372071227741331,Off-Peak,Thursday,May
2024-05-02 02:00:00,28,429,3,1,461,73,521,3,0,597,26.1,97,3,3.7,1058,False,2,101,950,6,1,2024-05-02,False,False,False,0.8979206049149339,0.09546313799621928,0.005671077504725898,0.000945179584120983,Off-Peak,Thursday,May
2024-05-02 03:00:00,65,473,7,0,545,55,335,3,1,394,25.8,97,3,5.9,939,False,3,120,808,10,1,2024-05-02,False,False,False,0.8604898828541001,0.12779552715654952,0.010649627263045794,0.0010649627263045794,Off-Peak,Thursday,May
2024-05-02 04:00:00,83,405,7,1,496,32,343,5,0,380,25.3,99,3,5.9,876,False,4,115,748,12,1,2024-05-02,False,False,False,0.8538812785388128,0.1312785388127854,0.0136986301369863,0.001141552511415525,Off-Peak,Thursday,May
2024-05-02 05:00:00,88,383,3,0,474,55,573,8,1,637,25.1,99,3,7.0,1111,False,5,143,956,11,1,2024-05-02,False,False,False,0.8604860486048604,0.12871287128712872,0.009900990099009901,0.0009000900090009,Shoulder,Thursday,May
2024-05-02 06:00:00,117,312,4,2,435,73,562,4,0,639,25.0,99,3,6.3,1074,False,6,190,874,8,2,2024-05-02,False,False,False,0.813780260707635,0.17690875232774675,0.0074487895716946,0.00186219739292365,Shoulder,Thursday,May
2024-05-02 07:00:00,96,416,4,0,516,63,380,4,1,448,25.0,99,3,6.0,964,False,7,159,796,8,1,2024-05-02,False,False,False,0.8257261410788381,0.16493775933609958,0.008298755186721992,0.001037344398340249,Peak,Thursday,May
2024-05-02 08:00:00,97,523,3,2,625,54,312,3,2,371,25.8,96,3,6.5,996,False,8,151,835,6,4,2024-05-02,False,False,False,0.8383534136546185,0.15160642570281124,0.006024096385542169,0.004016064257028112,Peak,Thursday,May
2024-05-02 09:00:00,94,516,5,2,617,64,394,5,1,464,26.9,93,51,9.0,1081,False,9,158,910,10,3,2024-05-02,False,False,False,0.8418131359851989,0.1461609620721554,0.009250693802035153,0.0027752081406105457,Shoulder,Thursday,May
2024-05-02 10:00:00,96,428,4,2,530,50,373,10,0,433,29.0,85,51,7.6,963,False,10,146,801,14,2,2024-05-02,False,False,False,0.8317757009345794,0.15160955347871236,0.014537902388369679,0.0020768431983385254,Shoulder,Thursday,May
2024-05-02 11:00:00,116,586,3,1,706,22,300,3,1,326,30.2,79,51,10.0,1032,False,11,138,886,6,2,2024-05-02,False,False,False,0.8585271317829457,0.13372093023255813,0.005813953488372093,0.001937984496124031,Peak,Thursday,May
2024-05-02 12:00:00,150,539,5,0,694,45,566,9,0,620,31.0,72,51,9.1,1314,False,12,195,1105,14,0,2024-05-02,False,False,False,0.8409436834094368,0.14840182648401826,0.0106544901065449,0.0,Peak,Thursday,May
2024-05-02 13:00:00,115,462,3,0,580,27,408,3,1,439,31.3,67,3,9.8,1019,False,13,142,870,6,1,2024-05-02,False,False,False,0.8537782139352306,0.1393523061825319,0.005888125613346418,0.0009813542688910696,Peak,Thursday,May
2024-05-02 14:00:00,105,474,4,1,584,38,536,5,1,580,31.7,64,3,9.4,1164,False,14,143,1010,9,2,2024-05-02,False,False,False,0.8676975945017182,0.12285223367697594,0.007731958762886598,0.001718213058419244,Peak,Thursday,May
2024-05-02 15:00:00,97,527,6,0,630,54,343,6,0,403,31.4,64,3,10.0,1033,False,15,151,870,12,0,2024-05-02,False,False,False,0.8422071636011617,0.14617618586640851,0.011616650532429816,0.0,Peak,Thursday,May
2024-05-02 16:00:00,94,581,7,0,682,64,425,4,1,494,31.3,63,3,6.5,1176,False,16,158,1006,11,1,2024-05-02,False,False,False,0.8554421768707483,0.13435374149659865,0.00935374149659864,0.0008503401360544217,Peak,Thursday,May
2024-05-02 17:00:00,88,432,4,0,524,42,344,2,1,389,30.8,64,3,4.8,913,False,17,130,776,6,1,2024-05-02,False,False,False,0.8499452354874042,0.14238773274917854,0.0065717415115005475,0.001095290251916758,Peak,Thursday,May
2024-05-02 18:00:00,112,446,5,2,565,35,303,6,2,346,29.9,68,3,4.1,911,False,18,147,749,11,4,2024-05-02,False,False,False,0.8221734357848518,0.16136114160263446,0.012074643249176729,0.0043907793633369925,Peak,Thursday,May
2024-05-02 19:00:00,105,388,6,1,500,28,530,4,1,563,28.8,77,3,3.7,1063,False,19,133,918,10,2,2024-05-02,False,False,False,0.863593603010348,0.1251175917215428,0.00940733772342427,0.0018814675446848542,Peak,Thursday,May
2024-05-02 20:00:00,120,462,6,2,590,56,431,6,0,493,28.4,78,3,4.1,1083,False,20,176,893,12,2,2024-05-02,False,False,False,0.8245614035087719,0.16251154201292706,0.0110803324099723,0.0018467220683287165,Shoulder,Thursday,May
2024-05-02 21:00:00,75,306,7,0,388,26,513,4,1,544,28.5,79,3,8.0,932,False,21,101,819,11,1,2024-05-02,False,False,False,0.878755364806867,0.10836909871244635,0.011802575107296138,0.001072961373390558,Shoulder,Thursday,May
2024-05-02 22:00:00,80,300,6,0,386,14,521,4,1,540,28.0,82,51,8.0,926,False,22,94,821,10,1,2024-05-02,False,False,False,0.8866090712742981,0.10151187904967603,0.01079913606911447,0.0010799136069114472,Shoulder,Thursday,May
2024-05-02 23:00:00,25,295,18,0,338,30,348,5,0,383,27.7,86,3,7.0,721,False,23,55,643,23,0,2024-05-02,False,False,False,0.8918169209431346,0.07628294036061026,0.0319001386962552,0.0,Shoulder,Thursday,May
2024-05-03 00:00:00,25,110,5,0,140,34,330,6,0,370,27.4,88,3,7.5,510,False,0,59,440,11,0,2024-05-03,False,False,False,0.8627450980392157,0.11568627450980393,0.021568627450980392,0.0,Off-Peak,Friday,May
2024-05-03 01:00:00,18,150,7,1,176,23,220,5,0,248,26.9,91,3,5.0,424,False,1,41,370,12,1,2024-05-03,False,False,False,0.8726415094339622,0.09669811320754718,0.02830188679245283,0.0023584905660377358,Off-Peak,Friday,May
2024-05-03 02:00:00,43,122,8,0,173,54,491,6,1,552,26.4,96,2,4.8,725,False,2,97,613,14,1,2024-05-03,False,False,False,0.8455172413793104,0.13379310344827586,0.019310344827586208,0.001379310344827586,Off-Peak,Friday,May
2024-05-03 03:00:00,35,132,4,0,171,84,529,5,0,618,26.9,93,3,1.5,789,False,3,119,661,9,0,2024-05-03,False,False,False,0.8377693282636248,0.15082382762991128,0.011406844106463879,0.0,Off-Peak,Friday,May
2024-05-03 04:00:00,52,166,3,0,221,65,517,6,1,589,26.2,97,51,5.8,810,False,4,117,683,9,1,2024-05-03,False,False,False,0.8432098765432099,0.14444444444444443,0.011111111111111112,0.0012345679012345679,Off-Peak,Friday,May
2024-05-03 05:00:00,120,441,9,1,571,99,477,6,2,584,26.2,96,51,6.9,1155,False,5,219,918,15,3,2024-05-03,False,False,False,0.7948051948051948,0.18961038961038962,0.012987012987012988,0.0025974025974025974,Shoulder,Friday,May
2024-05-03 06:00:00,89,532,10,0,631,45,345,2,1,393,26.0,95,63,7.3,1024,False,6,134,877,12,1,2024-05-03,False,False,False,0.8564453125,0.130859375,0.01171875,0.0009765625,Shoulder,Friday,May
2024-05-03 07:00:00,106,635,7,1,749,44,453,4,1,502,25.6,96,63,5.4,1251,False,7,150,1088,11,2,2024-05-03,False,False,False,0.8697042366107114,0.11990407673860912,0.008792965627498001,0.0015987210231814548,Peak,Friday,May
2024-05-03 08:00:00,97,722,5,0,824,65,354,9,0,428,25.3,96,63,3.6,1252,False,8,162,1076,14,0,2024-05-03,False,False,False,0.8594249201277955,0.12939297124600638,0.011182108626198083,0.0,Peak,Friday,May
2024-05-03 09:00:00,97,586,8,1,692,49,553,7,1,610,28.2,89,55,3.1,1302,False,9,146,1139,15,2,2024-05-03,False,False,False,0.8748079877112135,0.11213517665130568,0.01152073732718894,0.0015360983102918587,Shoulder,Friday,May
2024-05-03 10:00:00,89,640,5,2,736,56,653,5,0,714,27.5,84,61,15.5,1450,False,10,145,1293,10,2,2024-05-03,False,False,True,0.8917241379310344,0.1,0.006896551724137931,0.001379310344827586,Shoulder,Friday,May
2024-05-03 11:00:00,95,560,8,1,664,40,665,8,1,714,27.9,84,53,8.6,1378,False,11,135,1225,16,2,2024-05-03,False,False,True,0.8889695210449927,0.09796806966618288,0.011611030478955007,0.001451378809869376,Peak,Friday,May
2024-05-03 12:00:00,163,631,9,0,803,48,459,6,1,514,29.3,82,51,7.9,1317,False,12,211,1090,15,1,2024-05-03,False,False,False,0.8276385725132878,0.16021260440394836,0.011389521640091117,0.0007593014426727411,Peak,Friday,May
2024-05-03 13:00:00,150,488,13,0,651,35,608,5,2,650,28.8,82,51,8.4,1301,False,13,185,1096,18,2,2024-05-03,False,False,False,0.8424289008455035,0.14219830899308225,0.013835511145272867,0.0015372790161414297,Peak,Friday,May
2024-05-03 14:00:00,102,525,6,1,634,41,541,6,0,588,29.3,80,3,6.8,1222,False,14,143,1066,12,1,2024-05-03,False,False,False,0.8723404255319149,0.11702127659574468,0.009819967266775777,0.0008183306055646482,Peak,Friday,May
2024-05-03 15:00:00,122,503,0,0,625,36,405,2,0,443,30.4,75,3,7.8,1068,False,15,158,908,2,0,2024-05-03,False,False,False,0.850187265917603,0.14794007490636704,0.0018726591760299626,0.0,Peak,Friday,May
2024-05-03 16:00:00,96,551,1,1,649,40,356,5,0,401,30.3,75,3,8.3,1050,False,16,136,907,6,1,2024-05-03,False,False,False,0.8638095238095238,0.1295238095238095,0.005714285714285714,0.0009523809523809524,Peak,Friday,May
2024-05-03 17:00:00,106,620,3,0,729,34,314,4,0,352,30.1,77,3,8.5,1081,False,17,140,934,7,0,2024-05-03,False,False,False,0.8640148011100832,0.12950971322849214,0.0064754856614246065,0.0,Peak,Friday,May
2024-05-03 18:00:00,85,577,5,0,667,41,270,3,0,314,29.3,78,3,9.9,981,False,18,126,847,8,0,2024-05-03,False,False,False,0.8634046890927625,0.12844036697247707,0.00815494393476045,0.0,Peak,Friday,May
2024-05-03 19:00:00,63,450,4,0,517,36,381,5,1,423,28.6,82,3,7.2,940,False,19,99,831,9,1,2024-05-03,False,False,False,0.8840425531914894,0.10531914893617021,0.009574468085106383,0.0010638297872340426,Peak,Friday,May
2024-05-03 20:00:00,44,350,7,0,401,42,397,5,1,445,28.2,86,3,3.9,846,False,20,86,747,12,1,2024-05-03,False,False,False,0.8829787234042553,0.1016548463356974,0.014184397163120567,0.001182033096926714,Shoulder,Friday,May
2024-05-03 21:00:00,30,270,6,1,307,48,391,4,0,443,26.5,90,61,12.0,750,False,21,78,661,10,1,2024-05-03,False,False,False,0.8813333333333333,0.104,0.013333333333333334,0.0013333333333333333,Shoulder,Friday,May
2024-05-03 22:00:00,34,208,2,0,244,41,288,2,0,331,25.6,93,61,2.4,575,False,22,75,496,4,0,2024-05-03,False,False,False,0.8626086956521739,0.13043478260869565,0.006956521739130435,0.0,Shoulder,Friday,May
2024-05-03 23:00:00,28,233,0,0,261,32,205,3,0,240,25.8,93,51,5.4,501,False,23,60,438,3,0,2024-05-03,False,False,False,0.874251497005988,0.11976047904191617,0.005988023952095809,0.0,Shoulder,Friday,May
2024-05-04 00:00:00,18,160,3,1,182,18,120,0,0,138,25.3,95,51,3.1,320,True,0,36,280,3,1,2024-05-04,False,False,False,0.875,0.1125,0.009375,0.003125,Off-Peak,Saturday,May
2024-05-04 01:00:00,26,220,2,0,248,20,172,2,1,195,25.2,95,3,2.7,443,True,1,46,392,4,1,2024-05-04,False,False,False,0.8848758465011287,0.1038374717832957,0.009029345372460496,0.002257336343115124,Off-Peak,Saturday,May
2024-05-04 02:00:00,54,321,5,0,380,19,182,1,0,202,24.6,97,61,7.6,582,True,2,73,503,6,0,2024-05-04,False,False,False,0.8642611683848798,0.1254295532646048,0.010309278350515464,0.0,Off-Peak,Saturday,May
2024-05-04 03:00:00,44,250,2,1,297,31,167,3,0,201,24.2,99,63,6.8,498,True,3,75,417,5,1,2024-05-04,False,False,False,0.8373493975903614,0.15060240963855423,0.010040160642570281,0.002008032128514056,Off-Peak,Saturday,May
2024-05-04 04:00:00,53,360,1,0,414,42,225,2,1,270,24.3,97,61,4.2,684,True,4,95,585,3,1,2024-05-04,False,False,False,0.8552631578947368,0.1388888888888889,0.0043859649122807015,0.0014619883040935672,Off-Peak,Saturday,May
2024-05-04 05:00:00,66,560,1,0,627,55,359,1,0,415,24.4,96,61,3.2,1042,True,5,121,919,2,0,2024-05-04,False,False,False,0.8819577735124761,0.11612284069097889,0.0019193857965451055,0.0,Shoulder,Saturday,May
2024-05-04 06:00:00,163,430,10,2,605,57,490,8,2,557,24.5,96,63,5.1,1162,True,6,220,920,18,4,2024-05-04,False,False,False,0.7917383820998278,0.18932874354561102,0.01549053356282272,0.0034423407917383822,Shoulder,Saturday,May
2024-05-04 07:00:00,154,560,6,0,720,68,530,5,0,603,24.0,98,63,7.7,1323,True,7,222,1090,11,0,2024-05-04,False,False,False,0.8238851095993953,0.16780045351473924,0.008314436885865457,0.0,Peak,Saturday,May
2024-05-04 08:00:00,108,551,5,1,665,62,422,10,1,495,24.2,98,55,9.0,1160,True,8,170,973,15,2,2024-05-04,False,False,False,0.8387931034482758,0.14655172413793102,0.01293103448275862,0.0017241379310344827,Peak,Saturday,May
2024-05-04 09:00:00,170,448,6,0,624,52,710,3,0,765,26.1,93,63,12.4,1389,True,9,222,1158,9,0,2024-05-04,False,False,True,0.8336933045356372,0.15982721382289417,0.0064794816414686825,0.0,Shoulder,Saturday,May
2024-05-04 10:00:00,115,501,3,0,619,63,558,0,0,621,26.6,90,61,5.4,1240,True,10,178,1059,3,0,2024-05-04,False,False,False,0.8540322580645161,0.1435483870967742,0.0024193548387096775,0.0,Shoulder,Saturday,May
2024-05-04 11:00:00,133,520,1,3,657,77,670,4,0,751,26.8,86,53,8.7,1408,True,11,210,1190,5,3,2024-05-04,False,False,True,0.8451704545454546,0.14914772727272727,0.0035511363636363635,0.002130681818181818,Peak,Saturday,May
2024-05-04 12:00:00,107,450,3,0,560,45,522,1,1,569,26.8,85,51,12.7,1129,True,12,152,972,4,1,2024-05-04,False,False,False,0.8609388839681134,0.13463241806908768,0.00354295837023915,0.0008857395925597874,Peak,Saturday,May
2024-05-04 13:00:00,155,469,4,0,628,63,433,3,1,500,27.1,83,51,11.0,1128,True,13,218,902,7,1,2024-05-04,False,False,False,0.799645390070922,0.19326241134751773,0.0062056737588652485,0.0008865248226950354,Peak,Saturday,May
2024-05-04 14:00:00,91,422,2,0,515,50,440,0,0,490,28.0,76,3,11.5,1005,True,14,141,862,2,0,2024-05-04,False,False,False,0.8577114427860697,0.14029850746268657,0.001990049751243781,0.0,Peak,Saturday,May
2024-05-04 15:00:00,103,336,3,1,443,47,564,0,0,611,27.6,76,3,11.2,1054,True,15,150,900,3,1,2024-05-04,False,False,False,0.8538899430740038,0.14231499051233396,0.0028462998102466793,0.0009487666034155598,Peak,Saturday,May
2024-05-04 16:00:00,56,340,0,0,396,36,470,5,0,511,27.5,75,3,10.0,907,True,16,92,810,5,0,2024-05-04,False,False,False,0.8930540242557883,0.10143329658213891,0.005512679162072767,0.0,Peak,Saturday,May
2024-05-04 17:00:00,52,260,1,0,313,45,420,2,0,467,27.1,78,51,6.8,780,True,17,97,680,3,0,2024-05-04,False,False,False,0.8717948717948718,0.12435897435897436,0.0038461538461538464,0.0,Peak,Saturday,May
2024-05-04 18:00:00,46,497,2,1,546,59,397,2,1,459,27.1,80,51,5.6,1005,True,18,105,894,4,2,2024-05-04,False,False,False,0.8895522388059701,0.1044776119402985,0.003980099502487562,0.001990049751243781,Peak,Saturday,May
2024-05-04 19:00:00,41,460,1,0,502,31,229,0,0,260,26.3,87,3,3.2,762,True,19,72,689,1,0,2024-05-04,False,False,False,0.9041994750656168,0.09448818897637795,0.0013123359580052493,0.0,Peak,Saturday,May
2024-05-04 20:00:00,50,354,0,0,404,46,230,3,0,279,26.1,87,3,3.4,683,True,20,96,584,3,0,2024-05-04,False,False,False,0.8550512445095169,0.14055636896046853,0.004392386530014641,0.0,Shoulder,Saturday,May
2024-05-04 21:00:00,49,240,1,1,291,34,310,0,1,345,27.8,80,3,10.2,636,True,21,83,550,1,2,2024-05-04,False,False,False,0.8647798742138365,0.13050314465408805,0.0015723270440251573,0.0031446540880503146,Shoulder,Saturday,May
2024-05-04 22:00:00,33,179,3,2,217,22,323,1,0,346,27.6,81,3,7.0,563,True,22,55,502,4,2,2024-05-04,False,False,False,0.8916518650088809,0.09769094138543517,0.007104795737122558,0.003552397868561279,Shoulder,Saturday,May
2024-05-04 23:00:00,24,159,2,0,185,11,104,1,0,116,27.3,82,3,4.9,301,True,23,35,263,3,0,2024-05-04,False,False,False,0.8737541528239202,0.11627906976744186,0.009966777408637873,0.0,Shoulder,Saturday,May
2024-05-05 00:00:00,21,130,3,0,154,19,133,2,0,154,26.8,86,3,4.0,308,True,0,40,263,5,0,2024-05-05,False,False,False,0.8538961038961039,0.12987012987012986,0.016233766233766232,0.0,Off-Peak,Sunday,May
2024-05-05 01:00:00,19,221,5,0,245,23,197,4,0,224,26.7,89,3,4.9,469,True,1,42,418,9,0,2024-05-05,False,False,False,0.8912579957356077,0.08955223880597014,0.019189765458422176,0.0,Off-Peak,Sunday,May
2024-05-05 02:00:00,33,150,6,1,190,27,166,1,1,195,26.4,90,3,3.3,385,True,2,60,316,7,2,2024-05-05,False,False,False,0.8207792207792208,0.15584415584415584,0.01818181818181818,0.005194805194805195,Off-Peak,Sunday,May
2024-05-05 03:00:00,35,176,2,0,213,25,180,2,1,208,25.8,91,3,5.0,421,True,3,60,356,4,1,2024-05-05,False,False,False,0.8456057007125891,0.14251781472684086,0.009501187648456057,0.0023752969121140144,Off-Peak,Sunday,May
2024-05-05 04:00:00,45,149,5,1,200,34,177,6,0,217,25.8,91,3,5.6,417,True,4,79,326,11,1,2024-05-05,False,False,False,0.7817745803357314,0.18944844124700239,0.026378896882494004,0.002398081534772182,Off-Peak,Sunday,May
2024-05-05 05:00:00,61,190,2,0,253,50,220,1,2,273,26.9,83,3,2.5,526,True,5,111,410,3,2,2024-05-05,False,False,False,0.779467680608365,0.21102661596958175,0.005703422053231939,0.0038022813688212928,Shoulder,Sunday,May
2024-05-05 06:00:00,76,349,0,0,425,58,530,5,0,593,26.4,86,3,2.6,1018,True,6,134,879,5,0,2024-05-05,False,False,False,0.8634577603143418,0.13163064833005894,0.004911591355599214,0.0,Shoulder,Sunday,May
2024-05-05 07:00:00,88,458,3,0,549,46,449,5,0,500,26.3,87,1,2.6,1049,True,7,134,907,8,0,2024-05-05,False,False,False,0.8646329837940896,0.12774070543374644,0.0076263107721639654,0.0,Peak,Sunday,May
2024-05-05 08:00:00,94,577,5,1,677,60,320,4,0,384,27.0,89,3,4.3,1061,True,8,154,897,9,1,2024-05-05,False,False,False,0.8454288407163054,0.14514608859566447,0.008482563619227144,0.000942507068803016,Peak,Sunday,May
2024-05-05 09:00:00,112,552,4,1,669,70,579,8,1,658,29.6,77,3,7.2,1327,True,9,182,1131,12,2,2024-05-05,False,False,False,0.8522984174830445,0.13715146948003015,0.00904295403165034,0.0015071590052750565,Shoulder,Sunday,May
2024-05-05 10:00:00,116,560,4,1,681,93,441,0,0,534,30.3,71,2,10.5,1215,True,10,209,1001,4,1,2024-05-05,False,False,False,0.8238683127572016,0.1720164609053498,0.0032921810699588477,0.0008230452674897119,Shoulder,Sunday,May
2024-05-05 11:00:00,100,580,7,1,688,66,505,2,0,573,30.6,71,3,13.3,1261,True,11,166,1085,9,1,2024-05-05,False,False,False,0.8604282315622522,0.1316415543219667,0.007137192704203013,0.0007930214115781126,Peak,Sunday,May
2024-05-05 12:00:00,106,444,3,0,553,61,677,1,0,739,30.8,70,2,13.1,1292,True,12,167,1121,4,0,2024-05-05,False,False,False,0.8676470588235294,0.12925696594427244,0.0030959752321981426,0.0,Peak,Sunday,May
2024-05-05 13:00:00,104,532,1,1,638,58,410,1,2,471,31.2,66,3,12.0,1109,True,13,162,942,2,3,2024-05-05,False,False,False,0.8494138863841298,0.1460775473399459,0.0018034265103697023,0.002705139765554554,Peak,Sunday,May
2024-05-05 14:00:00,126,420,1,2,549,73,440,0,0,513,31.1,66,1,10.2,1062,True,14,199,860,1,2,2024-05-05,False,False,False,0.8097928436911488,0.1873822975517891,0.0009416195856873823,0.0018832391713747645,Peak,Sunday,May
2024-05-05 15:00:00,131,510,6,0,647,53,455,3,1,512,31.3,66,1,10.5,1159,True,15,184,965,9,1,2024-05-05,False,False,False,0.8326143226919759,0.15875754961173424,0.007765314926660914,0.0008628127696289905,Peak,Sunday,May
2024-05-05 16:00:00,88,522,4,1,615,66,530,0,0,596,31.2,68,1,8.4,1211,True,16,154,1052,4,1,2024-05-05,False,False,False,0.8687035507844756,0.12716763005780346,0.0033030553261767133,0.0008257638315441783,Peak,Sunday,May
2024-05-05 17:00:00,99,546,2,0,647,50,442,1,0,493,31.2,65,1,5.5,1140,True,17,149,988,3,0,2024-05-05,False,False,False,0.8666666666666667,0.1307017543859649,0.002631578947368421,0.0,Peak,Sunday,May
2024-05-05 18:00:00,77,450,0,0,527,65,403,2,0,470,30.7,67,0,5.0,997,True,18,142,853,2,0,2024-05-05,False,False,False,0.8555667001003009,0.1424272818455366,0.0020060180541624875,0.0,Peak,Sunday,May
2024-05-05 19:00:00,54,369,2,0,425,30,390,1,1,422,29.3,76,1,5.6,847,True,19,84,759,3,1,2024-05-05,False,False,False,0.8961038961038961,0.09917355371900827,0.0035419126328217238,0.0011806375442739079,Peak,Sunday,May
2024-05-05 20:00:00,46,229,4,1,280,22,244,1,0,267,28.4,81,1,7.2,547,True,20,68,473,5,1,2024-05-05,False,False,False,0.8647166361974405,0.12431444241316271,0.009140767824497258,0.0018281535648994515,Shoulder,Sunday,May
2024-05-05 21:00:00,63,188,3,1,255,28,330,1,0,359,29.2,79,0,7.7,614,True,21,91,518,4,1,2024-05-05,False,False,False,0.8436482084690554,0.1482084690553746,0.006514657980456026,0.0016286644951140066,Shoulder,Sunday,May
2024-05-05 22:00:00,31,192,2,0,225,17,160,2,0,179,29.0,80,1,8.9,404,True,22,48,352,4,0,2024-05-05,False,False,False,0.8712871287128713,0.1188118811881188,0.009900990099009901,0.0,Shoulder,Sunday,May
2024-05-05 23:00:00,20,102,0,0,122,12,218,0,0,230,28.5,84,0,6.6,352,True,23,32,320,0,0,2024-05-05,False,False,False,0.9090909090909091,0.09090909090909091,0.0,0.0,Shoulder,Sunday,May
2024-05-06 00:00:00,21,162,3,0,186,15,178,2,0,195,27.8,86,0,9.0,381,False,0,36,340,5,0,2024-05-06,False,False,False,0.8923884514435696,0.09448818897637795,0.013123359580052493,0.0,Off-Peak,Monday,May
2024-05-06 01:00:00,25,190,3,1,219,23,183,5,1,212,27.0,89,0,4.4,431,False,1,48,373,8,2,2024-05-06,False,False,False,0.8654292343387471,0.11136890951276102,0.018561484918793503,0.004640371229698376,Off-Peak,Monday,May
2024-05-06 02:00:00,43,230,5,0,278,33,186,4,1,224,26.6,89,0,5.4,502,False,2,76,416,9,1,2024-05-06,False,False,False,0.8286852589641435,0.15139442231075698,0.017928286852589643,0.00199203187250996,Off-Peak,Monday,May
2024-05-06 03:00:00,50,190,6,0,246,25,179,3,0,207,26.2,90,0,8.4,453,False,3,75,369,9,0,2024-05-06,False,False,False,0.8145695364238411,0.16556291390728478,0.019867549668874173,0.0,Off-Peak,Monday,May
2024-05-06 04:00:00,65,343,8,0,416,28,193,1,0,222,26.3,89,0,9.2,638,False,4,93,536,9,0,2024-05-06,False,False,False,0.8401253918495298,0.14576802507836992,0.014106583072100314,0.0,Off-Peak,Monday,May
2024-05-06 05:00:00,98,280,6,0,384,32,220,7,0,259,25.7,90,53,4.5,643,False,5,130,500,13,0,2024-05-06,False,False,False,0.7776049766718507,0.20217729393468117,0.02021772939346812,0.0,Shoulder,Monday,May
2024-05-06 06:00:00,107,450,6,2,565,92,310,5,0,407,25.2,93,53,1.1,972,False,6,199,760,11,2,2024-05-06,False,False,False,0.7818930041152263,0.20473251028806586,0.01131687242798354,0.00205761316872428,Shoulder,Monday,May
2024-05-06 07:00:00,112,390,9,1,512,105,640,3,2,750,25.5,94,51,3.6,1262,False,7,217,1030,12,3,2024-05-06,False,False,False,0.8161648177496038,0.17194928684627575,0.009508716323296355,0.002377179080824089,Peak,Monday,May
2024-05-06 08:00:00,125,533,11,0,669,65,440,2,1,508,26.4,93,53,4.8,1177,False,8,190,973,13,1,2024-05-06,False,False,False,0.826677994902294,0.16142735768903993,0.011045029736618521,0.0008496176720475786,Peak,Monday,May
2024-05-06 09:00:00,95,450,6,0,551,80,421,6,0,507,27.0,86,3,8.1,1058,False,9,175,871,12,0,2024-05-06,False,False,False,0.8232514177693762,0.16540642722117202,0.011342155009451797,0.0,Shoulder,Monday,May
2024-05-06 10:00:00,116,560,3,0,679,76,570,8,0,654,28.9,82,3,4.3,1333,False,10,192,1130,11,0,2024-05-06,False,False,False,0.8477119279819955,0.14403600900225055,0.008252063015753939,0.0,Shoulder,Monday,May
2024-05-06 11:00:00,139,640,7,0,786,61,611,12,1,685,30.4,77,51,9.7,1471,False,11,200,1251,19,1,2024-05-06,False,False,True,0.8504418762746431,0.13596193065941536,0.01291638341264446,0.0006798096532970768,Peak,Monday,May
2024-05-06 12:00:00,102,691,3,1,797,82,684,11,1,778,31.0,73,1,8.3,1575,False,12,184,1375,14,2,2024-05-06,False,False,True,0.873015873015873,0.11682539682539683,0.008888888888888889,0.0012698412698412698,Peak,Monday,May
2024-05-06 13:00:00,151,557,1,0,709,85,502,9,0,596,31.6,69,0,10.1,1305,False,13,236,1059,10,0,2024-05-06,False,False,False,0.8114942528735632,0.18084291187739462,0.007662835249042145,0.0,Peak,Monday,May
2024-05-06 14:00:00,113,539,5,1,658,66,577,17,0,660,31.9,66,0,9.3,1318,False,14,179,1116,22,1,2024-05-06,False,False,False,0.8467374810318664,0.13581183611532624,0.01669195751138088,0.0007587253414264037,Peak,Monday,May
2024-05-06 15:00:00,76,480,4,0,560,70,531,5,1,607,31.9,64,1,8.4,1167,False,15,146,1011,9,1,2024-05-06,False,False,False,0.8663239074550129,0.12510711225364182,0.007712082262210797,0.000856898029134533,Peak,Monday,May
2024-05-06 16:00:00,59,532,3,0,594,52,599,6,1,658,31.7,65,0,9.2,1252,False,16,111,1131,9,1,2024-05-06,False,False,False,0.9033546325878594,0.08865814696485623,0.00718849840255591,0.0007987220447284345,Peak,Monday,May
2024-05-06 17:00:00,47,410,5,0,462,50,560,3,0,613,31.3,68,1,8.7,1075,False,17,97,970,8,0,2024-05-06,False,False,False,0.9023255813953488,0.09023255813953489,0.0074418604651162795,0.0,Peak,Monday,May
2024-05-06 18:00:00,70,517,2,0,589,49,590,2,1,642,30.6,71,3,8.0,1231,False,18,119,1107,4,1,2024-05-06,False,False,False,0.8992688870836718,0.0966693744922827,0.003249390739236393,0.0008123476848090983,Peak,Monday,May
2024-05-06 19:00:00,83,429,6,0,518,24,460,1,2,487,29.6,78,2,6.5,1005,False,19,107,889,7,2,2024-05-06,False,False,False,0.8845771144278607,0.10646766169154229,0.006965174129353234,0.001990049751243781,Peak,Monday,May
2024-05-06 20:00:00,64,441,8,0,513,36,391,4,1,432,29.2,79,3,10.2,945,False,20,100,832,12,1,2024-05-06,False,False,False,0.8804232804232804,0.10582010582010581,0.012698412698412698,0.0010582010582010583,Shoulder,Monday,May
2024-05-06 21:00:00,71,359,2,1,433,12,455,2,0,469,28.4,87,3,10.8,902,False,21,83,814,4,1,2024-05-06,False,False,False,0.9024390243902439,0.09201773835920177,0.004434589800443459,0.0011086474501108647,Shoulder,Monday,May
2024-05-06 22:00:00,66,287,9,0,362,18,218,1,1,238,28.0,86,3,8.5,600,False,22,84,505,10,1,2024-05-06,False,False,False,0.8416666666666667,0.14,0.016666666666666666,0.0016666666666666668,Shoulder,Monday,May
2024-05-06 23:00:00,42,140,8,0,190,11,102,1,0,114,27.7,88,3,8.4,304,False,23,53,242,9,0,2024-05-06,False,False,False,0.7960526315789473,0.17434210526315788,0.029605263157894735,0.0,Shoulder,Monday,May
2024-05-07 00:00:00,28,285,6,1,320,97,540,7,0,644,27.5,91,3,6.5,964,False,0,125,825,13,1,2024-05-07,False,False,False,0.8558091286307054,0.12966804979253113,0.013485477178423237,0.001037344398340249,Off-Peak,Tuesday,May
2024-05-07 01:00:00,32,454,7,1,494,107,316,6,1,430,27.0,92,3,8.0,924,False,1,139,770,13,2,2024-05-07,False,False,False,0.8333333333333334,0.15043290043290045,0.01406926406926407,0.0021645021645021645,Off-Peak,Tuesday,May
2024-05-07 02:00:00,83,502,7,1,593,107,458,4,0,569,26.7,91,3,5.7,1162,False,2,190,960,11,1,2024-05-07,False,False,False,0.8261617900172117,0.16351118760757316,0.00946643717728055,0.0008605851979345956,Off-Peak,Tuesday,May
2024-05-07 03:00:00,79,504,7,1,591,106,438,5,0,549,26.2,94,51,2.6,1140,False,3,185,942,12,1,2024-05-07,False,False,False,0.8263157894736842,0.16228070175438597,0.010526315789473684,0.0008771929824561404,Off-Peak,Tuesday,May
2024-05-07 04:00:00,99,537,6,0,642,93,494,6,0,593,25.2,96,63,5.8,1235,False,4,192,1031,12,0,2024-05-07,False,False,False,0.8348178137651822,0.15546558704453442,0.009716599190283401,0.0,Off-Peak,Tuesday,May
2024-05-07 05:00:00,92,481,7,0,580,96,490,7,0,593,25.0,96,61,2.8,1173,False,5,188,971,14,0,2024-05-07,False,False,False,0.8277919863597613,0.16027280477408354,0.011935208866155157,0.0,Shoulder,Tuesday,May
2024-05-07 06:00:00,147,257,6,0,410,36,558,4,0,598,24.5,97,63,0.8,1008,False,6,183,815,10,0,2024-05-07,False,False,False,0.808531746031746,0.18154761904761904,0.00992063492063492,0.0,Shoulder,Tuesday,May
2024-05-07 07:00:00,89,335,3,1,428,48,420,10,0,478,24.2,96,61,6.3,906,False,7,137,755,13,1,2024-05-07,False,False,False,0.8333333333333334,0.15121412803532008,0.01434878587196468,0.0011037527593818985,Peak,Tuesday,May
2024-05-07 08:00:00,154,385,5,0,544,44,348,4,1,397,24.6,95,53,1.5,941,False,8,198,733,9,1,2024-05-07,False,False,False,0.7789585547290117,0.2104144527098831,0.009564293304994687,0.0010626992561105207,Peak,Tuesday,May
2024-05-07 09:00:00,163,328,4,0,495,30,573,3,0,606,28.0,88,3,3.7,1101,False,9,193,901,7,0,2024-05-07,False,False,False,0.818346957311535,0.17529518619436876,0.006357856494096276,0.0,Shoulder,Tuesday,May
2024-05-07 10:00:00,156,696,9,1,862,32,609,5,0,646,28.4,85,51,8.6,1508,False,10,188,1305,14,1,2024-05-07,False,False,True,0.8653846153846154,0.1246684350132626,0.009283819628647215,0.000663129973474801,Shoulder,Tuesday,May
2024-05-07 11:00:00,154,405,6,0,565,34,353,9,0,396,29.5,78,51,8.4,961,False,11,188,758,15,0,2024-05-07,False,False,False,0.7887617065556711,0.19562955254942768,0.015608740894901144,0.0,Peak,Tuesday,May
2024-05-07 12:00:00,87,479,6,1,573,41,284,4,1,330,30.6,72,3,9.0,903,False,12,128,763,10,2,2024-05-07,False,False,False,0.8449612403100775,0.14174972314507198,0.01107419712070875,0.0022148394241417496,Peak,Tuesday,May
2024-05-07 13:00:00,75,444,8,1,528,34,537,4,0,575,31.0,69,51,10.0,1103,False,13,109,981,12,1,2024-05-07,False,False,False,0.8893925657298277,0.09882139619220308,0.010879419764279238,0.0009066183136899365,Peak,Tuesday,May
2024-05-07 14:00:00,50,365,4,0,419,30,327,8,0,365,31.3,66,3,9.1,784,False,14,80,692,12,0,2024-05-07,False,False,False,0.8826530612244898,0.10204081632653061,0.015306122448979591,0.0,Peak,Tuesday,May
2024-05-07 15:00:00,78,267,3,0,348,41,362,2,1,406,31.1,67,3,10.3,754,False,15,119,629,5,1,2024-05-07,False,False,False,0.8342175066312998,0.15782493368700265,0.006631299734748011,0.001326259946949602,Peak,Tuesday,May
2024-05-07 16:00:00,47,373,6,0,426,32,310,5,0,347,30.6,71,2,6.9,773,False,16,79,683,11,0,2024-05-07,False,False,False,0.8835705045278137,0.10219922380336352,0.014230271668822769,0.0,Peak,Tuesday,May
2024-05-07 17:00:00,62,338,5,0,405,48,365,3,0,416,30.5,71,1,6.5,821,False,17,110,703,8,0,2024-05-07,False,False,False,0.856272838002436,0.13398294762484775,0.0097442143727162,0.0,Peak,Tuesday,May
2024-05-07 18:00:00,48,328,3,0,379,30,332,3,0,365,30.2,71,3,5.4,744,False,18,78,660,6,0,2024-05-07,False,False,False,0.8870967741935484,0.10483870967741936,0.008064516129032258,0.0,Peak,Tuesday,May
2024-05-07 19:00:00,50,298,4,0,352,41,355,2,1,399,29.1,77,3,5.8,751,False,19,91,653,6,1,2024-05-07,False,False,False,0.8695073235685752,0.12117177097203728,0.007989347536617843,0.0013315579227696406,Peak,Tuesday,May
2024-05-07 20:00:00,62,373,3,0,438,46,274,5,0,325,28.6,78,3,7.9,763,False,20,108,647,8,0,2024-05-07,False,False,False,0.8479685452162516,0.14154652686762778,0.010484927916120577,0.0,Shoulder,Tuesday,May
2024-05-07 21:00:00,55,360,3,1,419,43,256,5,0,304,27.4,85,51,1.8,723,False,21,98,616,8,1,2024-05-07,False,False,False,0.8520055325034578,0.1355463347164592,0.011065006915629323,0.0013831258644536654,Shoulder,Tuesday,May
2024-05-07 22:00:00,62,280,2,0,344,49,278,3,0,330,26.0,92,61,9.8,674,False,22,111,558,5,0,2024-05-07,False,False,False,0.827893175074184,0.16468842729970326,0.00741839762611276,0.0,Shoulder,Tuesday,May
2024-05-07 23:00:00,73,345,9,0,427,6,142,3,0,151,25.1,96,63,1.5,578,False,23,79,487,12,0,2024-05-07,False,False,False,0.842560553633218,0.13667820069204153,0.020761245674740483,0.0,Shoulder,Tuesday,May
2024-05-08 00:00:00,89,293,0,0,382,36,350,6,0,392,25.4,95,63,5.2,774,False,0,125,643,6,0,2024-05-08,False,False,False,0.8307493540051679,0.16149870801033592,0.007751937984496124,0.0,Off-Peak,Wednesday,May
2024-05-08 01:00:00,30,111,5,1,147,84,528,3,1,616,25.6,96,63,6.6,763,False,1,114,639,8,2,2024-05-08,False,False,False,0.8374836173001311,0.14941022280471822,0.010484927916120577,0.002621231979030144,Off-Peak,Wednesday,May
2024-05-08 02:00:00,65,131,6,1,203,104,705,0,1,810,25.4,98,63,3.7,1013,False,2,169,836,6,2,2024-05-08,False,False,False,0.8252714708785784,0.16683119447186576,0.005923000987166831,0.0019743336623889436,Off-Peak,Wednesday,May
2024-05-08 03:00:00,46,239,5,1,291,72,300,6,1,379,25.5,98,61,2.6,670,False,3,118,539,11,2,2024-05-08,False,False,False,0.8044776119402985,0.1761194029850746,0.016417910447761194,0.0029850746268656717,Off-Peak,Wednesday,May
2024-05-08 04:00:00,15,318,2,0,335,58,315,5,0,378,25.3,99,53,4.7,713,False,4,73,633,7,0,2024-05-08,False,False,False,0.8877980364656382,0.10238429172510519,0.009817671809256662,0.0,Off-Peak,Wednesday,May
2024-05-08 05:00:00,89,134,5,0,228,44,231,5,1,281,25.1,98,53,3.5,509,False,5,133,365,10,1,2024-05-08,False,False,False,0.7170923379174853,0.26129666011787817,0.019646365422396856,0.0019646365422396855,Shoulder,Wednesday,May
2024-05-08 06:00:00,200,826,4,0,1030,69,406,5,1,481,24.8,98,51,6.4,1511,False,6,269,1232,9,1,2024-05-08,False,False,True,0.8153540701522171,0.17802779616148245,0.005956320317670417,0.0006618133686300463,Shoulder,Wednesday,May
2024-05-08 07:00:00,203,771,3,1,978,19,636,9,0,664,24.7,97,51,5.7,1642,False,7,222,1407,12,1,2024-05-08,False,False,True,0.8568818514007308,0.13520097442143728,0.007308160779537149,0.0006090133982947625,Peak,Wednesday,May
2024-05-08 08:00:00,134,158,13,1,306,76,718,6,1,801,25.2,96,51,4.9,1107,False,8,210,876,19,2,2024-05-08,False,False,False,0.7913279132791328,0.1897018970189702,0.017163504968383016,0.0018066847335140017,Peak,Wednesday,May
2024-05-08 09:00:00,77,409,4,0,490,40,483,2,2,527,25.7,94,53,2.5,1017,False,9,117,892,6,2,2024-05-08,False,False,False,0.8770894788593904,0.11504424778761062,0.0058997050147492625,0.0019665683382497543,Shoulder,Wednesday,May
2024-05-08 10:00:00,127,426,3,0,556,17,480,5,0,502,26.8,90,51,4.0,1058,False,10,144,906,8,0,2024-05-08,False,False,False,0.8563327032136105,0.13610586011342155,0.007561436672967864,0.0,Shoulder,Wednesday,May
2024-05-08 11:00:00,124,572,2,0,698,25,442,3,0,470,28.4,82,3,0.8,1168,False,11,149,1014,5,0,2024-05-08,False,False,False,0.8681506849315068,0.12756849315068494,0.004280821917808219,0.0,Peak,Wednesday,May
2024-05-08 12:00:00,96,109,2,1,208,69,674,3,1,747,29.5,79,51,4.0,955,False,12,165,783,5,2,2024-05-08,False,False,False,0.8198952879581152,0.17277486910994763,0.005235602094240838,0.0020942408376963353,Peak,Wednesday,May
2024-05-08 13:00:00,84,603,6,0,693,59,376,4,1,440,30.2,76,51,6.4,1133,False,13,143,979,10,1,2024-05-08,False,False,False,0.8640776699029126,0.1262135922330097,0.0088261253309797,0.00088261253309797,Peak,Wednesday,May
2024-05-08 14:00:00,94,353,6,1,454,14,520,4,0,538,30.2,75,51,8.7,992,False,14,108,873,10,1,2024-05-08,False,False,False,0.8800403225806451,0.10887096774193548,0.010080645161290322,0.0010080645161290322,Peak,Wednesday,May
2024-05-08 15:00:00,111,380,0,1,492,56,511,2,1,570,30.0,78,51,10.0,1062,False,15,167,891,2,2,2024-05-08,False,False,False,0.8389830508474576,0.15725047080979285,0.0018832391713747645,0.0018832391713747645,Peak,Wednesday,May
2024-05-08 16:00:00,53,696,11,1,761,103,539,10,0,652,29.3,81,51,8.6,1413,False,16,156,1235,21,1,2024-05-08,False,False,True,0.8740268931351733,0.11040339702760085,0.014861995753715499,0.0007077140835102619,Peak,Wednesday,May
2024-05-08 17:00:00,51,901,1,1,954,130,463,6,0,599,29.2,79,51,8.0,1553,False,17,181,1364,7,1,2024-05-08,False,False,True,0.8783000643915003,0.11654861558274308,0.004507405022537025,0.000643915003219575,Peak,Wednesday,May
2024-05-08 18:00:00,58,368,13,2,441,48,136,9,1,194,28.5,80,51,8.9,635,False,18,106,504,22,3,2024-05-08,False,False,False,0.7937007874015748,0.16692913385826771,0.03464566929133858,0.004724409448818898,Peak,Wednesday,May
2024-05-08 19:00:00,102,277,5,0,384,48,267,3,1,319,27.9,84,51,7.4,703,False,19,150,544,8,1,2024-05-08,False,False,False,0.7738264580369844,0.21337126600284495,0.011379800853485065,0.001422475106685633,Peak,Wednesday,May
2024-05-08 20:00:00,84,556,6,1,647,38,226,3,1,268,26.9,91,51,5.6,915,False,20,122,782,9,2,2024-05-08,False,False,False,0.8546448087431694,0.13333333333333333,0.009836065573770493,0.002185792349726776,Shoulder,Wednesday,May
2024-05-08 21:00:00,53,415,6,1,475,19,200,2,0,221,27.3,90,3,9.0,696,False,21,72,615,8,1,2024-05-08,False,False,False,0.8836206896551724,0.10344827586206896,0.011494252873563218,0.0014367816091954023,Shoulder,Wednesday,May
2024-05-08 22:00:00,40,330,7,0,377,18,379,0,1,398,27.0,90,3,8.8,775,False,22,58,709,7,1,2024-05-08,False,False,False,0.9148387096774193,0.07483870967741936,0.00903225806451613,0.0012903225806451613,Shoulder,Wednesday,May
2024-05-08 23:00:00,52,654,4,0,710,13,145,4,0,162,26.7,89,3,5.2,872,False,23,65,799,8,0,2024-05-08,False,False,False,0.9162844036697247,0.07454128440366972,0.009174311926605505,0.0,Shoulder,Wednesday,May
2024-05-09 00:00:00,23,278,4,0,305,9,141,2,1,153,25.9,93,3,2.5,458,False,0,32,419,6,1,2024-05-09,False,False,False,0.9148471615720524,0.06986899563318777,0.013100436681222707,0.002183406113537118,Off-Peak,Thursday,May
2024-05-09 01:00:00,15,176,5,0,196,84,179,3,1,267,25.4,97,3,4.7,463,False,1,99,355,8,1,2024-05-09,False,False,False,0.7667386609071274,0.21382289416846653,0.017278617710583154,0.0021598272138228943,Off-Peak,Thursday,May
2024-05-09 02:00:00,73,170,3,0,246,15,469,6,0,490,25.0,99,3,3.7,736,False,2,88,639,9,0,2024-05-09,False,False,False,0.8682065217391305,0.11956521739130435,0.012228260869565218,0.0,Off-Peak,Thursday,May
2024-05-09 03:00:00,43,131,6,0,180,51,284,2,0,337,25.0,97,3,1.8,517,False,3,94,415,8,0,2024-05-09,False,False,False,0.8027079303675049,0.18181818181818182,0.015473887814313346,0.0,Off-Peak,Thursday,May
2024-05-09 04:00:00,90,430,9,0,529,80,289,3,0,372,25.0,96,3,2.1,901,False,4,170,719,12,0,2024-05-09,False,False,False,0.7980022197558269,0.18867924528301888,0.013318534961154272,0.0,Off-Peak,Thursday,May
2024-05-09 05:00:00,36,374,8,1,419,80,142,2,0,224,24.8,96,3,2.3,643,False,5,116,516,10,1,2024-05-09,False,False,False,0.80248833592535,0.18040435458786935,0.015552099533437015,0.0015552099533437014,Shoulder,Thursday,May
2024-05-09 06:00:00,87,571,6,0,664,27,622,3,1,653,24.6,96,2,3.0,1317,False,6,114,1193,9,1,2024-05-09,False,False,False,0.90584662110858,0.08656036446469248,0.00683371298405467,0.0007593014426727411,Shoulder,Thursday,May
2024-05-09 07:00:00,147,259,10,0,416,87,433,5,1,526,24.6,96,2,4.0,942,False,7,234,692,15,1,2024-05-09,False,False,False,0.7346072186836518,0.2484076433121019,0.01592356687898089,0.0010615711252653928,Peak,Thursday,May
2024-05-09 08:00:00,176,460,1,0,637,14,829,10,0,853,25.3,95,2,4.8,1490,False,8,190,1289,11,0,2024-05-09,False,False,True,0.8651006711409396,0.12751677852348994,0.00738255033557047,0.0,Peak,Thursday,May
2024-05-09 09:00:00,82,487,3,0,572,22,230,4,0,256,28.5,83,1,7.4,828,False,9,104,717,7,0,2024-05-09,False,False,False,0.8659420289855072,0.12560386473429952,0.008454106280193236,0.0,Shoulder,Thursday,May
2024-05-09 10:00:00,122,351,6,0,479,79,545,5,2,631,29.9,75,3,7.5,1110,False,10,201,896,11,2,2024-05-09,False,False,False,0.8072072072072072,0.1810810810810811,0.00990990990990991,0.0018018018018018018,Shoulder,Thursday,May
2024-05-09 11:00:00,110,539,8,0,657,13,371,4,0,388,31.0,69,2,12.1,1045,False,11,123,910,12,0,2024-05-09,False,False,False,0.8708133971291866,0.11770334928229666,0.011483253588516746,0.0,Peak,Thursday,May
2024-05-09 12:00:00,57,446,8,1,512,25,381,6,0,412,31.7,64,1,11.8,924,False,12,82,827,14,1,2024-05-09,False,False,False,0.895021645021645,0.08874458874458875,0.015151515151515152,0.0010822510822510823,Peak,Thursday,May
2024-05-09 13:00:00,51,548,6,0,605,22,276,1,1,300,32.0,64,3,14.0,905,False,13,73,824,7,1,2024-05-09,False,False,False,0.9104972375690608,0.08066298342541436,0.0077348066298342545,0.0011049723756906078,Peak,Thursday,May
2024-05-09 14:00:00,47,406,7,0,460,46,573,5,0,624,32.1,65,3,13.3,1084,False,14,93,979,12,0,2024-05-09,False,False,False,0.9031365313653137,0.08579335793357934,0.01107011070110701,0.0,Peak,Thursday,May
2024-05-09 15:00:00,109,471,5,0,585,39,408,1,0,448,31.8,66,2,13.2,1033,False,15,148,879,6,0,2024-05-09,False,False,False,0.850919651500484,0.14327202323330107,0.005808325266214908,0.0,Peak,Thursday,May
2024-05-09 16:00:00,44,811,4,0,859,98,519,9,0,626,31.3,69,3,12.6,1485,False,16,142,1330,13,0,2024-05-09,False,False,True,0.8956228956228957,0.09562289562289562,0.008754208754208754,0.0,Peak,Thursday,May
2024-05-09 17:00:00,125,587,10,0,722,83,658,7,1,749,30.6,70,51,4.4,1471,False,17,208,1245,17,1,2024-05-09,False,False,True,0.8463630183548606,0.14140040788579197,0.011556764106050306,0.0006798096532970768,Peak,Thursday,May
2024-05-09 18:00:00,160,906,0,0,1066,103,896,9,0,1008,30.6,70,51,2.9,2074,False,18,263,1802,9,0,2024-05-09,False,False,True,0.8688524590163934,0.12680810028929604,0.004339440694310511,0.0,Peak,Thursday,May
2024-05-09 19:00:00,48,146,4,0,198,29,460,5,0,494,29.7,79,3,1.4,692,False,19,77,606,9,0,2024-05-09,False,False,False,0.8757225433526011,0.11127167630057803,0.01300578034682081,0.0,Peak,Thursday,May
2024-05-09 20:00:00,83,549,1,0,633,88,410,6,1,505,28.5,85,3,3.1,1138,False,20,171,959,7,1,2024-05-09,False,False,False,0.8427065026362038,0.15026362038664323,0.006151142355008787,0.0008787346221441124,Shoulder,Thursday,May
2024-05-09 21:00:00,97,346,3,0,446,89,389,4,1,483,28.9,78,3,10.2,929,False,21,186,735,7,1,2024-05-09,False,False,False,0.7911733046286329,0.20021528525296017,0.007534983853606028,0.001076426264800861,Shoulder,Thursday,May
2024-05-09 22:00:00,77,139,6,0,222,46,166,2,0,214,28.2,81,3,8.7,436,False,22,123,305,8,0,2024-05-09,False,False,False,0.6995412844036697,0.28211009174311924,0.01834862385321101,0.0,Shoulder,Thursday,May
2024-05-09 23:00:00,59,249,4,0,312,60,160,3,1,224,27.5,83,3,7.3,536,False,23,119,409,7,1,2024-05-09,False,False,False,0.7630597014925373,0.22201492537313433,0.013059701492537313,0.0018656716417910447,Shoulder,Thursday,May
2024-05-10 00:00:00,60,676,9,1,746,26,123,2,0,151,27.0,86,3,3.9,897,False,0,86,799,11,1,2024-05-10,False,False,False,0.8907469342251951,0.09587513935340022,0.012263099219620958,0.0011148272017837235,Off-Peak,Friday,May
2024-05-10 01:00:00,100,119,1,1,221,44,117,2,1,164,26.6,87,61,2.3,385,False,1,144,236,3,2,2024-05-10,False,False,False,0.612987012987013,0.37402597402597404,0.007792207792207792,0.005194805194805195,Off-Peak,Friday,May
2024-05-10 02:00:00,115,631,3,0,749,38,161,0,1,200,26.5,90,2,10.0,949,False,2,153,792,3,1,2024-05-10,False,False,False,0.8345626975763962,0.1612223393045311,0.003161222339304531,0.001053740779768177,Off-Peak,Friday,May
2024-05-10 03:00:00,109,283,10,0,402,52,691,0,0,743,26.4,90,2,5.2,1145,False,3,161,974,10,0,2024-05-10,False,False,False,0.8506550218340612,0.1406113537117904,0.008733624454148471,0.0,Off-Peak,Friday,May
2024-05-10 04:00:00,67,225,5,0,297,50,337,5,0,392,26.2,91,2,4.9,689,False,4,117,562,10,0,2024-05-10,False,False,False,0.8156748911465893,0.16981132075471697,0.01451378809869376,0.0,Off-Peak,Friday,May
2024-05-10 05:00:00,123,171,7,0,301,55,418,8,0,481,25.8,92,3,4.1,782,False,5,178,589,15,0,2024-05-10,False,False,False,0.7531969309462916,0.22762148337595908,0.01918158567774936,0.0,Shoulder,Friday,May
2024-05-10 06:00:00,28,733,7,1,769,71,970,5,1,1047,26.1,90,2,9.8,1816,False,6,99,1703,12,2,2024-05-10,False,False,True,0.9377753303964758,0.054515418502202644,0.006607929515418502,0.0011013215859030838,Shoulder,Friday,May
2024-05-10 07:00:00,119,534,9,0,662,29,381,14,2,426,25.9,89,3,7.7,1088,False,7,148,915,23,2,2024-05-10,False,False,False,0.8409926470588235,0.13602941176470587,0.021139705882352942,0.001838235294117647,Peak,Friday,May
2024-05-10 08:00:00,72,280,8,1,361,29,642,5,1,677,26.5,89,3,7.3,1038,False,8,101,922,13,2,2024-05-10,False,False,False,0.8882466281310212,0.09730250481695568,0.012524084778420038,0.0019267822736030828,Peak,Friday,May
2024-05-10 09:00:00,102,239,11,1,353,41,517,1,1,560,28.5,88,3,9.6,913,False,9,143,756,12,2,2024-05-10,False,False,False,0.828039430449069,0.1566265060240964,0.013143483023001095,0.002190580503833516,Shoulder,Friday,May
2024-05-10 10:00:00,45,623,7,0,675,50,645,10,0,705,29.5,84,51,14.8,1380,False,10,95,1268,17,0,2024-05-10,False,False,True,0.9188405797101449,0.06884057971014493,0.012318840579710146,0.0,Shoulder,Friday,May
2024-05-10 11:00:00,101,390,3,0,494,25,589,3,0,617,30.2,78,51,11.2,1111,False,11,126,979,6,0,2024-05-10,False,False,False,0.8811881188118812,0.11341134113411341,0.0054005400540054005,0.0,Peak,Friday,May
2024-05-10 12:00:00,104,577,1,0,682,56,462,11,0,529,31.2,73,51,10.2,1211,False,12,160,1039,12,0,2024-05-10,False,False,False,0.8579686209744013,0.13212221304706853,0.00990916597853014,0.0,Peak,Friday,May
2024-05-10 13:00:00,109,110,3,0,222,40,359,5,0,404,31.5,71,51,9.4,626,False,13,149,469,8,0,2024-05-10,False,False,False,0.7492012779552716,0.2380191693290735,0.012779552715654952,0.0,Peak,Friday,May
2024-05-10 14:00:00,84,113,6,0,203,21,403,6,1,431,29.9,77,53,13.8,634,False,14,105,516,12,1,2024-05-10,False,False,False,0.8138801261829653,0.16561514195583596,0.01892744479495268,0.0015772870662460567,Peak,Friday,May
2024-05-10 15:00:00,79,102,6,0,187,25,347,5,1,378,30.5,75,51,7.9,565,False,15,104,449,11,1,2024-05-10,False,False,False,0.7946902654867256,0.184070796460177,0.019469026548672566,0.0017699115044247787,Peak,Friday,May
2024-05-10 16:00:00,106,554,3,1,664,40,869,1,2,912,30.6,74,51,9.2,1576,False,16,146,1423,4,3,2024-05-10,False,False,True,0.9029187817258884,0.09263959390862944,0.0025380710659898475,0.0019035532994923859,Peak,Friday,May
2024-05-10 17:00:00,56,1200,8,0,1264,80,353,15,2,450,30.3,75,3,11.6,1714,False,17,136,1553,23,2,2024-05-10,False,False,True,0.9060676779463244,0.07934655775962661,0.013418903150525088,0.0011668611435239206,Peak,Friday,May
2024-05-10 18:00:00,100,1399,18,1,1518,33,746,12,0,791,30.0,76,3,13.0,2309,False,18,133,2145,30,1,2024-05-10,False,False,True,0.9289735816370723,0.057600692940666956,0.0129926375054136,0.00043308791684711995,Peak,Friday,May
2024-05-10 19:00:00,19,277,8,0,304,51,287,0,1,339,28.8,80,3,13.9,643,False,19,70,564,8,1,2024-05-10,False,False,False,0.8771384136858476,0.1088646967340591,0.012441679626749611,0.0015552099533437014,Peak,Friday,May
2024-05-10 20:00:00,76,488,8,0,572,10,239,4,0,253,28.5,83,3,10.4,825,False,20,86,727,12,0,2024-05-10,False,False,False,0.8812121212121212,0.10424242424242425,0.014545454545454545,0.0,Shoulder,Friday,May
2024-05-10 21:00:00,105,332,0,0,437,42,385,8,1,436,28.3,87,3,13.7,873,False,21,147,717,8,1,2024-05-10,False,False,False,0.8213058419243986,0.16838487972508592,0.009163802978235968,0.001145475372279496,Shoulder,Friday,May
2024-05-10 22:00:00,70,117,1,0,188,35,459,7,0,501,28.1,88,3,11.9,689,False,22,105,576,8,0,2024-05-10,False,False,False,0.8359941944847605,0.15239477503628446,0.011611030478955007,0.0,Shoulder,Friday,May
2024-05-10 23:00:00,123,598,3,0,724,7,271,3,0,281,27.8,88,3,8.0,1005,False,23,130,869,6,0,2024-05-10,False,False,False,0.8646766169154229,0.12935323383084577,0.005970149253731343,0.0,Shoulder,Friday,May
2024-05-11 00:00:00,29,292,2,0,323,52,114,3,1,170,27.4,88,3,6.8,493,True,0,81,406,5,1,2024-05-11,False,False,False,0.8235294117647058,0.1643002028397566,0.010141987829614604,0.002028397565922921,Off-Peak,Saturday,May
2024-05-11 01:00:00,17,285,2,1,305,51,141,4,0,196,26.7,90,3,4.0,501,True,1,68,426,6,1,2024-05-11,False,False,False,0.8502994011976048,0.13572854291417166,0.011976047904191617,0.001996007984031936,Off-Peak,Saturday,May
2024-05-11 02:00:00,108,169,0,1,278,39,316,3,1,359,26.4,92,3,4.7,637,True,2,147,485,3,2,2024-05-11,False,False,False,0.7613814756671899,0.23076923076923078,0.004709576138147566,0.0031397174254317113,Off-Peak,Saturday,May
2024-05-11 03:00:00,120,400,6,0,526,8,318,4,0,330,26.3,92,3,6.5,856,True,3,128,718,10,0,2024-05-11,False,False,False,0.8387850467289719,0.14953271028037382,0.011682242990654205,0.0,Off-Peak,Saturday,May
2024-05-11 04:00:00,113,620,5,1,739,61,264,1,1,327,26.0,93,3,4.4,1066,True,4,174,884,6,2,2024-05-11,False,False,False,0.8292682926829268,0.16322701688555347,0.005628517823639775,0.001876172607879925,Off-Peak,Saturday,May
2024-05-11 05:00:00,45,242,2,0,289,53,278,5,0,336,25.9,93,3,3.7,625,True,5,98,520,7,0,2024-05-11,False,False,False,0.832,0.1568,0.0112,0.0,Shoulder,Saturday,May
2024-05-11 06:00:00,95,525,9,0,629,33,830,8,1,872,25.7,93,3,5.5,1501,True,6,128,1355,17,1,2024-05-11,False,False,True,0.9027315123251166,0.08527648234510327,0.011325782811459028,0.0006662225183211193,Shoulder,Saturday,May
2024-05-11 07:00:00,73,338,0,2,413,94,538,1,1,634,25.5,95,3,3.7,1047,True,7,167,876,1,3,2024-05-11,False,False,False,0.836676217765043,0.15950334288443171,0.0009551098376313276,0.0028653295128939827,Peak,Saturday,May
2024-05-11 08:00:00,171,637,1,1,810,44,307,4,2,357,26.7,91,3,3.3,1167,True,8,215,944,5,3,2024-05-11,False,False,False,0.8089117395029991,0.1842330762639246,0.004284490145672665,0.002570694087403599,Peak,Saturday,May
2024-05-11 09:00:00,64,406,0,1,471,16,339,5,1,361,28.3,87,3,4.9,832,True,9,80,745,5,2,2024-05-11,False,False,False,0.8954326923076923,0.09615384615384616,0.006009615384615385,0.002403846153846154,Shoulder,Saturday,May
2024-05-11 10:00:00,82,336,3,1,422,17,311,1,1,330,30.2,78,3,6.8,752,True,10,99,647,4,2,2024-05-11,False,False,False,0.8603723404255319,0.13164893617021275,0.005319148936170213,0.0026595744680851063,Shoulder,Saturday,May
2024-05-11 11:00:00,17,229,5,0,251,8,533,1,1,543,31.2,73,51,9.6,794,True,11,25,762,6,1,2024-05-11,False,False,False,0.9596977329974811,0.031486146095717885,0.007556675062972292,0.0012594458438287153,Peak,Saturday,May
2024-05-11 12:00:00,67,591,3,1,662,51,355,4,0,410,31.9,71,51,7.9,1072,True,12,118,946,7,1,2024-05-11,False,False,False,0.8824626865671642,0.11007462686567164,0.0065298507462686565,0.0009328358208955224,Peak,Saturday,May
2024-05-11 13:00:00,54,301,1,0,356,55,602,5,1,663,31.8,71,51,6.1,1019,True,13,109,903,6,1,2024-05-11,False,False,False,0.8861629048086359,0.1069676153091266,0.005888125613346418,0.0009813542688910696,Peak,Saturday,May
2024-05-11 14:00:00,104,509,5,0,618,56,480,3,1,540,32.3,70,51,8.9,1158,True,14,160,989,8,1,2024-05-11,False,False,False,0.8540587219343696,0.1381692573402418,0.0069084628670120895,0.0008635578583765112,Peak,Saturday,May
2024-05-11 15:00:00,106,323,5,1,435,56,360,3,1,420,31.9,72,51,1.8,855,True,15,162,683,8,2,2024-05-11,False,False,False,0.7988304093567251,0.18947368421052632,0.00935672514619883,0.0023391812865497076,Peak,Saturday,May
2024-05-11 16:00:00,157,906,8,0,1071,96,947,1,1,1045,28.7,82,65,7.2,2116,True,16,253,1853,9,1,2024-05-11,False,False,True,0.8757088846880907,0.11956521739130435,0.004253308128544423,0.0004725897920604915,Peak,Saturday,May
2024-05-11 17:00:00,144,656,3,0,803,34,360,4,0,398,27.9,85,51,8.2,1201,True,17,178,1016,7,0,2024-05-11,False,False,False,0.8459616985845129,0.1482098251457119,0.005828476269775187,0.0,Peak,Saturday,May
2024-05-11 18:00:00,120,793,3,1,917,101,988,5,1,1095,28.3,83,51,4.3,2012,True,18,221,1781,8,2,2024-05-11,False,False,True,0.8851888667992047,0.10984095427435388,0.003976143141153081,0.0009940357852882703,Peak,Saturday,May
2024-05-11 19:00:00,86,317,6,1,410,58,497,3,1,559,27.9,88,51,2.7,969,True,19,144,814,9,2,2024-05-11,False,False,False,0.8400412796697626,0.14860681114551083,0.009287925696594427,0.0020639834881320948,Peak,Saturday,May
2024-05-11 20:00:00,77,378,4,1,460,24,242,3,0,269,27.2,93,3,4.2,729,True,20,101,620,7,1,2024-05-11,False,False,False,0.850480109739369,0.13854595336076816,0.009602194787379973,0.0013717421124828531,Shoulder,Saturday,May
2024-05-11 21:00:00,56,183,6,0,245,32,149,3,0,184,27.9,87,3,4.3,429,True,21,88,332,9,0,2024-05-11,False,False,False,0.7738927738927739,0.20512820512820512,0.02097902097902098,0.0,Shoulder,Saturday,May
2024-05-11 22:00:00,41,227,4,1,273,45,305,1,1,352,27.5,91,3,7.2,625,True,22,86,532,5,2,2024-05-11,False,False,False,0.8512,0.1376,0.008,0.0032,Shoulder,Saturday,May
2024-05-11 23:00:00,8,120,2,0,130,8,209,3,1,221,27.2,92,3,7.2,351,True,23,16,329,5,1,2024-05-11,False,False,False,0.9373219373219374,0.045584045584045586,0.014245014245014245,0.002849002849002849,Shoulder,Saturday,May
2024-05-12 00:00:00,28,270,0,0,298,31,313,0,1,345,26.6,96,3,3.7,643,True,0,59,583,0,1,2024-05-12,False,False,False,0.9066874027993779,0.09175738724727839,0.0,0.0015552099533437014,Off-Peak,Sunday,May
2024-05-12 01:00:00,110,230,2,0,342,44,289,3,1,337,26.3,97,3,2.2,679,True,1,154,519,5,1,2024-05-12,False,False,False,0.7643593519882179,0.2268041237113402,0.007363770250368188,0.0014727540500736377,Off-Peak,Sunday,May
2024-05-12 02:00:00,89,474,3,0,566,93,523,3,0,619,26.2,97,3,5.1,1185,True,2,182,997,6,0,2024-05-12,False,False,False,0.8413502109704641,0.15358649789029535,0.005063291139240506,0.0,Off-Peak,Sunday,May
2024-05-12 03:00:00,58,521,3,1,583,53,227,3,2,285,26.1,97,3,4.5,868,True,3,111,748,6,3,2024-05-12,False,False,False,0.8617511520737328,0.12788018433179724,0.0069124423963133645,0.0034562211981566822,Off-Peak,Sunday,May
2024-05-12 04:00:00,103,230,2,0,335,70,220,3,1,294,26.0,97,3,4.1,629,True,4,173,450,5,1,2024-05-12,False,False,False,0.7154213036565977,0.27503974562798095,0.00794912559618442,0.001589825119236884,Off-Peak,Sunday,May
2024-05-12 05:00:00,18,255,2,0,275,60,248,2,0,310,25.7,98,3,2.6,585,True,5,78,503,4,0,2024-05-12,False,False,False,0.8598290598290599,0.13333333333333333,0.006837606837606838,0.0,Shoulder,Sunday,May
2024-05-12 06:00:00,80,628,5,1,714,42,814,4,2,862,25.6,96,3,4.7,1576,True,6,122,1442,9,3,2024-05-12,False,False,True,0.9149746192893401,0.07741116751269035,0.005710659898477157,0.0019035532994923859,Shoulder,Sunday,May
2024-05-12 07:00:00,105,471,8,0,584,119,869,3,1,992,25.4,97,3,2.6,1576,True,7,224,1340,11,1,2024-05-12,False,False,True,0.850253807106599,0.14213197969543148,0.006979695431472081,0.0006345177664974619,Peak,Sunday,May
2024-05-12 08:00:00,133,932,7,1,1073,27,972,1,0,1000,26.5,94,3,4.8,2073,True,8,160,1904,8,1,2024-05-12,False,False,True,0.9184756391702846,0.07718282682103232,0.003859141341051616,0.000482392667631452,Peak,Sunday,May
2024-05-12 09:00:00,38,311,4,0,353,54,210,2,1,267,27.9,91,51,2.4,620,True,9,92,521,6,1,2024-05-12,False,False,False,0.8403225806451613,0.14838709677419354,0.00967741935483871,0.0016129032258064516,Shoulder,Sunday,May
2024-05-12 10:00:00,52,492,1,0,545,18,190,3,2,213,28.1,88,51,4.7,758,True,10,70,682,4,2,2024-05-12,False,False,False,0.899736147757256,0.09234828496042216,0.005277044854881266,0.002638522427440633,Shoulder,Sunday,May
2024-05-12 11:00:00,78,460,4,1,543,89,224,3,3,319,29.1,84,3,3.2,862,True,11,167,684,7,4,2024-05-12,False,False,False,0.7935034802784223,0.1937354988399072,0.008120649651972157,0.004640371229698376,Peak,Sunday,May
2024-05-12 12:00:00,113,217,2,0,332,42,397,2,0,441,30.3,78,3,6.5,773,True,12,155,614,4,0,2024-05-12,False,False,False,0.7943078913324709,0.20051746442432083,0.00517464424320828,0.0,Peak,Sunday,May
2024-05-12 13:00:00,8,152,1,0,161,88,132,3,0,223,30.8,75,51,9.1,384,True,13,96,284,4,0,2024-05-12,False,False,False,0.7395833333333334,0.25,0.010416666666666666,0.0,Peak,Sunday,May
2024-05-12 14:00:00,16,127,0,0,143,35,413,3,1,452,30.9,77,51,9.0,595,True,14,51,540,3,1,2024-05-12,False,False,False,0.907563025210084,0.08571428571428572,0.005042016806722689,0.0016806722689075631,Peak,Sunday,May
2024-05-12 15:00:00,117,170,2,0,289,19,285,2,1,307,31.0,76,51,8.9,596,True,15,136,455,4,1,2024-05-12,False,False,False,0.7634228187919463,0.22818791946308725,0.006711409395973154,0.0016778523489932886,Peak,Sunday,May
2024-05-12 16:00:00,69,854,8,1,932,38,590,5,1,634,29.7,82,55,2.9,1566,True,16,107,1444,13,2,2024-05-12,False,False,True,0.9220945083014048,0.06832694763729247,0.008301404853128991,0.001277139208173691,Peak,Sunday,May
2024-05-12 17:00:00,92,658,4,1,755,63,500,5,1,569,29.6,81,51,4.6,1324,True,17,155,1158,9,2,2024-05-12,False,False,False,0.8746223564954683,0.11706948640483383,0.006797583081570997,0.0015105740181268882,Peak,Sunday,May
2024-05-12 18:00:00,154,472,6,0,632,77,355,0,0,432,29.2,81,3,5.0,1064,True,18,231,827,6,0,2024-05-12,False,False,False,0.7772556390977443,0.21710526315789475,0.005639097744360902,0.0,Peak,Sunday,May
2024-05-12 19:00:00,93,153,2,0,248,62,223,1,1,287,28.2,87,51,3.4,535,True,19,155,376,3,1,2024-05-12,False,False,False,0.702803738317757,0.2897196261682243,0.005607476635514018,0.001869158878504673,Peak,Sunday,May
2024-05-12 20:00:00,114,147,2,1,264,32,123,3,1,159,27.3,92,3,6.4,423,True,20,146,270,5,2,2024-05-12,False,False,False,0.6382978723404256,0.34515366430260047,0.01182033096926714,0.004728132387706856,Shoulder,Sunday,May
2024-05-12 21:00:00,11,331,1,0,343,38,350,1,0,389,27.1,92,61,10.0,732,True,21,49,681,2,0,2024-05-12,False,False,False,0.930327868852459,0.06693989071038252,0.00273224043715847,0.0,Shoulder,Sunday,May
2024-05-12 22:00:00,68,198,3,0,269,61,175,0,1,237,26.3,92,3,8.7,506,True,22,129,373,3,1,2024-05-12,False,False,False,0.7371541501976284,0.2549407114624506,0.005928853754940711,0.001976284584980237,Shoulder,Sunday,May
2024-05-12 23:00:00,69,102,5,0,176,19,213,3,1,236,26.2,93,3,9.4,412,True,23,88,315,8,1,2024-05-12,False,False,False,0.7645631067961165,0.21359223300970873,0.019417475728155338,0.0024271844660194173,Shoulder,Sunday,May
2024-05-13 00:00:00,22,187,2,0,211,26,104,5,0,135,25.9,95,3,6.6,346,False,0,48,291,7,0,2024-05-13,False,False,False,0.8410404624277457,0.13872832369942195,0.02023121387283237,0.0,Off-Peak,Monday,May
2024-05-13 01:00:00,97,524,9,1,631,39,146,0,1,186,25.8,95,3,7.6,817,False,1,136,670,9,2,2024-05-13,False,False,False,0.8200734394124847,0.1664626682986536,0.011015911872705019,0.0024479804161566705,Off-Peak,Monday,May
2024-05-13 02:00:00,111,357,3,1,472,14,665,4,1,684,25.6,96,3,7.0,1156,False,2,125,1022,7,2,2024-05-13,False,False,False,0.884083044982699,0.10813148788927336,0.006055363321799308,0.0017301038062283738,Off-Peak,Monday,May
2024-05-13 03:00:00,109,269,5,0,383,46,284,6,1,337,25.3,97,3,5.5,720,False,3,155,553,11,1,2024-05-13,False,False,False,0.7680555555555556,0.2152777777777778,0.015277777777777777,0.001388888888888889,Off-Peak,Monday,May
2024-05-13 04:00:00,39,409,9,0,457,48,110,8,1,167,25.1,97,3,6.8,624,False,4,87,519,17,1,2024-05-13,False,False,False,0.8317307692307693,0.13942307692307693,0.027243589743589744,0.0016025641025641025,Off-Peak,Monday,May
2024-05-13 05:00:00,33,341,7,1,382,35,420,6,1,462,24.9,98,1,6.3,844,False,5,68,761,13,2,2024-05-13,False,False,False,0.9016587677725119,0.08056872037914692,0.015402843601895734,0.002369668246445498,Shoulder,Monday,May
2024-05-13 06:00:00,210,546,7,2,765,94,917,13,1,1025,24.9,97,1,6.9,1790,False,6,304,1463,20,3,2024-05-13,False,False,True,0.8173184357541899,0.16983240223463686,0.0111731843575419,0.0016759776536312849,Shoulder,Monday,May
2024-05-13 07:00:00,173,981,10,2,1166,32,1129,14,0,1175,24.9,96,1,6.2,2341,False,7,205,2110,24,2,2024-05-13,False,False,True,0.9013242204186245,0.08756941478000854,0.010252029047415635,0.0008543357539513029,Peak,Monday,May
2024-05-13 08:00:00,24,880,15,2,921,102,516,1,2,621,25.7,93,0,5.9,1542,False,8,126,1396,16,4,2024-05-13,False,False,True,0.9053177691309987,0.08171206225680934,0.010376134889753566,0.0025940337224383916,Peak,Monday,May
2024-05-13 09:00:00,42,333,6,1,382,58,216,5,0,279,28.2,89,3,7.6,661,False,9,100,549,11,1,2024-05-13,False,False,False,0.8305597579425114,0.15128593040847202,0.01664145234493192,0.0015128593040847202,Shoulder,Monday,May
2024-05-13 10:00:00,52,459,2,1,514,38,270,2,1,311,27.5,87,51,10.1,825,False,10,90,729,4,2,2024-05-13,False,False,False,0.8836363636363637,0.10909090909090909,0.0048484848484848485,0.0024242424242424242,Shoulder,Monday,May
2024-05-13 11:00:00,166,373,6,1,546,11,376,4,0,391,28.5,84,3,8.2,937,False,11,177,749,10,1,2024-05-13,False,False,False,0.7993596584845251,0.18890074706510138,0.010672358591248666,0.0010672358591248667,Peak,Monday,May
2024-05-13 12:00:00,66,355,6,0,427,10,693,1,1,705,30.3,77,3,3.7,1132,False,12,76,1048,7,1,2024-05-13,False,False,False,0.9257950530035336,0.06713780918727916,0.006183745583038869,0.0008833922261484099,Peak,Monday,May
2024-05-13 13:00:00,35,398,8,1,442,43,537,6,1,587,31.2,71,51,1.1,1029,False,13,78,935,14,2,2024-05-13,False,False,False,0.9086491739552964,0.07580174927113703,0.013605442176870748,0.001943634596695821,Peak,Monday,May
2024-05-13 14:00:00,126,402,4,1,533,33,271,3,1,308,31.7,70,3,6.0,841,False,14,159,673,7,2,2024-05-13,False,False,False,0.8002378121284186,0.18906064209274673,0.008323424494649227,0.0023781212841854932,Peak,Monday,May
2024-05-13 15:00:00,134,141,0,0,275,42,329,7,1,379,30.7,72,55,6.1,654,False,15,176,470,7,1,2024-05-13,False,False,False,0.7186544342507645,0.2691131498470948,0.010703363914373088,0.0015290519877675841,Peak,Monday,May
2024-05-13 16:00:00,27,982,0,0,1009,82,901,6,1,990,30.2,74,3,4.0,1999,False,16,109,1883,6,1,2024-05-13,False,False,True,0.9419709854927464,0.054527263631815905,0.0030015007503751876,0.0005002501250625312,Peak,Monday,May
2024-05-13 17:00:00,23,411,5,2,441,53,785,6,2,846,30.2,74,3,5.8,1287,False,17,76,1196,11,4,2024-05-13,False,False,False,0.9292929292929293,0.059052059052059055,0.008547008547008548,0.003108003108003108,Peak,Monday,May
2024-05-13 18:00:00,84,653,7,2,746,22,332,14,2,370,29.8,75,3,3.3,1116,False,18,106,985,21,4,2024-05-13,False,False,False,0.8826164874551972,0.09498207885304659,0.01881720430107527,0.0035842293906810036,Peak,Monday,May
2024-05-13 19:00:00,149,197,6,1,353,32,502,1,1,536,28.7,83,55,2.4,889,False,19,181,699,7,2,2024-05-13,False,False,False,0.7862767154105736,0.20359955005624297,0.007874015748031496,0.0022497187851518562,Peak,Monday,May
2024-05-13 20:00:00,108,419,3,0,530,25,177,3,1,206,26.5,94,65,8.7,736,False,20,133,596,6,1,2024-05-13,False,False,False,0.8097826086956522,0.18070652173913043,0.008152173913043478,0.001358695652173913,Shoulder,Monday,May
2024-05-13 21:00:00,141,415,5,1,562,59,163,1,1,224,27.5,94,51,2.5,786,False,21,200,578,6,2,2024-05-13,False,False,False,0.7353689567430025,0.2544529262086514,0.007633587786259542,0.002544529262086514,Shoulder,Monday,May
2024-05-13 22:00:00,65,174,5,1,245,27,329,3,0,359,26.4,95,3,5.9,604,False,22,92,503,8,1,2024-05-13,False,False,False,0.8327814569536424,0.152317880794702,0.013245033112582781,0.0016556291390728477,Shoulder,Monday,May
2024-05-13 23:00:00,107,224,5,0,336,5,258,0,1,264,26.0,95,53,8.4,600,False,23,112,482,5,1,2024-05-13,False,False,False,0.8033333333333333,0.18666666666666668,0.008333333333333333,0.0016666666666666668,Shoulder,Monday,May
2024-05-14 00:00:00,25,227,2,0,254,22,130,4,1,157,26.0,95,61,3.8,411,False,0,47,357,6,1,2024-05-14,False,False,False,0.8686131386861314,0.11435523114355231,0.014598540145985401,0.0024330900243309003,Off-Peak,Tuesday,May
2024-05-14 01:00:00,47,201,3,1,252,29,329,7,0,365,24.9,96,63,11.1,617,False,1,76,530,10,1,2024-05-14,False,False,False,0.8589951377633711,0.12317666126418152,0.01620745542949757,0.0016207455429497568,Off-Peak,Tuesday,May
2024-05-14 02:00:00,89,301,1,0,391,51,505,6,1,563,24.5,98,51,7.0,954,False,2,140,806,7,1,2024-05-14,False,False,False,0.8448637316561844,0.14675052410901468,0.007337526205450734,0.0010482180293501049,Off-Peak,Tuesday,May
2024-05-14 03:00:00,33,225,5,0,263,70,394,4,1,469,24.5,99,51,3.5,732,False,3,103,619,9,1,2024-05-14,False,False,False,0.8456284153005464,0.1407103825136612,0.012295081967213115,0.001366120218579235,Off-Peak,Tuesday,May
2024-05-14 04:00:00,84,451,5,1,541,55,362,1,0,418,24.5,98,51,4.5,959,False,4,139,813,6,1,2024-05-14,False,False,False,0.8477580813347236,0.14494264859228362,0.006256517205422315,0.0010427528675703858,Off-Peak,Tuesday,May
2024-05-14 05:00:00,50,227,3,1,281,65,324,6,1,396,24.4,99,3,4.3,677,False,5,115,551,9,2,2024-05-14,False,False,False,0.8138847858197932,0.16986706056129985,0.013293943870014771,0.0029542097488921715,Shoulder,Tuesday,May
2024-05-14 06:00:00,104,398,14,1,517,26,891,6,2,925,24.3,98,3,2.9,1442,False,6,130,1289,20,3,2024-05-14,False,False,True,0.8938973647711512,0.09015256588072122,0.013869625520110958,0.0020804438280166435,Shoulder,Tuesday,May
2024-05-14 07:00:00,137,438,9,2,586,28,219,5,1,253,24.6,96,3,3.8,839,False,7,165,657,14,3,2024-05-14,False,False,False,0.7830750893921334,0.1966626936829559,0.0166865315852205,0.003575685339690107,Peak,Tuesday,May
2024-05-14 08:00:00,119,918,13,2,1052,45,965,12,1,1023,25.9,92,51,6.8,2075,False,8,164,1883,25,3,2024-05-14,False,False,True,0.9074698795180723,0.07903614457831325,0.012048192771084338,0.0014457831325301205,Peak,Tuesday,May
2024-05-14 09:00:00,71,340,6,0,417,38,467,6,1,512,26.0,96,51,13.8,929,False,9,109,807,12,1,2024-05-14,False,False,False,0.868675995694295,0.11733046286329386,0.012917115177610334,0.001076426264800861,Shoulder,Tuesday,May
2024-05-14 10:00:00,113,244,4,1,362,51,147,1,1,200,26.6,93,51,5.4,562,False,10,164,391,5,2,2024-05-14,False,False,False,0.6957295373665481,0.2918149466192171,0.008896797153024912,0.0035587188612099642,Shoulder,Tuesday,May
2024-05-14 11:00:00,102,397,7,1,507,42,266,7,1,316,28.9,85,3,9.1,823,False,11,144,663,14,2,2024-05-14,False,False,False,0.8055893074119077,0.17496962332928312,0.01701093560145808,0.002430133657351154,Peak,Tuesday,May
2024-05-14 12:00:00,81,218,5,1,305,61,260,1,1,323,29.4,79,51,13.1,628,False,12,142,478,6,2,2024-05-14,False,False,False,0.7611464968152867,0.22611464968152867,0.009554140127388535,0.0031847133757961785,Peak,Tuesday,May
2024-05-14 13:00:00,72,506,2,2,582,39,402,2,0,443,30.4,76,51,10.1,1025,False,13,111,908,4,2,2024-05-14,False,False,False,0.8858536585365854,0.10829268292682927,0.003902439024390244,0.001951219512195122,Peak,Tuesday,May
2024-05-14 14:00:00,99,394,7,0,500,33,490,6,1,530,29.9,78,53,8.7,1030,False,14,132,884,13,1,2024-05-14,False,False,False,0.858252427184466,0.12815533980582525,0.01262135922330097,0.000970873786407767,Peak,Tuesday,May
2024-05-14 15:00:00,103,318,7,0,428,20,164,6,1,191,30.5,74,51,4.0,619,False,15,123,482,13,1,2024-05-14,False,False,False,0.778675282714055,0.1987075928917609,0.0210016155088853,0.0016155088852988692,Peak,Tuesday,May
2024-05-14 16:00:00,181,152,12,1,346,72,503,8,2,585,29.5,76,51,7.2,931,False,16,253,655,20,3,2024-05-14,False,False,False,0.7035445757250268,0.27175080558539205,0.021482277121374866,0.00322234156820623,Peak,Tuesday,May
2024-05-14 17:00:00,113,935,4,0,1052,87,202,2,2,293,29.1,77,51,6.9,1345,False,17,200,1137,6,2,2024-05-14,False,False,False,0.8453531598513011,0.14869888475836432,0.0044609665427509295,0.001486988847583643,Peak,Tuesday,May
2024-05-14 18:00:00,84,781,10,1,876,80,368,11,0,459,28.9,80,3,5.3,1335,False,18,164,1149,21,1,2024-05-14,False,False,False,0.8606741573033708,0.12284644194756554,0.015730337078651686,0.000749063670411985,Peak,Tuesday,May
2024-05-14 19:00:00,111,312,1,1,425,66,575,3,1,645,28.3,85,3,3.1,1070,False,19,177,887,4,2,2024-05-14,False,False,False,0.8289719626168224,0.16542056074766356,0.003738317757009346,0.001869158878504673,Peak,Tuesday,May
2024-05-14 20:00:00,48,579,2,1,630,27,400,5,1,433,27.4,90,3,3.0,1063,False,20,75,979,7,2,2024-05-14,False,False,False,0.9209783631232361,0.07055503292568203,0.00658513640639699,0.0018814675446848542,Shoulder,Tuesday,May
2024-05-14 21:00:00,96,237,6,1,340,14,333,7,0,354,26.0,95,65,8.1,694,False,21,110,570,13,1,2024-05-14,False,False,False,0.8213256484149856,0.1585014409221902,0.018731988472622477,0.001440922190201729,Shoulder,Tuesday,May
2024-05-14 22:00:00,31,444,2,1,478,40,556,7,1,604,25.8,96,53,11.0,1082,False,22,71,1000,9,2,2024-05-14,False,False,False,0.9242144177449169,0.06561922365988909,0.00831792975970425,0.0018484288354898336,Shoulder,Tuesday,May
2024-05-14 23:00:00,37,211,8,1,257,5,202,4,1,212,25.6,96,51,11.5,469,False,23,42,413,12,2,2024-05-14,False,False,False,0.8805970149253731,0.08955223880597014,0.0255863539445629,0.0042643923240938165,Shoulder,Tuesday,May
2024-05-15 00:00:00,10,199,7,0,216,16,32,2,0,50,25.7,96,3,8.3,266,False,0,26,231,9,0,2024-05-15,False,False,False,0.868421052631579,0.09774436090225563,0.03383458646616541,0.0,Off-Peak,Wednesday,May
2024-05-15 01:00:00,55,170,5,1,231,15,160,4,0,179,25.2,97,55,9.7,410,False,1,70,330,9,1,2024-05-15,False,False,False,0.8048780487804879,0.17073170731707318,0.02195121951219512,0.0024390243902439024,Off-Peak,Wednesday,May
2024-05-15 02:00:00,29,109,1,0,139,30,358,2,1,391,24.8,99,51,8.8,530,False,2,59,467,3,1,2024-05-15,False,False,False,0.8811320754716981,0.11132075471698114,0.005660377358490566,0.0018867924528301887,Off-Peak,Wednesday,May
2024-05-15 03:00:00,65,345,2,1,413,18,366,3,0,387,24.9,98,3,2.1,800,False,3,83,711,5,1,2024-05-15,False,False,False,0.88875,0.10375,0.00625,0.00125,Off-Peak,Wednesday,May
2024-05-15 04:00:00,29,382,10,1,422,82,228,4,1,315,24.9,97,3,4.2,737,False,4,111,610,14,2,2024-05-15,False,False,False,0.8276797829036635,0.15061058344640435,0.018995929443690638,0.0027137042062415195,Off-Peak,Wednesday,May
2024-05-15 05:00:00,91,591,5,0,687,43,386,6,0,435,24.4,98,3,2.5,1122,False,5,134,977,11,0,2024-05-15,False,False,False,0.8707664884135472,0.11942959001782531,0.00980392156862745,0.0,Shoulder,Wednesday,May
2024-05-15 06:00:00,192,176,13,1,382,81,643,2,1,727,24.6,97,3,6.4,1109,False,6,273,819,15,2,2024-05-15,False,False,False,0.7385031559963932,0.24616771866546439,0.013525698827772768,0.0018034265103697023,Shoulder,Wednesday,May
2024-05-15 07:00:00,50,346,14,0,410,72,532,4,1,609,24.5,97,3,6.1,1019,False,7,122,878,18,1,2024-05-15,False,False,False,0.8616290480863592,0.1197252208047105,0.017664376840039256,0.0009813542688910696,Peak,Wednesday,May
2024-05-15 08:00:00,195,908,12,0,1115,69,304,2,1,376,25.4,96,3,6.4,1491,False,8,264,1212,14,1,2024-05-15,False,False,True,0.8128772635814889,0.17706237424547283,0.009389671361502348,0.0006706908115358819,Peak,Wednesday,May
2024-05-15 09:00:00,122,538,9,0,669,30,635,14,0,679,28.0,90,3,5.2,1348,False,9,152,1173,23,0,2024-05-15,False,False,False,0.8701780415430267,0.11275964391691394,0.017062314540059347,0.0,Shoulder,Wednesday,May
2024-05-15 10:00:00,33,183,0,1,217,53,501,2,0,556,29.4,83,3,5.6,773,False,10,86,684,2,1,2024-05-15,False,False,False,0.8848641655886158,0.111254851228978,0.00258732212160414,0.00129366106080207,Shoulder,Wednesday,May
2024-05-15 11:00:00,50,568,3,0,621,28,601,5,0,634,29.9,81,3,8.0,1255,False,11,78,1169,8,0,2024-05-15,False,False,False,0.9314741035856574,0.062151394422310755,0.006374501992031873,0.0,Peak,Wednesday,May
2024-05-15 12:00:00,78,428,5,0,511,30,340,10,1,381,30.4,77,51,8.6,892,False,12,108,768,15,1,2024-05-15,False,False,False,0.8609865470852018,0.1210762331838565,0.016816143497757848,0.0011210762331838565,Peak,Wednesday,May
2024-05-15 13:00:00,64,569,5,1,639,60,425,5,0,490,30.0,78,55,11.4,1129,False,13,124,994,10,1,2024-05-15,False,False,False,0.8804251550044287,0.10983170947741364,0.008857395925597875,0.0008857395925597874,Peak,Wednesday,May
2024-05-15 14:00:00,112,270,2,0,384,54,788,5,0,847,30.2,79,55,6.6,1231,False,14,166,1058,7,0,2024-05-15,False,False,False,0.859463850528026,0.1348497156783103,0.005686433793663688,0.0,Peak,Wednesday,May
2024-05-15 15:00:00,46,663,0,1,710,26,371,4,1,402,30.7,77,51,7.5,1112,False,15,72,1034,4,2,2024-05-15,False,False,False,0.9298561151079137,0.06474820143884892,0.0035971223021582736,0.0017985611510791368,Peak,Wednesday,May
2024-05-15 16:00:00,210,843,0,2,1055,56,621,9,0,686,29.2,81,55,5.2,1741,False,16,266,1464,9,2,2024-05-15,False,False,True,0.8408960367604825,0.15278575531303848,0.005169442848937392,0.0011487650775416428,Peak,Wednesday,May
2024-05-15 17:00:00,130,645,1,1,777,58,610,7,0,675,29.3,78,53,4.9,1452,False,17,188,1255,8,1,2024-05-15,False,False,True,0.8643250688705234,0.12947658402203857,0.005509641873278237,0.0006887052341597796,Peak,Wednesday,May
2024-05-15 18:00:00,59,481,13,0,553,58,506,3,1,568,28.8,83,51,6.0,1121,False,18,117,987,16,1,2024-05-15,False,False,False,0.8804638715432649,0.10437109723461195,0.014272970561998216,0.0008920606601248885,Peak,Wednesday,May
2024-05-15 19:00:00,27,135,3,0,165,65,497,2,0,564,27.7,89,3,8.4,729,False,19,92,632,5,0,2024-05-15,False,False,False,0.8669410150891632,0.1262002743484225,0.006858710562414266,0.0,Peak,Wednesday,May
2024-05-15 20:00:00,50,386,10,1,447,25,402,3,0,430,27.0,89,3,7.7,877,False,20,75,788,13,1,2024-05-15,False,False,False,0.8985176738882554,0.08551881413911061,0.014823261117445839,0.0011402508551881414,Shoulder,Wednesday,May
2024-05-15 21:00:00,118,408,1,1,528,18,259,6,0,283,27.0,88,3,6.1,811,False,21,136,667,7,1,2024-05-15,False,False,False,0.8224414303329223,0.16769420468557336,0.008631319358816275,0.0012330456226880395,Shoulder,Wednesday,May
2024-05-15 22:00:00,123,193,0,1,317,35,167,5,1,208,26.7,90,3,6.7,525,False,22,158,360,5,2,2024-05-15,False,False,False,0.6857142857142857,0.30095238095238097,0.009523809523809525,0.0038095238095238095,Shoulder,Wednesday,May
2024-05-15 23:00:00,18,393,9,1,421,12,197,6,0,215,26.5,91,3,7.9,636,False,23,30,590,15,1,2024-05-15,False,False,False,0.9276729559748428,0.04716981132075472,0.02358490566037736,0.0015723270440251573,Shoulder,Wednesday,May
2024-05-16 00:00:00,70,100,3,1,174,13,126,6,1,146,26.4,91,3,5.9,320,False,0,83,226,9,2,2024-05-16,False,False,False,0.70625,0.259375,0.028125,0.00625,Off-Peak,Thursday,May
2024-05-16 01:00:00,50,124,4,0,178,7,265,4,1,277,25.9,95,3,4.3,455,False,1,57,389,8,1,2024-05-16,False,False,False,0.8549450549450549,0.12527472527472527,0.017582417582417582,0.002197802197802198,Off-Peak,Thursday,May
2024-05-16 02:00:00,32,205,1,2,240,38,216,3,1,258,26.0,93,3,3.3,498,False,2,70,421,4,3,2024-05-16,False,False,False,0.8453815261044176,0.14056224899598393,0.008032128514056224,0.006024096385542169,Off-Peak,Thursday,May
2024-05-16 03:00:00,56,125,3,1,185,13,209,5,1,228,25.6,96,3,3.1,413,False,3,69,334,8,2,2024-05-16,False,False,False,0.8087167070217918,0.16707021791767554,0.01937046004842615,0.004842615012106538,Off-Peak,Thursday,May
2024-05-16 04:00:00,28,450,6,0,484,21,391,5,1,418,25.4,97,3,1.8,902,False,4,49,841,11,1,2024-05-16,False,False,False,0.9323725055432373,0.05432372505543237,0.012195121951219513,0.0011086474501108647,Off-Peak,Thursday,May
2024-05-16 05:00:00,95,245,6,1,347,63,360,5,0,428,24.9,98,61,2.1,775,False,5,158,605,11,1,2024-05-16,False,False,False,0.7806451612903226,0.20387096774193547,0.014193548387096775,0.0012903225806451613,Shoulder,Thursday,May
2024-05-16 06:00:00,41,844,4,2,891,70,584,9,1,664,25.0,96,51,4.6,1555,False,6,111,1428,13,3,2024-05-16,False,False,True,0.9183279742765273,0.07138263665594856,0.008360128617363344,0.0019292604501607716,Shoulder,Thursday,May
2024-05-16 07:00:00,46,613,3,2,664,21,443,6,2,472,25.1,97,51,4.5,1136,False,7,67,1056,9,4,2024-05-16,False,False,False,0.9295774647887324,0.05897887323943662,0.007922535211267605,0.0035211267605633804,Peak,Thursday,May
2024-05-16 08:00:00,59,215,10,1,285,72,768,8,1,849,26.1,95,51,7.9,1134,False,8,131,983,18,2,2024-05-16,False,False,False,0.8668430335097002,0.11552028218694885,0.015873015873015872,0.001763668430335097,Peak,Thursday,May
2024-05-16 09:00:00,103,164,2,2,271,58,412,6,0,476,27.4,90,3,5.5,747,False,9,161,576,8,2,2024-05-16,False,False,False,0.7710843373493976,0.21552878179384202,0.0107095046854083,0.002677376171352075,Shoulder,Thursday,May
2024-05-16 10:00:00,56,406,6,0,468,10,534,4,2,550,28.6,86,3,5.8,1018,False,10,66,940,10,2,2024-05-16,False,False,False,0.9233791748526523,0.06483300589390963,0.009823182711198428,0.0019646365422396855,Shoulder,Thursday,May
2024-05-16 11:00:00,126,508,8,2,644,63,607,3,1,674,28.8,81,61,12.3,1318,False,11,189,1115,11,3,2024-05-16,False,False,False,0.84597875569044,0.1433990895295903,0.00834597875569044,0.002276176024279211,Peak,Thursday,May
2024-05-16 12:00:00,138,675,5,1,819,83,794,3,0,880,27.5,86,63,6.5,1699,False,12,221,1469,8,1,2024-05-16,False,False,True,0.8646262507357269,0.13007651559741024,0.004708652148322542,0.0005885815185403178,Peak,Thursday,May
2024-05-16 13:00:00,77,539,5,1,622,44,352,4,0,400,28.5,84,3,0.7,1022,False,13,121,891,9,1,2024-05-16,False,False,False,0.8718199608610567,0.11839530332681017,0.008806262230919765,0.0009784735812133072,Peak,Thursday,May
2024-05-16 14:00:00,133,559,2,0,694,67,513,5,1,586,30.1,77,3,4.8,1280,False,14,200,1072,7,1,2024-05-16,False,False,False,0.8375,0.15625,0.00546875,0.00078125,Peak,Thursday,May
2024-05-16 15:00:00,74,432,4,0,510,12,361,6,1,380,30.4,76,3,6.2,890,False,15,86,793,10,1,2024-05-16,False,False,False,0.8910112359550562,0.09662921348314607,0.011235955056179775,0.0011235955056179776,Peak,Thursday,May
2024-05-16 16:00:00,200,583,6,1,790,75,389,7,1,472,30.2,71,51,8.1,1262,False,16,275,972,13,2,2024-05-16,False,False,False,0.7702060221870047,0.2179080824088748,0.010301109350237718,0.001584786053882726,Peak,Thursday,May
2024-05-16 17:00:00,87,1010,6,2,1105,63,386,4,1,454,28.9,80,53,6.9,1559,False,17,150,1396,10,3,2024-05-16,False,False,True,0.895445798588839,0.09621552277100706,0.006414368184733804,0.001924310455420141,Peak,Thursday,May
2024-05-16 18:00:00,184,380,10,1,575,88,201,8,1,298,28.3,82,51,11.7,873,False,18,272,581,18,2,2024-05-16,False,False,False,0.6655211912943871,0.3115693012600229,0.020618556701030927,0.002290950744558992,Peak,Thursday,May
2024-05-16 19:00:00,72,205,8,1,286,26,474,1,1,502,27.4,86,55,10.0,788,False,19,98,679,9,2,2024-05-16,False,False,False,0.8616751269035533,0.12436548223350254,0.011421319796954314,0.0025380710659898475,Peak,Thursday,May
2024-05-16 20:00:00,56,218,8,0,282,49,335,2,1,387,26.2,92,63,1.0,669,False,20,105,553,10,1,2024-05-16,False,False,False,0.8266068759342302,0.15695067264573992,0.014947683109118086,0.0014947683109118087,Shoulder,Thursday,May
2024-05-16 21:00:00,105,206,5,0,316,45,318,2,1,366,26.6,95,53,3.1,682,False,21,150,524,7,1,2024-05-16,False,False,False,0.7683284457478006,0.21994134897360704,0.010263929618768328,0.001466275659824047,Shoulder,Thursday,May
2024-05-16 22:00:00,60,569,3,1,633,12,465,3,0,480,26.6,95,51,4.3,1113,False,22,72,1034,6,1,2024-05-16,False,False,False,0.9290206648697215,0.0646900269541779,0.005390835579514825,0.0008984725965858042,Shoulder,Thursday,May
2024-05-16 23:00:00,10,416,6,1,433,20,288,5,1,314,26.6,96,51,1.4,747,False,23,30,704,11,2,2024-05-16,False,False,False,0.9424364123159303,0.040160642570281124,0.014725568942436412,0.002677376171352075,Shoulder,Thursday,May
2024-05-17 00:00:00,13,130,3,2,148,24,285,3,0,312,25.8,96,63,5.1,460,False,0,37,415,6,2,2024-05-17,False,True,False,0.9021739130434783,0.08043478260869565,0.013043478260869565,0.004347826086956522,Off-Peak,Friday,May
2024-05-17 01:00:00,26,200,2,1,229,45,313,8,1,367,25.8,97,51,4.6,596,False,1,71,513,10,2,2024-05-17,False,True,False,0.860738255033557,0.11912751677852348,0.016778523489932886,0.003355704697986577,Off-Peak,Friday,May
2024-05-17 02:00:00,98,144,4,0,246,40,363,6,0,409,25.6,97,53,5.8,655,False,2,138,507,10,0,2024-05-17,False,True,False,0.7740458015267175,0.21068702290076335,0.015267175572519083,0.0,Off-Peak,Friday,May
2024-05-17 03:00:00,109,696,1,1,807,53,201,7,0,261,25.2,98,51,5.4,1068,False,3,162,897,8,1,2024-05-17,False,True,False,0.8398876404494382,0.15168539325842698,0.00749063670411985,0.0009363295880149813,Off-Peak,Friday,May
2024-05-17 04:00:00,54,740,7,1,802,17,332,7,0,356,25.1,98,51,2.2,1158,False,4,71,1072,14,1,2024-05-17,False,True,False,0.92573402417962,0.0613126079447323,0.012089810017271158,0.0008635578583765112,Off-Peak,Friday,May
2024-05-17 05:00:00,79,676,8,0,763,24,268,6,1,299,24.8,99,3,2.4,1062,False,5,103,944,14,1,2024-05-17,False,True,False,0.8888888888888888,0.09698681732580038,0.013182674199623353,0.0009416195856873823,Shoulder,Friday,May
2024-05-17 06:00:00,131,119,4,2,256,16,894,10,0,920,24.8,97,3,5.5,1176,False,6,147,1013,14,2,2024-05-17,False,True,False,0.8613945578231292,0.125,0.011904761904761904,0.0017006802721088435,Shoulder,Friday,May
2024-05-17 07:00:00,143,309,13,2,467,29,1074,4,2,1109,24.5,98,3,3.3,1576,False,7,172,1383,17,4,2024-05-17,False,True,True,0.8775380710659898,0.10913705583756345,0.010786802030456852,0.0025380710659898475,Peak,Friday,May
2024-05-17 08:00:00,166,937,9,2,1114,69,138,17,0,224,25.3,97,51,1.1,1338,False,8,235,1075,26,2,2024-05-17,False,True,False,0.8034379671150972,0.1756352765321375,0.01943198804185351,0.0014947683109118087,Peak,Friday,May
2024-05-17 09:00:00,98,382,3,1,484,57,201,7,1,266,26.9,95,3,2.5,750,False,9,155,583,10,2,2024-05-17,False,True,False,0.7773333333333333,0.20666666666666667,0.013333333333333334,0.0026666666666666666,Shoulder,Friday,May
2024-05-17 10:00:00,56,315,6,0,377,54,396,4,0,454,28.4,87,51,6.2,831,False,10,110,711,10,0,2024-05-17,False,True,False,0.855595667870036,0.13237063778580024,0.012033694344163659,0.0,Shoulder,Friday,May
2024-05-17 11:00:00,50,687,7,1,745,31,660,2,1,694,29.5,82,51,10.2,1439,False,11,81,1347,9,2,2024-05-17,False,True,True,0.9360667129951356,0.056289089645587216,0.006254343293954135,0.001389854065323141,Peak,Friday,May
2024-05-17 12:00:00,106,345,9,0,460,21,828,6,0,855,30.4,77,51,9.6,1315,False,12,127,1173,15,0,2024-05-17,False,True,False,0.8920152091254753,0.09657794676806084,0.011406844106463879,0.0,Peak,Friday,May
2024-05-17 13:00:00,45,266,8,0,319,22,164,5,0,191,30.8,72,51,11.3,510,False,13,67,430,13,0,2024-05-17,False,True,False,0.8431372549019608,0.13137254901960785,0.025490196078431372,0.0,Peak,Friday,May
2024-05-17 14:00:00,23,604,10,1,638,18,567,7,1,593,31.1,69,3,11.5,1231,False,14,41,1171,17,2,2024-05-17,False,True,False,0.9512591389114541,0.03330625507717303,0.01380991064175467,0.0016246953696181965,Peak,Friday,May
2024-05-17 15:00:00,77,365,7,1,450,53,778,5,1,837,31.0,68,3,11.6,1287,False,15,130,1143,12,2,2024-05-17,False,True,False,0.8881118881118881,0.10101010101010101,0.009324009324009324,0.001554001554001554,Peak,Friday,May
2024-05-17 16:00:00,115,889,4,1,1009,84,573,5,1,663,31.1,67,3,10.5,1672,False,16,199,1462,9,2,2024-05-17,False,True,True,0.8744019138755981,0.11901913875598086,0.005382775119617225,0.0011961722488038277,Peak,Friday,May
2024-05-17 17:00:00,92,771,6,2,871,75,687,2,0,764,30.7,68,3,8.8,1635,False,17,167,1458,8,2,2024-05-17,False,True,True,0.8917431192660551,0.10214067278287461,0.004892966360856269,0.0012232415902140672,Peak,Friday,May
2024-05-17 18:00:00,54,853,17,2,926,94,642,10,1,747,30.1,70,3,7.5,1673,False,18,148,1495,27,3,2024-05-17,False,True,True,0.8936043036461446,0.08846383741781232,0.016138673042438732,0.0017931858936043037,Peak,Friday,May
2024-05-17 19:00:00,83,269,8,1,361,50,163,5,1,219,29.2,75,3,7.0,580,False,19,133,432,13,2,2024-05-17,False,True,False,0.7448275862068966,0.2293103448275862,0.022413793103448276,0.0034482758620689655,Peak,Friday,May
2024-05-17 20:00:00,103,162,7,1,273,53,282,4,0,339,28.9,77,3,7.2,612,False,20,156,444,11,1,2024-05-17,False,True,False,0.7254901960784313,0.2549019607843137,0.017973856209150325,0.0016339869281045752,Shoulder,Friday,May
2024-05-17 21:00:00,70,196,5,0,271,26,104,6,0,136,28.8,77,3,9.2,407,False,21,96,300,11,0,2024-05-17,False,True,False,0.7371007371007371,0.23587223587223588,0.02702702702702703,0.0,Shoulder,Friday,May
2024-05-17 22:00:00,72,365,7,1,445,30,318,4,1,353,28.3,80,3,8.0,798,False,22,102,683,11,2,2024-05-17,False,True,False,0.8558897243107769,0.12781954887218044,0.013784461152882205,0.002506265664160401,Shoulder,Friday,May
2024-05-17 23:00:00,47,254,9,0,310,7,443,4,0,454,27.9,81,3,9.5,764,False,23,54,697,13,0,2024-05-17,False,True,False,0.912303664921466,0.07068062827225131,0.017015706806282723,0.0,Shoulder,Friday,May
2024-05-18 00:00:00,115,256,6,0,377,12,110,2,0,124,27.6,82,3,9.3,501,True,0,127,366,8,0,2024-05-18,False,False,False,0.7305389221556886,0.25349301397205587,0.015968063872255488,0.0,Off-Peak,Saturday,May
2024-05-18 01:00:00,61,270,5,0,336,37,248,4,0,289,27.3,83,3,9.1,625,True,1,98,518,9,0,2024-05-18,False,False,False,0.8288,0.1568,0.0144,0.0,Off-Peak,Saturday,May
2024-05-18 02:00:00,69,681,5,1,756,42,337,3,0,382,26.9,86,3,6.6,1138,True,2,111,1018,8,1,2024-05-18,False,False,False,0.8945518453427065,0.09753954305799649,0.007029876977152899,0.0008787346221441124,Off-Peak,Saturday,May
2024-05-18 03:00:00,15,169,6,1,191,59,287,7,1,354,26.4,89,3,6.0,545,True,3,74,456,13,2,2024-05-18,False,False,False,0.8366972477064221,0.13577981651376148,0.023853211009174313,0.003669724770642202,Off-Peak,Saturday,May
2024-05-18 04:00:00,34,490,6,1,531,68,485,2,0,555,26.1,90,3,5.1,1086,True,4,102,975,8,1,2024-05-18,False,False,False,0.8977900552486188,0.09392265193370165,0.007366482504604052,0.0009208103130755065,Off-Peak,Saturday,May
2024-05-18 05:00:00,75,128,2,0,205,11,575,1,0,587,25.8,91,3,4.8,792,True,5,86,703,3,0,2024-05-18,False,False,False,0.8876262626262627,0.10858585858585859,0.003787878787878788,0.0,Shoulder,Saturday,May
2024-05-18 06:00:00,158,776,8,1,943,56,834,5,1,896,25.5,92,3,5.4,1839,True,6,214,1610,13,2,2024-05-18,False,False,True,0.8754758020663403,0.11636759108210984,0.0070690592713431215,0.001087547580206634,Shoulder,Saturday,May
2024-05-18 07:00:00,122,288,2,2,414,21,783,10,0,814,25.2,93,3,6.4,1228,True,7,143,1071,12,2,2024-05-18,False,False,False,0.8721498371335505,0.11644951140065146,0.009771986970684038,0.0016286644951140066,Peak,Saturday,May
2024-05-18 08:00:00,209,351,7,1,568,74,547,4,1,626,26.2,91,3,6.6,1194,True,8,283,898,11,2,2024-05-18,False,False,False,0.7520938023450586,0.2370184254606365,0.009212730318257957,0.0016750418760469012,Peak,Saturday,May
2024-05-18 09:00:00,105,596,4,1,706,66,547,8,1,622,29.1,85,3,6.6,1328,True,9,171,1143,12,2,2024-05-18,False,False,False,0.8606927710843374,0.12876506024096385,0.009036144578313253,0.0015060240963855422,Shoulder,Saturday,May
2024-05-18 10:00:00,112,333,2,1,448,20,351,3,0,374,29.9,80,51,8.9,822,True,10,132,684,5,1,2024-05-18,False,False,False,0.8321167883211679,0.16058394160583941,0.006082725060827251,0.0012165450121654502,Shoulder,Saturday,May
2024-05-18 11:00:00,83,503,5,1,592,48,522,5,1,576,30.5,78,51,7.9,1168,True,11,131,1025,10,2,2024-05-18,False,False,False,0.877568493150685,0.11215753424657535,0.008561643835616438,0.0017123287671232876,Peak,Saturday,May
2024-05-18 12:00:00,75,624,4,0,703,62,380,6,0,448,31.3,71,51,7.6,1151,True,12,137,1004,10,0,2024-05-18,False,False,False,0.8722849695916595,0.11902693310165074,0.008688097306689836,0.0,Peak,Saturday,May
2024-05-18 13:00:00,82,127,3,1,213,10,488,5,0,503,30.7,73,51,12.6,716,True,13,92,615,8,1,2024-05-18,False,False,False,0.8589385474860335,0.12849162011173185,0.0111731843575419,0.0013966480446927375,Peak,Saturday,May
2024-05-18 14:00:00,69,557,4,1,631,18,584,1,0,603,29.9,78,55,12.2,1234,True,14,87,1141,5,1,2024-05-18,False,False,False,0.9246353322528363,0.07050243111831442,0.004051863857374392,0.0008103727714748784,Peak,Saturday,May
2024-05-18 15:00:00,58,210,6,1,275,69,451,0,1,521,30.1,78,51,10.5,796,True,15,127,661,6,2,2024-05-18,False,False,False,0.8304020100502513,0.15954773869346733,0.007537688442211055,0.002512562814070352,Peak,Saturday,May
2024-05-18 16:00:00,63,679,4,2,748,38,505,11,1,555,30.0,77,51,11.5,1303,True,16,101,1184,15,3,2024-05-18,False,False,False,0.908672294704528,0.07751343054489639,0.011511895625479662,0.0023023791250959325,Peak,Saturday,May
2024-05-18 17:00:00,205,840,11,1,1057,93,492,4,0,589,29.9,73,51,12.1,1646,True,17,298,1332,15,1,2024-05-18,False,False,True,0.8092345078979344,0.181044957472661,0.009113001215066828,0.0006075334143377885,Peak,Saturday,May
2024-05-18 18:00:00,33,338,2,1,374,35,383,3,0,421,28.9,82,51,9.7,795,True,18,68,721,5,1,2024-05-18,False,False,False,0.9069182389937107,0.08553459119496855,0.006289308176100629,0.0012578616352201257,Peak,Saturday,May
2024-05-18 19:00:00,41,597,0,0,638,55,432,1,1,489,28.5,83,51,9.6,1127,True,19,96,1029,1,1,2024-05-18,False,False,False,0.9130434782608695,0.08518189884649512,0.0008873114463176575,0.0008873114463176575,Peak,Saturday,May
2024-05-18 20:00:00,51,468,0,1,520,6,134,1,0,141,28.1,84,3,11.3,661,True,20,57,602,1,1,2024-05-18,False,False,False,0.9107413010590015,0.08623298033282904,0.0015128593040847202,0.0015128593040847202,Shoulder,Saturday,May
2024-05-18 21:00:00,29,235,1,1,266,23,284,0,0,307,27.9,86,3,12.4,573,True,21,52,519,1,1,2024-05-18,False,False,False,0.9057591623036649,0.09075043630017451,0.0017452006980802793,0.0017452006980802793,Shoulder,Saturday,May
2024-05-18 22:00:00,56,343,6,0,405,16,182,2,0,200,27.6,89,3,9.3,605,True,22,72,525,8,0,2024-05-18,False,False,False,0.8677685950413223,0.11900826446280992,0.013223140495867768,0.0,Shoulder,Saturday,May
2024-05-18 23:00:00,80,352,3,0,435,22,270,3,0,295,27.4,90,3,9.7,730,True,23,102,622,6,0,2024-05-18,False,False,False,0.852054794520548,0.13972602739726028,0.00821917808219178,0.0,Shoulder,Saturday,May
2024-05-19 00:00:00,34,257,0,0,291,30,329,3,0,362,27.1,90,3,8.8,653,True,0,64,586,3,0,2024-05-19,False,False,False,0.8973966309341501,0.09800918836140889,0.004594180704441042,0.0,Off-Peak,Sunday,May
2024-05-19 01:00:00,55,347,1,0,403,13,237,1,1,252,26.8,91,3,6.5,655,True,1,68,584,2,1,2024-05-19,False,False,False,0.8916030534351145,0.10381679389312977,0.0030534351145038168,0.0015267175572519084,Off-Peak,Sunday,May
2024-05-19 02:00:00,25,453,3,1,482,73,429,0,0,502,26.6,92,3,6.8,984,True,2,98,882,3,1,2024-05-19,False,False,False,0.8963414634146342,0.09959349593495935,0.003048780487804878,0.0010162601626016261,Off-Peak,Sunday,May
2024-05-19 03:00:00,55,204,4,1,264,67,240,1,0,308,26.5,92,3,7.6,572,True,3,122,444,5,1,2024-05-19,False,False,False,0.7762237762237763,0.21328671328671328,0.008741258741258742,0.0017482517482517483,Off-Peak,Sunday,May
2024-05-19 04:00:00,66,522,3,0,591,47,337,0,1,385,26.5,92,3,7.1,976,True,4,113,859,3,1,2024-05-19,False,False,False,0.8801229508196722,0.11577868852459017,0.0030737704918032786,0.0010245901639344263,Off-Peak,Sunday,May
2024-05-19 05:00:00,74,154,0,1,229,69,255,3,0,327,26.5,93,3,5.1,556,True,5,143,409,3,1,2024-05-19,False,False,False,0.7356115107913669,0.25719424460431656,0.00539568345323741,0.0017985611510791368,Shoulder,Sunday,May
2024-05-19 06:00:00,105,622,7,1,735,5,543,2,1,551,26.2,93,3,6.2,1286,True,6,110,1165,9,2,2024-05-19,False,False,False,0.9059097978227061,0.08553654743390357,0.006998444790046656,0.0015552099533437014,Shoulder,Sunday,May
2024-05-19 07:00:00,154,891,5,1,1051,55,753,4,0,812,26.2,94,3,5.8,1863,True,7,209,1644,9,1,2024-05-19,False,False,True,0.8824476650563607,0.11218464841653247,0.004830917874396135,0.0005367686527106817,Peak,Sunday,May
2024-05-19 08:00:00,79,385,7,1,472,22,921,0,0,943,27.0,91,3,5.8,1415,True,8,101,1306,7,1,2024-05-19,False,False,True,0.9229681978798586,0.07137809187279152,0.0049469964664310955,0.0007067137809187279,Peak,Sunday,May
2024-05-19 09:00:00,92,210,3,0,305,28,402,4,1,435,27.5,93,3,1.3,740,True,9,120,612,7,1,2024-05-19,False,False,False,0.827027027027027,0.16216216216216217,0.00945945945945946,0.0013513513513513514,Shoulder,Sunday,May
2024-05-19 10:00:00,113,497,3,1,614,32,618,1,2,653,28.7,85,3,7.6,1267,True,10,145,1115,4,3,2024-05-19,False,False,False,0.8800315706393055,0.11444356748224152,0.0031570639305445935,0.0023677979479084454,Shoulder,Sunday,May
2024-05-19 11:00:00,55,592,3,1,651,35,228,3,0,266,30.2,75,51,13.1,917,True,11,90,820,6,1,2024-05-19,False,False,False,0.8942202835332607,0.09814612868047982,0.006543075245365322,0.0010905125408942203,Peak,Sunday,May
2024-05-19 12:00:00,82,260,1,0,343,32,191,3,0,226,30.5,74,51,8.9,569,True,12,114,451,4,0,2024-05-19,False,False,False,0.7926186291739895,0.20035149384885764,0.007029876977152899,0.0,Peak,Sunday,May
2024-05-19 13:00:00,17,587,0,1,605,13,127,4,0,144,31.1,72,51,12.0,749,True,13,30,714,4,1,2024-05-19,False,False,False,0.9532710280373832,0.04005340453938585,0.0053404539385847796,0.0013351134846461949,Peak,Sunday,May
2024-05-19 14:00:00,48,293,2,0,343,75,289,3,2,369,31.2,72,51,13.0,712,True,14,123,582,5,2,2024-05-19,False,False,False,0.8174157303370787,0.17275280898876405,0.007022471910112359,0.0028089887640449437,Peak,Sunday,May
2024-05-19 15:00:00,62,137,2,0,201,50,259,0,1,310,31.1,72,53,12.4,511,True,15,112,396,2,1,2024-05-19,False,False,False,0.7749510763209393,0.2191780821917808,0.003913894324853229,0.0019569471624266144,Peak,Sunday,May
2024-05-19 16:00:00,144,842,7,0,993,72,229,2,1,304,31.0,72,3,12.6,1297,True,16,216,1071,9,1,2024-05-19,False,False,False,0.825751734772552,0.16653816499614496,0.006939090208172706,0.0007710100231303007,Peak,Sunday,May
2024-05-19 17:00:00,189,144,3,1,337,105,168,8,2,283,30.8,71,51,12.5,620,True,17,294,312,11,3,2024-05-19,False,False,False,0.5032258064516129,0.47419354838709676,0.017741935483870968,0.004838709677419355,Peak,Sunday,May
2024-05-19 18:00:00,36,306,8,1,351,79,716,3,0,798,30.3,74,51,12.7,1149,True,18,115,1022,11,1,2024-05-19,False,False,False,0.8894691035683203,0.10008703220191471,0.009573542210617928,0.0008703220191470844,Peak,Sunday,May
2024-05-19 19:00:00,18,132,1,1,152,26,353,2,1,382,29.5,78,3,13.5,534,True,19,44,485,3,2,2024-05-19,False,False,False,0.9082397003745318,0.08239700374531835,0.0056179775280898875,0.003745318352059925,Peak,Sunday,May
2024-05-19 20:00:00,43,425,4,1,473,31,534,2,1,568,28.6,83,3,12.0,1041,True,20,74,959,6,2,2024-05-19,False,False,False,0.9212295869356388,0.07108549471661864,0.005763688760806916,0.0019212295869356388,Shoulder,Sunday,May
2024-05-19 21:00:00,35,517,1,0,553,59,409,4,0,472,29.1,81,3,14.8,1025,True,21,94,926,5,0,2024-05-19,False,False,False,0.9034146341463415,0.09170731707317073,0.004878048780487805,0.0,Shoulder,Sunday,May
2024-05-19 22:00:00,57,208,2,0,267,15,349,2,0,366,28.1,85,3,12.8,633,True,22,72,557,4,0,2024-05-19,False,False,False,0.8799368088467614,0.11374407582938388,0.00631911532385466,0.0,Shoulder,Sunday,May
2024-05-19 23:00:00,40,151,3,1,195,28,220,0,0,248,27.6,87,3,9.8,443,True,23,68,371,3,1,2024-05-19,False,False,False,0.837471783295711,0.15349887133182843,0.006772009029345372,0.002257336343115124,Shoulder,Sunday,May
2024-05-20 00:00:00,80,206,4,0,290,70,129,2,0,201,27.2,88,3,9.9,491,False,0,150,335,6,0,2024-05-20,False,False,False,0.6822810590631364,0.3054989816700611,0.012219959266802444,0.0,Off-Peak,Monday,May
2024-05-20 01:00:00,82,164,3,1,250,29,240,3,0,272,26.9,89,3,8.3,522,False,1,111,404,6,1,2024-05-20,False,False,False,0.7739463601532567,0.21264367816091953,0.011494252873563218,0.0019157088122605363,Off-Peak,Monday,May
2024-05-20 02:00:00,89,469,0,1,559,61,362,4,1,428,26.6,89,3,7.8,987,False,2,150,831,4,2,2024-05-20,False,False,False,0.8419452887537994,0.1519756838905775,0.004052684903748734,0.002026342451874367,Off-Peak,Monday,May
2024-05-20 03:00:00,43,280,0,1,322,53,424,2,0,479,26.3,90,3,5.8,801,False,3,96,704,2,1,2024-05-20,False,False,False,0.8789013732833958,0.1198501872659176,0.0024968789013732834,0.0012484394506866417,Off-Peak,Monday,May
2024-05-20 04:00:00,78,429,8,0,515,36,390,9,0,435,26.1,91,3,5.6,950,False,4,114,819,17,0,2024-05-20,False,False,False,0.8621052631578947,0.12,0.017894736842105262,0.0,Off-Peak,Monday,May
2024-05-20 05:00:00,131,416,4,0,551,46,198,6,1,251,26.3,92,3,9.5,802,False,5,177,614,10,1,2024-05-20,False,False,False,0.7655860349127181,0.22069825436408977,0.012468827930174564,0.0012468827930174563,Shoulder,Monday,May
2024-05-20 06:00:00,107,830,7,1,945,111,981,4,0,1096,26.1,93,55,5.9,2041,False,6,218,1811,11,1,2024-05-20,False,False,True,0.8873101420872122,0.10681038706516413,0.005389514943655071,0.0004899559039686428,Shoulder,Monday,May
2024-05-20 07:00:00,116,770,19,2,907,58,911,5,0,974,26.1,95,53,6.8,1881,False,7,174,1681,24,2,2024-05-20,False,False,True,0.8936735778841042,0.09250398724082935,0.012759170653907496,0.001063264221158958,Peak,Monday,May
2024-05-20 08:00:00,49,303,9,2,363,104,527,6,2,639,26.6,92,51,6.3,1002,False,8,153,830,15,4,2024-05-20,False,False,False,0.8283433133732535,0.15269461077844312,0.014970059880239521,0.003992015968063872,Peak,Monday,May
2024-05-20 09:00:00,66,245,12,0,323,45,423,7,1,476,26.0,91,51,2.1,799,False,9,111,668,19,1,2024-05-20,False,False,False,0.8360450563204005,0.13892365456821026,0.023779724655819776,0.0012515644555694619,Shoulder,Monday,May
2024-05-20 10:00:00,93,178,5,1,277,76,285,10,2,373,27.6,88,51,3.9,650,False,10,169,463,15,3,2024-05-20,False,False,False,0.7123076923076923,0.26,0.023076923076923078,0.004615384615384616,Shoulder,Monday,May
2024-05-20 11:00:00,71,335,8,0,414,23,654,2,0,679,29.1,83,51,10.4,1093,False,11,94,989,10,0,2024-05-20,False,False,False,0.9048490393412626,0.08600182982616651,0.009149130832570906,0.0,Peak,Monday,May
2024-05-20 12:00:00,110,122,5,1,238,25,296,9,2,332,29.4,80,51,10.9,570,False,12,135,418,14,3,2024-05-20,False,False,False,0.7333333333333333,0.23684210526315788,0.02456140350877193,0.005263157894736842,Peak,Monday,May
2024-05-20 13:00:00,78,350,5,1,434,63,312,10,0,385,29.8,79,51,12.4,819,False,13,141,662,15,1,2024-05-20,False,False,False,0.8083028083028083,0.17216117216117216,0.018315018315018316,0.001221001221001221,Peak,Monday,May
2024-05-20 14:00:00,103,376,10,1,490,48,655,5,1,709,29.4,81,51,9.7,1199,False,14,151,1031,15,2,2024-05-20,False,False,False,0.859883236030025,0.12593828190158465,0.012510425354462052,0.0016680567139282735,Peak,Monday,May
2024-05-20 15:00:00,66,159,7,1,233,71,394,11,1,477,30.3,76,51,8.9,710,False,15,137,553,18,2,2024-05-20,False,False,False,0.7788732394366197,0.19295774647887323,0.02535211267605634,0.0028169014084507044,Peak,Monday,May
2024-05-20 16:00:00,116,975,17,2,1110,37,558,8,1,604,30.2,75,51,11.1,1714,False,16,153,1533,25,3,2024-05-20,False,False,True,0.8943990665110851,0.08926487747957992,0.014585764294049008,0.001750291715285881,Peak,Monday,May
2024-05-20 17:00:00,79,1013,5,0,1097,45,925,4,0,974,29.9,76,3,11.3,2071,False,17,124,1938,9,0,2024-05-20,False,False,True,0.9357798165137615,0.05987445678416224,0.0043457267020762915,0.0,Peak,Monday,May
2024-05-20 18:00:00,166,874,6,1,1047,36,282,7,2,327,29.2,79,3,12.1,1374,False,18,202,1156,13,3,2024-05-20,False,False,True,0.8413391557496361,0.1470160116448326,0.009461426491994178,0.002183406113537118,Peak,Monday,May
2024-05-20 19:00:00,106,546,4,1,657,38,176,3,1,218,28.9,81,3,11.2,875,False,19,144,722,7,2,2024-05-20,False,False,False,0.8251428571428572,0.16457142857142856,0.008,0.002285714285714286,Peak,Monday,May
2024-05-20 20:00:00,92,249,8,1,350,41,266,6,1,314,28.8,81,3,11.3,664,False,20,133,515,14,2,2024-05-20,False,False,False,0.7756024096385542,0.2003012048192771,0.02108433734939759,0.0030120481927710845,Shoulder,Monday,May
2024-05-20 21:00:00,84,126,3,0,213,28,452,5,0,485,28.6,84,3,10.9,698,False,21,112,578,8,0,2024-05-20,False,False,False,0.828080229226361,0.16045845272206305,0.011461318051575931,0.0,Shoulder,Monday,May
2024-05-20 22:00:00,88,590,2,1,681,39,121,2,1,163,28.5,84,3,9.3,844,False,22,127,711,4,2,2024-05-20,False,False,False,0.8424170616113744,0.1504739336492891,0.004739336492890996,0.002369668246445498,Shoulder,Monday,May
2024-05-20 23:00:00,14,307,2,0,323,42,351,3,0,396,28.1,86,3,8.8,719,False,23,56,658,5,0,2024-05-20,False,False,False,0.9151599443671766,0.07788595271210014,0.006954102920723227,0.0,Shoulder,Monday,May
2024-05-21 00:00:00,60,114,1,1,176,33,180,2,0,215,28.1,86,3,10.0,391,False,0,93,294,3,1,2024-05-21,False,False,False,0.7519181585677749,0.23785166240409208,0.0076726342710997444,0.0025575447570332483,Off-Peak,Tuesday,May
2024-05-21 01:00:00,33,236,2,1,272,66,227,1,0,294,28.0,86,3,7.2,566,False,1,99,463,3,1,2024-05-21,False,False,False,0.8180212014134276,0.17491166077738515,0.00530035335689046,0.0017667844522968198,Off-Peak,Tuesday,May
2024-05-21 02:00:00,20,170,5,0,195,79,345,5,1,430,27.4,88,51,4.8,625,False,2,99,515,10,1,2024-05-21,False,False,False,0.824,0.1584,0.016,0.0016,Off-Peak,Tuesday,May
2024-05-21 03:00:00,51,280,1,0,332,17,270,4,1,292,27.2,90,3,4.7,624,False,3,68,550,5,1,2024-05-21,False,False,False,0.8814102564102564,0.10897435897435898,0.008012820512820512,0.0016025641025641025,Off-Peak,Tuesday,May
2024-05-21 04:00:00,88,202,4,0,294,30,183,6,0,219,26.5,95,3,4.1,513,False,4,118,385,10,0,2024-05-21,False,False,False,0.7504873294346979,0.2300194931773879,0.01949317738791423,0.0,Off-Peak,Tuesday,May
2024-05-21 05:00:00,131,556,3,1,691,6,538,6,0,550,26.1,97,51,4.9,1241,False,5,137,1094,9,1,2024-05-21,False,False,False,0.8815471394037067,0.11039484286865431,0.007252215954875101,0.0008058017727639,Shoulder,Tuesday,May
2024-05-21 06:00:00,91,484,9,0,584,66,680,3,0,749,25.8,96,61,5.6,1333,False,6,157,1164,12,0,2024-05-21,False,False,False,0.873218304576144,0.1177794448612153,0.00900225056264066,0.0,Shoulder,Tuesday,May
2024-05-21 07:00:00,126,960,13,0,1099,28,920,12,1,961,25.8,97,51,6.5,2060,False,7,154,1880,25,1,2024-05-21,False,False,True,0.912621359223301,0.07475728155339806,0.012135922330097087,0.0004854368932038835,Peak,Tuesday,May
2024-05-21 08:00:00,275,779,2,2,1058,89,492,2,1,584,26.4,95,51,5.6,1642,False,8,364,1271,4,3,2024-05-21,False,False,True,0.7740560292326432,0.22168087697929353,0.00243605359317905,0.0018270401948842874,Peak,Tuesday,May
2024-05-21 09:00:00,93,288,6,0,387,10,209,2,0,221,28.0,92,3,7.7,608,False,9,103,497,8,0,2024-05-21,False,False,False,0.8174342105263158,0.16940789473684212,0.013157894736842105,0.0,Shoulder,Tuesday,May
2024-05-21 10:00:00,140,247,6,1,394,90,220,0,0,310,29.4,79,51,14.7,704,False,10,230,467,6,1,2024-05-21,False,False,False,0.6633522727272727,0.32670454545454547,0.008522727272727272,0.0014204545454545455,Shoulder,Tuesday,May
2024-05-21 11:00:00,98,220,6,1,325,79,683,1,0,763,27.8,87,61,13.7,1088,False,11,177,903,7,1,2024-05-21,False,False,False,0.8299632352941176,0.16268382352941177,0.006433823529411764,0.0009191176470588235,Peak,Tuesday,May
2024-05-21 12:00:00,76,389,7,1,473,9,395,9,1,414,29.3,84,51,12.1,887,False,12,85,784,16,2,2024-05-21,False,False,False,0.8838782412626832,0.09582863585118377,0.018038331454340473,0.002254791431792559,Peak,Tuesday,May
2024-05-21 13:00:00,84,377,6,0,467,75,442,6,1,524,29.6,81,51,14.2,991,False,13,159,819,12,1,2024-05-21,False,False,False,0.8264379414732593,0.16044399596367306,0.012108980827447022,0.0010090817356205853,Peak,Tuesday,May
2024-05-21 14:00:00,76,313,0,0,389,5,301,8,1,315,30.4,76,3,12.4,704,False,14,81,614,8,1,2024-05-21,False,False,False,0.8721590909090909,0.11505681818181818,0.011363636363636364,0.0014204545454545455,Peak,Tuesday,May
2024-05-21 15:00:00,81,383,7,1,472,47,571,1,1,620,30.7,72,3,13.3,1092,False,15,128,954,8,2,2024-05-21,False,False,False,0.8736263736263736,0.11721611721611722,0.007326007326007326,0.0018315018315018315,Peak,Tuesday,May
2024-05-21 16:00:00,200,927,9,1,1137,71,432,7,0,510,30.8,71,3,11.6,1647,False,16,271,1359,16,1,2024-05-21,False,False,True,0.825136612021858,0.16454159077109898,0.009714632665452338,0.0006071645415907711,Peak,Tuesday,May
2024-05-21 17:00:00,197,889,1,0,1087,64,981,2,2,1049,30.5,72,3,9.2,2136,False,17,261,1870,3,2,2024-05-21,False,False,True,0.8754681647940075,0.12219101123595505,0.0014044943820224719,0.0009363295880149813,Peak,Tuesday,May
2024-05-21 18:00:00,187,766,14,1,968,40,411,6,1,458,29.9,75,3,7.4,1426,False,18,227,1177,20,2,2024-05-21,False,False,True,0.8253856942496494,0.15918653576437589,0.014025245441795231,0.001402524544179523,Peak,Tuesday,May
2024-05-21 19:00:00,62,396,3,1,462,39,489,9,1,538,29.3,80,3,8.0,1000,False,19,101,885,12,2,2024-05-21,False,False,False,0.885,0.101,0.012,0.002,Peak,Tuesday,May
2024-05-21 20:00:00,57,628,7,0,692,21,239,2,0,262,28.6,83,3,10.5,954,False,20,78,867,9,0,2024-05-21,False,False,False,0.9088050314465409,0.08176100628930817,0.009433962264150943,0.0,Shoulder,Tuesday,May
2024-05-21 21:00:00,88,366,1,1,456,75,153,1,0,229,27.3,94,61,1.0,685,False,21,163,519,2,1,2024-05-21,False,False,False,0.7576642335766424,0.23795620437956205,0.00291970802919708,0.00145985401459854,Shoulder,Tuesday,May
2024-05-21 22:00:00,44,312,3,0,359,91,446,8,1,546,26.4,95,61,2.6,905,False,22,135,758,11,1,2024-05-21,False,False,False,0.8375690607734807,0.14917127071823205,0.012154696132596685,0.0011049723756906078,Shoulder,Tuesday,May
2024-05-21 23:00:00,54,111,6,0,171,5,586,4,0,595,26.5,95,51,7.5,766,False,23,59,697,10,0,2024-05-21,False,False,False,0.9099216710182768,0.07702349869451697,0.013054830287206266,0.0,Shoulder,Tuesday,May
2024-05-22 00:00:00,92,188,1,0,281,10,126,5,1,142,25.9,96,61,2.9,423,False,0,102,314,6,1,2024-05-22,True,True,False,0.7423167848699763,0.24113475177304963,0.014184397163120567,0.002364066193853428,Off-Peak,Wednesday,May
2024-05-22 01:00:00,69,241,5,0,315,31,123,0,1,155,25.7,97,51,2.9,470,False,1,100,364,5,1,2024-05-22,True,True,False,0.774468085106383,0.2127659574468085,0.010638297872340425,0.002127659574468085,Off-Peak,Wednesday,May
2024-05-22 02:00:00,56,301,6,1,364,26,115,4,1,146,25.5,97,3,5.3,510,False,2,82,416,10,2,2024-05-22,True,True,False,0.8156862745098039,0.1607843137254902,0.0196078431372549,0.00392156862745098,Off-Peak,Wednesday,May
2024-05-22 03:00:00,70,282,5,0,357,10,208,8,0,226,25.2,98,3,4.7,583,False,3,80,490,13,0,2024-05-22,True,True,False,0.8404802744425386,0.137221269296741,0.022298456260720412,0.0,Off-Peak,Wednesday,May
2024-05-22 04:00:00,47,518,6,0,571,40,172,1,0,213,25.1,99,3,5.7,784,False,4,87,690,7,0,2024-05-22,True,True,False,0.8801020408163265,0.11096938775510204,0.008928571428571428,0.0,Off-Peak,Wednesday,May
2024-05-22 05:00:00,82,427,5,1,515,33,497,2,0,532,25.1,98,3,4.5,1047,False,5,115,924,7,1,2024-05-22,True,True,False,0.8825214899713467,0.10983763132760267,0.0066857688634192934,0.0009551098376313276,Shoulder,Wednesday,May
2024-05-22 06:00:00,126,664,3,2,795,17,202,0,1,220,25.2,96,63,9.2,1015,False,6,143,866,3,3,2024-05-22,True,True,False,0.8532019704433498,0.14088669950738916,0.002955665024630542,0.002955665024630542,Shoulder,Wednesday,May
2024-05-22 07:00:00,68,586,14,0,668,17,866,4,1,888,24.8,98,65,5.2,1556,False,7,85,1452,18,1,2024-05-22,True,True,True,0.9331619537275064,0.05462724935732648,0.011568123393316195,0.0006426735218508997,Peak,Wednesday,May
2024-05-22 08:00:00,140,374,12,1,527,129,455,7,0,591,25.3,97,53,3.3,1118,False,8,269,829,19,1,2024-05-22,True,True,False,0.7415026833631485,0.240608228980322,0.01699463327370304,0.0008944543828264759,Peak,Wednesday,May
2024-05-22 09:00:00,86,233,5,0,324,76,620,5,0,701,26.4,95,55,5.0,1025,False,9,162,853,10,0,2024-05-22,True,True,False,0.8321951219512195,0.15804878048780488,0.00975609756097561,0.0,Shoulder,Wednesday,May
2024-05-22 10:00:00,98,445,5,1,549,50,453,6,2,511,26.6,95,53,7.1,1060,False,10,148,898,11,3,2024-05-22,True,True,False,0.8471698113207548,0.13962264150943396,0.010377358490566037,0.002830188679245283,Shoulder,Wednesday,May
2024-05-22 11:00:00,100,377,8,0,485,48,330,3,0,381,27.5,91,53,3.8,866,False,11,148,707,11,0,2024-05-22,True,True,False,0.8163972286374134,0.17090069284064666,0.012702078521939953,0.0,Peak,Wednesday,May
2024-05-22 12:00:00,72,336,2,2,412,11,199,2,0,212,29.1,85,51,2.6,624,False,12,83,535,4,2,2024-05-22,True,True,False,0.8573717948717948,0.1330128205128205,0.00641025641025641,0.003205128205128205,Peak,Wednesday,May
2024-05-22 13:00:00,87,308,1,1,397,15,792,6,1,814,30.0,79,51,6.0,1211,False,13,102,1100,7,2,2024-05-22,True,True,False,0.9083402146985962,0.08422791081750619,0.005780346820809248,0.0016515276630883566,Peak,Wednesday,May
2024-05-22 14:00:00,97,188,8,0,293,35,174,3,1,213,30.1,77,51,5.2,506,False,14,132,362,11,1,2024-05-22,True,True,False,0.7154150197628458,0.2608695652173913,0.021739130434782608,0.001976284584980237,Peak,Wednesday,May
2024-05-22 15:00:00,46,119,8,2,175,66,745,8,0,819,30.7,76,51,4.9,994,False,15,112,864,16,2,2024-05-22,True,True,False,0.869215291750503,0.11267605633802817,0.01609657947686117,0.002012072434607646,Peak,Wednesday,May
2024-05-22 16:00:00,112,188,8,0,308,136,436,5,2,579,30.8,75,3,3.6,887,False,16,248,624,13,2,2024-05-22,True,True,False,0.7034949267192785,0.27959413754227735,0.014656144306651634,0.002254791431792559,Peak,Wednesday,May
2024-05-22 17:00:00,71,1001,2,1,1075,76,227,7,1,311,30.6,76,3,5.4,1386,False,17,147,1228,9,2,2024-05-22,True,True,True,0.886002886002886,0.10606060606060606,0.006493506493506494,0.001443001443001443,Peak,Wednesday,May
2024-05-22 18:00:00,107,774,11,0,892,43,514,10,0,567,29.7,80,3,6.5,1459,False,18,150,1288,21,0,2024-05-22,True,True,True,0.8827964359150103,0.10281014393420151,0.01439342015078821,0.0,Peak,Wednesday,May
2024-05-22 19:00:00,104,259,6,1,370,48,829,6,0,883,28.9,83,3,7.3,1253,False,19,152,1088,12,1,2024-05-22,True,True,False,0.8683160415003991,0.12130885873902633,0.009577015163607342,0.0007980845969672786,Peak,Wednesday,May
2024-05-22 20:00:00,59,251,1,0,311,60,533,6,0,599,28.3,86,3,4.9,910,False,20,119,784,7,0,2024-05-22,True,True,False,0.8615384615384616,0.13076923076923078,0.007692307692307693,0.0,Shoulder,Wednesday,May
2024-05-22 21:00:00,101,493,2,0,596,48,244,1,0,293,26.7,94,61,6.4,889,False,21,149,737,3,0,2024-05-22,True,True,False,0.829021372328459,0.16760404949381327,0.003374578177727784,0.0,Shoulder,Wednesday,May
2024-05-22 22:00:00,31,446,1,0,478,45,388,3,1,437,26.5,97,53,4.5,915,False,22,76,834,4,1,2024-05-22,True,True,False,0.9114754098360656,0.08306010928961749,0.004371584699453552,0.001092896174863388,Shoulder,Wednesday,May
2024-05-22 23:00:00,11,363,3,0,377,9,114,1,0,124,25.9,96,61,6.1,501,False,23,20,477,4,0,2024-05-22,True,True,False,0.9520958083832335,0.03992015968063872,0.007984031936127744,0.0,Shoulder,Wednesday,May
2024-05-23 00:00:00,28,201,5,0,234,10,177,8,0,195,25.9,95,53,4.0,429,False,0,38,378,13,0,2024-05-23,False,False,False,0.8811188811188811,0.08857808857808858,0.030303030303030304,0.0,Off-Peak,Thursday,May
2024-05-23 01:00:00,25,109,4,0,138,31,273,5,0,309,25.3,98,61,5.6,447,False,1,56,382,9,0,2024-05-23,False,False,False,0.854586129753915,0.12527964205816555,0.020134228187919462,0.0,Off-Peak,Thursday,May
2024-05-23 02:00:00,83,198,3,1,285,23,407,8,0,438,25.2,98,61,6.9,723,False,2,106,605,11,1,2024-05-23,False,False,False,0.8367911479944675,0.14661134163208853,0.015214384508990318,0.0013831258644536654,Off-Peak,Thursday,May
2024-05-23 03:00:00,47,108,8,0,163,24,431,0,0,455,25.2,96,51,3.1,618,False,3,71,539,8,0,2024-05-23,False,False,False,0.872168284789644,0.11488673139158576,0.012944983818770227,0.0,Off-Peak,Thursday,May
2024-05-23 04:00:00,46,498,1,2,547,27,404,6,1,438,25.3,95,3,0.4,985,False,4,73,902,7,3,2024-05-23,False,False,False,0.915736040609137,0.07411167512690356,0.007106598984771574,0.003045685279187817,Off-Peak,Thursday,May
2024-05-23 05:00:00,76,516,6,0,598,39,449,1,0,489,24.9,96,3,1.9,1087,False,5,115,965,7,0,2024-05-23,False,False,False,0.8877644894204232,0.10579576816927323,0.006439742410303588,0.0,Shoulder,Thursday,May
2024-05-23 06:00:00,132,719,18,1,870,48,602,2,0,652,25.0,96,51,6.1,1522,False,6,180,1321,20,1,2024-05-23,False,False,True,0.8679369250985546,0.11826544021024968,0.013140604467805518,0.000657030223390276,Shoulder,Thursday,May
2024-05-23 07:00:00,105,1057,13,0,1175,55,507,13,0,575,24.5,99,3,2.8,1750,False,7,160,1564,26,0,2024-05-23,False,False,True,0.8937142857142857,0.09142857142857143,0.014857142857142857,0.0,Peak,Thursday,May
2024-05-23 08:00:00,73,970,6,0,1049,53,793,5,0,851,25.5,92,3,0.8,1900,False,8,126,1763,11,0,2024-05-23,False,False,True,0.9278947368421052,0.06631578947368422,0.005789473684210527,0.0,Peak,Thursday,May
2024-05-23 09:00:00,107,609,2,0,718,62,509,6,0,577,26.5,97,51,6.6,1295,False,9,169,1118,8,0,2024-05-23,False,False,False,0.8633204633204633,0.1305019305019305,0.006177606177606178,0.0,Shoulder,Thursday,May
2024-05-23 10:00:00,52,372,7,0,431,63,333,1,1,398,27.8,93,3,5.3,829,False,10,115,705,8,1,2024-05-23,False,False,False,0.850422195416164,0.13872135102533173,0.009650180940892641,0.0012062726176115801,Shoulder,Thursday,May
2024-05-23 11:00:00,67,148,8,0,223,37,310,3,1,351,29.3,85,3,2.9,574,False,11,104,458,11,1,2024-05-23,False,False,False,0.7979094076655052,0.18118466898954705,0.01916376306620209,0.0017421602787456446,Peak,Thursday,May
2024-05-23 12:00:00,59,440,6,0,505,30,306,7,0,343,30.4,75,3,3.5,848,False,12,89,746,13,0,2024-05-23,False,False,False,0.8797169811320755,0.10495283018867925,0.015330188679245283,0.0,Peak,Thursday,May
2024-05-23 13:00:00,86,258,8,0,352,64,168,9,1,242,31.2,72,51,4.3,594,False,13,150,426,17,1,2024-05-23,False,False,False,0.7171717171717171,0.25252525252525254,0.02861952861952862,0.0016835016835016834,Peak,Thursday,May
2024-05-23 14:00:00,73,338,4,0,415,49,262,8,0,319,31.3,75,51,6.5,734,False,14,122,600,12,0,2024-05-23,False,False,False,0.8174386920980926,0.16621253405994552,0.01634877384196185,0.0,Peak,Thursday,May
2024-05-23 15:00:00,55,215,4,0,274,56,180,10,1,247,31.1,76,51,8.6,521,False,15,111,395,14,1,2024-05-23,False,False,False,0.7581573896353166,0.21305182341650672,0.026871401151631478,0.0019193857965451055,Peak,Thursday,May
2024-05-23 16:00:00,140,288,20,1,449,81,232,6,0,319,30.4,79,51,6.6,768,False,16,221,520,26,1,2024-05-23,False,False,False,0.6770833333333334,0.2877604166666667,0.033854166666666664,0.0013020833333333333,Peak,Thursday,May
2024-05-23 17:00:00,149,242,14,1,406,55,836,6,0,897,29.2,79,63,6.4,1303,False,17,204,1078,20,1,2024-05-23,False,False,False,0.827321565617805,0.15656178050652342,0.015349194167306216,0.0007674597083653108,Peak,Thursday,May
2024-05-23 18:00:00,152,268,5,0,425,15,976,15,0,1006,27.8,87,51,5.4,1431,False,18,167,1244,20,0,2024-05-23,False,False,True,0.8693221523410203,0.116701607267645,0.013976240391334731,0.0,Peak,Thursday,May
2024-05-23 19:00:00,88,625,6,0,719,53,490,5,0,548,27.4,92,53,3.7,1267,False,19,141,1115,11,0,2024-05-23,False,False,False,0.8800315706393055,0.11128650355169692,0.008681925808997633,0.0,Peak,Thursday,May
2024-05-23 20:00:00,65,250,4,0,319,35,295,2,0,332,27.0,94,61,7.0,651,False,20,100,545,6,0,2024-05-23,False,False,False,0.837173579109063,0.15360983102918588,0.009216589861751152,0.0,Shoulder,Thursday,May
2024-05-23 21:00:00,119,590,6,0,715,20,274,9,0,303,26.3,97,51,6.0,1018,False,21,139,864,15,0,2024-05-23,False,False,False,0.8487229862475442,0.13654223968565815,0.014734774066797643,0.0,Shoulder,Thursday,May
2024-05-23 22:00:00,92,221,4,0,317,59,176,6,0,241,25.6,97,61,6.2,558,False,22,151,397,10,0,2024-05-23,False,False,False,0.7114695340501792,0.27060931899641577,0.017921146953405017,0.0,Shoulder,Thursday,May
2024-05-23 23:00:00,85,322,4,0,411,46,172,5,1,224,25.1,99,63,11.8,635,False,23,131,494,9,1,2024-05-23,False,False,False,0.7779527559055118,0.2062992125984252,0.014173228346456693,0.0015748031496062992,Shoulder,Thursday,May
2024-05-24 00:00:00,27,34,3,0,64,46,58,0,1,105,25.0,98,65,10.9,169,False,0,73,92,3,1,2024-05-24,False,False,False,0.5443786982248521,0.4319526627218935,0.01775147928994083,0.005917159763313609,Off-Peak,Friday,May
2024-05-24 01:00:00,88,368,3,0,459,17,191,2,0,210,25.2,97,53,7.5,669,False,1,105,559,5,0,2024-05-24,False,False,False,0.8355754857997011,0.15695067264573992,0.007473841554559043,0.0,Off-Peak,Friday,May
2024-05-24 02:00:00,63,458,3,1,525,25,138,1,0,164,25.2,96,61,4.3,689,False,2,88,596,4,1,2024-05-24,False,False,False,0.865021770682148,0.12772133526850507,0.005805515239477504,0.001451378809869376,Off-Peak,Friday,May
2024-05-24 03:00:00,119,142,7,0,268,34,151,2,1,188,25.2,96,53,6.2,456,False,3,153,293,9,1,2024-05-24,False,False,False,0.6425438596491229,0.3355263157894737,0.019736842105263157,0.0021929824561403508,Off-Peak,Friday,May
2024-05-24 04:00:00,88,222,6,0,316,43,132,3,0,178,24.9,96,51,8.6,494,False,4,131,354,9,0,2024-05-24,False,False,False,0.7165991902834008,0.2651821862348178,0.018218623481781375,0.0,Off-Peak,Friday,May
2024-05-24 05:00:00,110,226,6,0,342,57,712,7,0,776,25.0,94,3,8.2,1118,False,5,167,938,13,0,2024-05-24,False,False,False,0.8389982110912343,0.14937388193202147,0.011627906976744186,0.0,Shoulder,Friday,May
2024-05-24 06:00:00,145,107,5,1,258,66,481,10,0,557,25.0,94,3,7.1,815,False,6,211,588,15,1,2024-05-24,False,False,False,0.7214723926380369,0.2588957055214724,0.018404907975460124,0.001226993865030675,Shoulder,Friday,May
2024-05-24 07:00:00,123,367,10,1,501,109,537,3,0,649,25.0,94,3,5.9,1150,False,7,232,904,13,1,2024-05-24,False,False,False,0.7860869565217391,0.20173913043478262,0.011304347826086957,0.0008695652173913044,Peak,Friday,May
2024-05-24 08:00:00,249,666,12,0,927,87,718,9,1,815,25.4,94,3,8.1,1742,False,8,336,1384,21,1,2024-05-24,False,False,True,0.7944890929965557,0.1928817451205511,0.012055109070034443,0.000574052812858783,Peak,Friday,May
2024-05-24 09:00:00,210,554,3,1,768,55,660,5,0,720,26.3,93,63,4.9,1488,False,9,265,1214,8,1,2024-05-24,False,False,True,0.8158602150537635,0.17809139784946237,0.005376344086021506,0.0006720430107526882,Shoulder,Friday,May
2024-05-24 10:00:00,147,686,5,1,839,66,153,11,1,231,25.8,93,63,3.9,1070,False,10,213,839,16,2,2024-05-24,False,False,False,0.7841121495327102,0.19906542056074766,0.014953271028037384,0.001869158878504673,Shoulder,Friday,May
2024-05-24 11:00:00,81,139,2,0,222,73,303,8,0,384,25.6,93,61,9.4,606,False,11,154,442,10,0,2024-05-24,False,False,False,0.7293729372937293,0.25412541254125415,0.0165016501650165,0.0,Peak,Friday,May
2024-05-24 12:00:00,99,276,8,0,383,38,750,12,0,800,25.7,93,55,5.8,1183,False,12,137,1026,20,0,2024-05-24,False,False,False,0.8672865595942519,0.1158072696534235,0.0169061707523246,0.0,Peak,Friday,May
2024-05-24 13:00:00,109,581,3,1,694,75,342,2,0,419,26.9,90,55,4.5,1113,False,13,184,923,5,1,2024-05-24,False,False,False,0.8292902066486972,0.16531895777178796,0.004492362982929021,0.0008984725965858042,Peak,Friday,May
2024-05-24 14:00:00,147,450,7,0,604,46,139,4,1,190,28.4,84,53,5.7,794,False,14,193,589,11,1,2024-05-24,False,False,False,0.7418136020151134,0.24307304785894207,0.013853904282115869,0.0012594458438287153,Peak,Friday,May
2024-05-24 15:00:00,163,317,1,0,481,58,215,14,0,287,28.6,82,51,6.5,768,False,15,221,532,15,0,2024-05-24,False,False,False,0.6927083333333334,0.2877604166666667,0.01953125,0.0,Peak,Friday,May
2024-05-24 16:00:00,222,1010,14,2,1248,111,296,8,2,417,29.5,78,3,5.0,1665,False,16,333,1306,22,4,2024-05-24,False,False,True,0.7843843843843844,0.2,0.013213213213213212,0.0024024024024024023,Peak,Friday,May
2024-05-24 17:00:00,309,520,6,0,835,21,1154,6,0,1181,29.3,78,3,5.8,2016,False,17,330,1674,12,0,2024-05-24,False,False,True,0.8303571428571429,0.1636904761904762,0.005952380952380952,0.0,Peak,Friday,May
2024-05-24 18:00:00,229,890,7,0,1126,51,1080,7,0,1138,29.0,81,3,4.1,2264,False,18,280,1970,14,0,2024-05-24,False,False,True,0.8701413427561837,0.12367491166077739,0.006183745583038869,0.0,Peak,Friday,May
2024-05-24 19:00:00,80,594,5,0,679,34,247,3,0,284,28.2,86,3,3.7,963,False,19,114,841,8,0,2024-05-24,False,False,False,0.8733125649013499,0.11838006230529595,0.008307372793354102,0.0,Peak,Friday,May
2024-05-24 20:00:00,121,651,8,0,780,45,578,5,0,628,27.5,89,3,6.6,1408,False,20,166,1229,13,0,2024-05-24,False,False,True,0.8728693181818182,0.11789772727272728,0.009232954545454546,0.0,Shoulder,Friday,May
2024-05-24 21:00:00,72,498,3,0,573,37,334,6,0,377,25.2,94,63,3.1,950,False,21,109,832,9,0,2024-05-24,False,False,False,0.8757894736842106,0.11473684210526315,0.009473684210526316,0.0,Shoulder,Friday,May
2024-05-24 22:00:00,57,137,7,0,201,17,608,3,0,628,25.8,92,51,7.2,829,False,22,74,745,10,0,2024-05-24,False,False,False,0.8986731001206273,0.08926417370325694,0.012062726176115802,0.0,Shoulder,Friday,May
2024-05-24 23:00:00,35,380,7,0,422,12,296,2,1,311,25.7,96,3,2.6,733,False,23,47,676,9,1,2024-05-24,False,False,False,0.922237380627558,0.06412005457025921,0.01227830832196453,0.001364256480218281,Shoulder,Friday,May
2024-05-25 00:00:00,14,147,3,0,164,42,180,1,0,223,25.9,93,3,4.2,387,True,0,56,327,4,0,2024-05-25,False,False,False,0.8449612403100775,0.14470284237726097,0.0103359173126615,0.0,Off-Peak,Saturday,May
2024-05-25 01:00:00,166,199,3,0,368,35,257,3,0,295,25.7,96,3,3.4,663,True,1,201,456,6,0,2024-05-25,False,False,False,0.6877828054298643,0.3031674208144796,0.00904977375565611,0.0,Off-Peak,Saturday,May
2024-05-25 02:00:00,155,348,3,1,507,51,167,2,0,220,25.9,96,3,4.4,727,True,2,206,515,5,1,2024-05-25,False,False,False,0.7083906464924347,0.2833562585969739,0.0068775790921595595,0.001375515818431912,Off-Peak,Saturday,May
2024-05-25 03:00:00,205,657,2,1,865,18,210,5,0,233,25.7,96,1,5.9,1098,True,3,223,867,7,1,2024-05-25,False,False,False,0.7896174863387978,0.20309653916211293,0.006375227686703097,0.0009107468123861566,Off-Peak,Saturday,May
2024-05-25 04:00:00,156,451,5,0,612,34,320,3,1,358,25.4,97,3,4.6,970,True,4,190,771,8,1,2024-05-25,False,False,False,0.7948453608247422,0.1958762886597938,0.008247422680412371,0.0010309278350515464,Off-Peak,Saturday,May
2024-05-25 05:00:00,217,502,4,1,724,24,127,4,0,155,25.5,96,3,5.7,879,True,5,241,629,8,1,2024-05-25,False,False,False,0.7155858930602957,0.27417519908987487,0.009101251422070534,0.0011376564277588168,Shoulder,Saturday,May
2024-05-25 06:00:00,139,980,4,0,1123,107,447,3,1,558,25.5,96,3,5.0,1681,True,6,246,1427,7,1,2024-05-25,False,False,True,0.8488994646044021,0.14634146341463414,0.004164187983343248,0.000594883997620464,Shoulder,Saturday,May
2024-05-25 07:00:00,150,266,8,0,424,42,355,7,1,405,25.3,96,3,5.0,829,True,7,192,621,15,1,2024-05-25,False,False,False,0.7490952955367913,0.2316043425814234,0.018094089264173704,0.0012062726176115801,Peak,Saturday,May
2024-05-25 08:00:00,392,397,9,0,798,17,723,2,0,742,26.0,95,3,6.7,1540,True,8,409,1120,11,0,2024-05-25,False,False,True,0.7272727272727273,0.2655844155844156,0.007142857142857143,0.0,Peak,Saturday,May
2024-05-25 09:00:00,262,283,1,2,548,22,477,3,0,502,28.2,90,3,5.0,1050,True,9,284,760,4,2,2024-05-25,False,False,False,0.7238095238095238,0.2704761904761905,0.0038095238095238095,0.0019047619047619048,Shoulder,Saturday,May
2024-05-25 10:00:00,143,190,3,0,336,67,700,4,1,772,29.6,82,3,7.9,1108,True,10,210,890,7,1,2024-05-25,False,False,False,0.8032490974729242,0.18953068592057762,0.00631768953068592,0.0009025270758122744,Shoulder,Saturday,May
2024-05-25 11:00:00,229,605,3,0,837,44,555,1,0,600,30.6,75,51,9.8,1437,True,11,273,1160,4,0,2024-05-25,False,False,True,0.8072372999304106,0.18997912317327767,0.0027835768963117608,0.0,Peak,Saturday,May
2024-05-25 12:00:00,152,504,3,0,659,51,380,4,0,435,31.3,73,51,9.7,1094,True,12,203,884,7,0,2024-05-25,False,False,False,0.8080438756855576,0.18555758683729434,0.006398537477148081,0.0,Peak,Saturday,May
2024-05-25 13:00:00,118,316,1,0,435,21,697,3,0,721,31.8,71,51,9.2,1156,True,13,139,1013,4,0,2024-05-25,False,False,False,0.8762975778546713,0.12024221453287197,0.0034602076124567475,0.0,Peak,Saturday,May
2024-05-25 14:00:00,143,248,5,0,396,33,379,1,0,413,31.3,73,51,10.8,809,True,14,176,627,6,0,2024-05-25,False,False,False,0.7750309023485785,0.21755253399258342,0.007416563658838072,0.0,Peak,Saturday,May
2024-05-25 15:00:00,174,345,0,0,519,21,393,5,0,419,28.8,80,65,10.8,938,True,15,195,738,5,0,2024-05-25,False,False,False,0.7867803837953091,0.20788912579957355,0.005330490405117271,0.0,Peak,Saturday,May
2024-05-25 16:00:00,378,375,8,0,761,30,514,8,1,553,26.8,91,61,8.0,1314,True,16,408,889,16,1,2024-05-25,False,False,False,0.6765601217656012,0.3105022831050228,0.0121765601217656,0.00076103500761035,Peak,Saturday,May
2024-05-25 17:00:00,160,753,9,0,922,77,599,2,0,678,27.1,91,53,8.6,1600,True,17,237,1352,11,0,2024-05-25,False,False,True,0.845,0.148125,0.006875,0.0,Peak,Saturday,May
2024-05-25 18:00:00,246,125,6,0,377,81,244,5,0,330,27.7,90,3,4.0,707,True,18,327,369,11,0,2024-05-25,False,False,False,0.521923620933522,0.4625176803394625,0.015558698727015558,0.0,Peak,Saturday,May
2024-05-25 19:00:00,161,521,5,0,687,53,234,4,1,292,27.6,91,3,8.3,979,True,19,214,755,9,1,2024-05-25,False,False,False,0.7711950970377937,0.21859039836567926,0.009193054136874362,0.0010214504596527069,Peak,Saturday,May
2024-05-25 20:00:00,169,205,1,0,375,30,252,2,0,284,27.2,92,3,7.4,659,True,20,199,457,3,0,2024-05-25,False,False,False,0.6934749620637329,0.30197268588770865,0.004552352048558422,0.0,Shoulder,Saturday,May
2024-05-25 21:00:00,121,265,1,0,387,61,334,3,0,398,26.9,97,51,2.0,785,True,21,182,599,4,0,2024-05-25,False,False,False,0.7630573248407644,0.2318471337579618,0.005095541401273885,0.0,Shoulder,Saturday,May
2024-05-25 22:00:00,108,164,1,1,274,63,271,5,0,339,26.4,97,53,8.4,613,True,22,171,435,6,1,2024-05-25,False,False,False,0.7096247960848288,0.27895595432300163,0.009787928221859706,0.0016313213703099511,Shoulder,Saturday,May
2024-05-25 23:00:00,100,134,5,0,239,30,165,2,0,197,25.8,96,53,9.7,436,True,23,130,299,7,0,2024-05-25,False,False,False,0.6857798165137615,0.2981651376146789,0.016055045871559634,0.0,Shoulder,Saturday,May
2024-05-26 00:00:00,25,145,1,0,171,23,264,3,0,290,25.0,97,51,10.5,461,True,0,48,409,4,0,2024-05-26,False,False,False,0.8872017353579176,0.10412147505422993,0.008676789587852495,0.0,Off-Peak,Sunday,May
2024-05-26 01:00:00,62,343,6,2,413,47,330,2,0,379,25.2,96,51,6.6,792,True,1,109,673,8,2,2024-05-26,False,False,False,0.8497474747474747,0.13762626262626262,0.010101010101010102,0.0025252525252525255,Off-Peak,Sunday,May
2024-05-26 02:00:00,26,147,9,0,182,43,318,2,0,363,25.2,96,51,7.6,545,True,2,69,465,11,0,2024-05-26,False,False,False,0.8532110091743119,0.12660550458715597,0.02018348623853211,0.0,Off-Peak,Sunday,May
2024-05-26 03:00:00,84,494,5,0,583,32,452,4,0,488,25.1,97,51,7.2,1071,True,3,116,946,9,0,2024-05-26,False,False,False,0.8832866479925303,0.10830999066293184,0.008403361344537815,0.0,Off-Peak,Sunday,May
2024-05-26 04:00:00,116,519,4,0,639,26,266,3,1,296,25.1,97,51,7.6,935,True,4,142,785,7,1,2024-05-26,False,False,False,0.839572192513369,0.1518716577540107,0.0074866310160427805,0.0010695187165775401,Off-Peak,Sunday,May
2024-05-26 05:00:00,124,476,4,1,605,42,348,9,0,399,25.0,97,51,7.2,1004,True,5,166,824,13,1,2024-05-26,False,False,False,0.8207171314741036,0.16533864541832669,0.012948207171314742,0.00099601593625498,Shoulder,Sunday,May
2024-05-26 06:00:00,47,588,16,0,651,95,927,18,2,1042,25.1,97,51,5.2,1693,True,6,142,1515,34,2,2024-05-26,False,False,True,0.8948611931482575,0.08387477849970466,0.02008269344359126,0.0011813349084465446,Shoulder,Sunday,May
2024-05-26 07:00:00,162,902,17,1,1082,86,410,10,0,506,24.9,98,3,6.0,1588,True,7,248,1312,27,1,2024-05-26,False,False,True,0.8261964735516373,0.1561712846347607,0.01700251889168766,0.0006297229219143577,Peak,Sunday,May
2024-05-26 08:00:00,227,364,7,1,599,55,342,7,1,405,25.3,97,3,7.7,1004,True,8,282,706,14,2,2024-05-26,False,False,False,0.703187250996016,0.28087649402390436,0.013944223107569721,0.00199203187250996,Peak,Sunday,May
2024-05-26 09:00:00,73,580,11,0,664,36,473,7,1,517,27.1,93,3,10.0,1181,True,9,109,1053,18,1,2024-05-26,False,False,False,0.8916172734970365,0.09229466553767993,0.015241320914479255,0.000846740050804403,Shoulder,Sunday,May
2024-05-26 10:00:00,31,572,5,0,608,56,671,12,0,739,27.4,93,51,8.3,1347,True,10,87,1243,17,0,2024-05-26,False,False,False,0.9227913882702301,0.0645879732739421,0.012620638455827766,0.0,Shoulder,Sunday,May
2024-05-26 11:00:00,45,244,11,1,301,23,351,9,0,383,28.6,88,51,5.6,684,True,11,68,595,20,1,2024-05-26,False,False,False,0.8698830409356725,0.09941520467836257,0.029239766081871343,0.0014619883040935672,Peak,Sunday,May
2024-05-26 12:00:00,107,272,7,0,386,52,318,8,0,378,29.1,84,3,8.2,764,True,12,159,590,15,0,2024-05-26,False,False,False,0.7722513089005235,0.2081151832460733,0.01963350785340314,0.0,Peak,Sunday,May
2024-05-26 13:00:00,101,420,8,0,529,25,313,13,0,351,30.4,78,3,8.9,880,True,13,126,733,21,0,2024-05-26,False,False,False,0.8329545454545455,0.1431818181818182,0.023863636363636365,0.0,Peak,Sunday,May
2024-05-26 14:00:00,97,257,9,0,363,58,664,6,1,729,31.5,71,3,9.1,1092,True,14,155,921,15,1,2024-05-26,False,False,False,0.8434065934065934,0.14194139194139194,0.013736263736263736,0.0009157509157509158,Peak,Sunday,May
2024-05-26 15:00:00,79,212,6,0,297,33,521,7,0,561,31.5,72,51,9.8,858,True,15,112,733,13,0,2024-05-26,False,False,False,0.8543123543123543,0.13053613053613053,0.015151515151515152,0.0,Peak,Sunday,May
2024-05-26 16:00:00,203,571,10,0,784,16,428,5,0,449,30.3,78,61,12.3,1233,True,16,219,999,15,0,2024-05-26,False,False,False,0.8102189781021898,0.17761557177615572,0.012165450121654502,0.0,Peak,Sunday,May
2024-05-26 17:00:00,69,798,19,0,886,12,575,4,0,591,30.0,80,3,12.7,1477,True,17,81,1373,23,0,2024-05-26,False,False,True,0.929587000677048,0.05484089370345294,0.015572105619498984,0.0,Peak,Sunday,May
2024-05-26 18:00:00,162,742,11,1,916,75,438,6,1,520,28.7,85,51,8.3,1436,True,18,237,1180,17,2,2024-05-26,False,False,True,0.8217270194986073,0.16504178272980502,0.011838440111420613,0.001392757660167131,Peak,Sunday,May
2024-05-26 19:00:00,49,430,9,0,488,57,511,3,0,571,26.9,92,63,7.2,1059,True,19,106,941,12,0,2024-05-26,False,False,False,0.8885741265344664,0.10009442870632672,0.0113314447592068,0.0,Peak,Sunday,May
2024-05-26 20:00:00,65,350,6,0,421,42,358,4,0,404,26.4,95,53,4.8,825,True,20,107,708,10,0,2024-05-26,False,False,False,0.8581818181818182,0.1296969696969697,0.012121212121212121,0.0,Shoulder,Sunday,May
2024-05-26 21:00:00,27,199,6,0,232,26,506,5,0,537,26.1,93,51,11.7,769,True,21,53,705,11,0,2024-05-26,False,False,False,0.9167750325097529,0.06892067620286085,0.014304291287386216,0.0,Shoulder,Sunday,May
2024-05-26 22:00:00,58,458,2,0,518,31,265,2,0,298,25.9,94,3,8.5,816,True,22,89,723,4,0,2024-05-26,False,False,False,0.8860294117647058,0.1090686274509804,0.004901960784313725,0.0,Shoulder,Sunday,May
2024-05-26 23:00:00,23,166,7,0,196,38,200,3,0,241,26.0,93,3,5.4,437,True,23,61,366,10,0,2024-05-26,False,False,False,0.8375286041189931,0.13958810068649885,0.02288329519450801,0.0,Shoulder,Sunday,May
2024-05-27 00:00:00,32,248,8,0,288,29,137,6,1,173,25.8,95,3,5.2,461,False,0,61,385,14,1,2024-05-27,False,False,False,0.8351409978308026,0.13232104121475055,0.03036876355748373,0.0021691973969631237,Off-Peak,Monday,May
2024-05-27 01:00:00,104,298,9,0,411,19,325,4,0,348,25.5,96,3,4.1,759,False,1,123,623,13,0,2024-05-27,False,False,False,0.8208168642951251,0.16205533596837945,0.017127799736495388,0.0,Off-Peak,Monday,May
2024-05-27 02:00:00,58,236,7,0,301,59,142,3,1,205,25.7,96,3,5.1,506,False,2,117,378,10,1,2024-05-27,False,False,False,0.7470355731225297,0.23122529644268774,0.019762845849802372,0.001976284584980237,Off-Peak,Monday,May
2024-05-27 03:00:00,34,232,2,0,268,35,351,2,1,389,25.6,96,3,4.3,657,False,3,69,583,4,1,2024-05-27,False,False,False,0.8873668188736682,0.1050228310502283,0.0060882800608828,0.0015220700152207,Off-Peak,Monday,May
2024-05-27 04:00:00,62,167,3,0,232,37,262,4,0,303,25.7,96,3,4.7,535,False,4,99,429,7,0,2024-05-27,False,False,False,0.8018691588785046,0.18504672897196262,0.013084112149532711,0.0,Off-Peak,Monday,May
2024-05-27 05:00:00,24,254,7,0,285,39,388,7,1,435,25.5,96,3,6.1,720,False,5,63,642,14,1,2024-05-27,False,False,False,0.8916666666666667,0.0875,0.019444444444444445,0.001388888888888889,Shoulder,Monday,May
2024-05-27 06:00:00,104,1291,16,1,1412,53,513,5,1,572,25.5,96,3,6.0,1984,False,6,157,1804,21,2,2024-05-27,False,False,True,0.9092741935483871,0.07913306451612903,0.010584677419354838,0.0010080645161290322,Shoulder,Monday,May
2024-05-27 07:00:00,178,545,10,2,735,92,564,9,1,666,25.5,95,3,5.1,1401,False,7,270,1109,19,3,2024-05-27,False,False,True,0.7915774446823698,0.19271948608137046,0.013561741613133477,0.0021413276231263384,Peak,Monday,May
2024-05-27 08:00:00,78,265,14,1,358,64,434,4,1,503,26.0,94,3,5.0,861,False,8,142,699,18,2,2024-05-27,False,False,False,0.8118466898954704,0.16492450638792103,0.020905923344947737,0.0023228803716608595,Peak,Monday,May
2024-05-27 09:00:00,32,439,13,1,485,48,356,5,0,409,28.3,89,3,8.2,894,False,9,80,795,18,1,2024-05-27,False,False,False,0.889261744966443,0.0894854586129754,0.020134228187919462,0.0011185682326621924,Shoulder,Monday,May
2024-05-27 10:00:00,121,231,15,0,367,34,727,2,0,763,28.3,86,3,9.5,1130,False,10,155,958,17,0,2024-05-27,False,False,False,0.8477876106194691,0.13716814159292035,0.01504424778761062,0.0,Shoulder,Monday,May
2024-05-27 11:00:00,50,319,11,3,383,50,220,4,1,275,29.9,80,3,7.6,658,False,11,100,539,15,4,2024-05-27,False,False,False,0.8191489361702128,0.1519756838905775,0.022796352583586626,0.0060790273556231,Peak,Monday,May
2024-05-27 12:00:00,140,222,7,1,370,22,615,8,0,645,30.6,77,51,10.0,1015,False,12,162,837,15,1,2024-05-27,False,False,False,0.8246305418719212,0.15960591133004925,0.014778325123152709,0.0009852216748768472,Peak,Monday,May
2024-05-27 13:00:00,43,266,15,0,324,45,586,11,0,642,30.8,75,2,11.3,966,False,13,88,852,26,0,2024-05-27,False,False,False,0.8819875776397516,0.09109730848861283,0.026915113871635612,0.0,Peak,Monday,May
2024-05-27 14:00:00,105,639,7,0,751,60,749,8,1,818,30.9,75,3,12.6,1569,False,14,165,1388,15,1,2024-05-27,False,False,True,0.8846398980242193,0.10516252390057361,0.009560229445506692,0.0006373486297004461,Peak,Monday,May
2024-05-27 15:00:00,75,593,4,0,672,63,324,14,0,401,30.9,76,3,10.4,1073,False,15,138,917,18,0,2024-05-27,False,False,False,0.8546132339235788,0.12861136999068035,0.016775396085740912,0.0,Peak,Monday,May
2024-05-27 16:00:00,124,909,4,1,1038,51,1077,5,1,1134,30.0,80,3,7.2,2172,False,16,175,1986,9,2,2024-05-27,False,False,True,0.914364640883978,0.08057090239410682,0.004143646408839779,0.0009208103130755065,Peak,Monday,May
2024-05-27 17:00:00,217,561,6,1,785,49,666,5,0,720,30.2,76,3,7.7,1505,False,17,266,1227,11,1,2024-05-27,False,False,True,0.815282392026578,0.17674418604651163,0.007308970099667774,0.000664451827242525,Peak,Monday,May
2024-05-27 18:00:00,190,707,11,1,909,34,242,15,0,291,29.9,77,3,8.9,1200,False,18,224,949,26,1,2024-05-27,False,False,False,0.7908333333333334,0.18666666666666668,0.021666666666666667,0.0008333333333333334,Peak,Monday,May
2024-05-27 19:00:00,32,239,8,0,279,14,156,4,0,174,29.1,81,3,6.0,453,False,19,46,395,12,0,2024-05-27,False,False,False,0.8719646799116998,0.10154525386313466,0.026490066225165563,0.0,Peak,Monday,May
2024-05-27 20:00:00,105,394,9,0,508,39,376,6,1,422,28.6,84,3,7.9,930,False,20,144,770,15,1,2024-05-27,False,False,False,0.8279569892473119,0.15483870967741936,0.016129032258064516,0.001075268817204301,Shoulder,Monday,May
2024-05-27 21:00:00,71,424,1,0,496,53,137,7,0,197,29.4,81,3,14.6,693,False,21,124,561,8,0,2024-05-27,False,False,False,0.8095238095238095,0.17893217893217894,0.011544011544011544,0.0,Shoulder,Monday,May
2024-05-27 22:00:00,12,431,3,0,446,29,505,4,1,539,28.9,85,3,12.4,985,False,22,41,936,7,1,2024-05-27,False,False,False,0.950253807106599,0.0416243654822335,0.007106598984771574,0.0010152284263959391,Shoulder,Monday,May
2024-05-27 23:00:00,71,339,6,1,417,36,397,10,1,444,28.5,87,3,9.4,861,False,23,107,736,16,2,2024-05-27,False,False,False,0.8548199767711963,0.12427409988385599,0.018583042973286876,0.0023228803716608595,Shoulder,Monday,May
2024-05-28 00:00:00,45,143,5,1,194,59,206,1,1,267,28.0,89,3,10.2,461,False,0,104,349,6,2,2024-05-28,False,False,False,0.7570498915401301,0.22559652928416485,0.013015184381778741,0.004338394793926247,Off-Peak,Tuesday,May
2024-05-28 01:00:00,82,119,9,0,210,58,126,6,0,190,27.8,90,3,7.2,400,False,1,140,245,15,0,2024-05-28,False,False,False,0.6125,0.35,0.0375,0.0,Off-Peak,Tuesday,May
2024-05-28 02:00:00,67,381,4,1,453,20,200,5,1,226,27.8,89,3,9.1,679,False,2,87,581,9,2,2024-05-28,False,False,False,0.8556701030927835,0.12812960235640647,0.013254786450662739,0.0029455081001472753,Off-Peak,Tuesday,May
2024-05-28 03:00:00,48,180,4,0,232,22,194,4,0,220,27.4,89,51,5.5,452,False,3,70,374,8,0,2024-05-28,False,False,False,0.827433628318584,0.15486725663716813,0.017699115044247787,0.0,Off-Peak,Tuesday,May
2024-05-28 04:00:00,72,112,8,1,193,57,380,2,1,440,27.2,91,3,4.7,633,False,4,129,492,10,2,2024-05-28,False,False,False,0.7772511848341233,0.2037914691943128,0.01579778830963665,0.00315955766192733,Off-Peak,Tuesday,May
2024-05-28 05:00:00,88,553,9,1,651,10,344,3,1,358,27.0,93,2,7.9,1009,False,5,98,897,12,2,2024-05-28,False,False,False,0.8889990089197225,0.09712586719524281,0.011892963330029732,0.0019821605550049554,Shoulder,Tuesday,May
2024-05-28 06:00:00,58,915,19,1,993,63,555,12,1,631,26.7,94,3,6.3,1624,False,6,121,1470,31,2,2024-05-28,False,False,True,0.9051724137931034,0.07450738916256158,0.019088669950738917,0.0012315270935960591,Shoulder,Tuesday,May
2024-05-28 07:00:00,108,1033,18,0,1159,48,849,9,1,907,26.5,95,3,4.2,2066,False,7,156,1882,27,1,2024-05-28,False,False,True,0.9109390125847048,0.0755082284607938,0.013068731848983543,0.000484027105517909,Peak,Tuesday,May
2024-05-28 08:00:00,82,929,20,0,1031,97,396,14,2,509,26.9,94,51,3.8,1540,False,8,179,1325,34,2,2024-05-28,False,False,True,0.8603896103896104,0.11623376623376623,0.02207792207792208,0.0012987012987012987,Peak,Tuesday,May
2024-05-28 09:00:00,71,196,6,1,274,26,595,5,1,627,27.7,86,63,6.4,901,False,9,97,791,11,2,2024-05-28,False,False,False,0.8779134295227525,0.1076581576026637,0.01220865704772475,0.0022197558268590455,Shoulder,Tuesday,May
2024-05-28 10:00:00,76,176,6,2,260,73,317,4,3,397,29.4,86,51,6.7,657,False,10,149,493,10,5,2024-05-28,False,False,False,0.7503805175038052,0.2267884322678843,0.015220700152207,0.0076103500761035,Shoulder,Tuesday,May
2024-05-28 11:00:00,155,299,3,1,458,30,330,13,1,374,30.8,79,51,6.1,832,False,11,185,629,16,2,2024-05-28,False,False,False,0.7560096153846154,0.22235576923076922,0.019230769230769232,0.002403846153846154,Peak,Tuesday,May
2024-05-28 12:00:00,116,435,8,1,560,50,623,12,1,686,31.6,73,51,11.0,1246,False,12,166,1058,20,2,2024-05-28,False,False,False,0.8491171749598716,0.1332263242375602,0.016051364365971106,0.0016051364365971107,Peak,Tuesday,May
2024-05-28 13:00:00,39,553,5,1,598,55,621,4,1,681,32.1,69,51,11.8,1279,False,13,94,1174,9,2,2024-05-28,False,False,False,0.9179046129788898,0.07349491790461297,0.007036747458952306,0.001563721657544957,Peak,Tuesday,May
2024-05-28 14:00:00,55,340,3,0,398,28,104,3,0,135,31.8,71,51,12.1,533,False,14,83,444,6,0,2024-05-28,False,False,False,0.8330206378986866,0.15572232645403378,0.01125703564727955,0.0,Peak,Tuesday,May
2024-05-28 15:00:00,50,513,3,1,567,42,529,10,0,581,29.6,78,63,7.2,1148,False,15,92,1042,13,1,2024-05-28,False,False,False,0.9076655052264808,0.08013937282229965,0.01132404181184669,0.0008710801393728223,Peak,Tuesday,May
2024-05-28 16:00:00,170,1124,13,1,1308,110,617,12,0,739,26.4,91,63,8.5,2047,False,16,280,1741,25,1,2024-05-28,False,False,True,0.8505129457743038,0.13678553981436248,0.012212994626282364,0.0004885197850512946,Peak,Tuesday,May
2024-05-28 17:00:00,178,956,4,1,1139,82,405,2,0,489,26.8,91,55,4.5,1628,False,17,260,1361,6,1,2024-05-28,False,False,True,0.835995085995086,0.1597051597051597,0.0036855036855036856,0.0006142506142506142,Peak,Tuesday,May
2024-05-28 18:00:00,94,391,18,1,504,41,1014,7,1,1063,26.5,93,53,5.2,1567,False,18,135,1405,25,2,2024-05-28,False,False,True,0.8966177409061902,0.08615188257817485,0.01595405232929164,0.0012763241863433313,Peak,Tuesday,May
2024-05-28 19:00:00,114,555,2,0,671,43,709,5,0,757,26.0,96,51,6.4,1428,False,19,157,1264,7,0,2024-05-28,False,False,True,0.8851540616246498,0.10994397759103641,0.004901960784313725,0.0,Peak,Tuesday,May
2024-05-28 20:00:00,155,252,4,1,412,25,344,6,0,375,26.0,96,51,8.2,787,False,20,180,596,10,1,2024-05-28,False,False,False,0.7573062261753494,0.22871664548919948,0.012706480304955527,0.0012706480304955528,Shoulder,Tuesday,May
2024-05-28 21:00:00,160,318,10,1,489,42,197,3,0,242,28.4,88,3,12.9,731,False,21,202,515,13,1,2024-05-28,False,False,False,0.7045143638850889,0.2763337893296854,0.017783857729138167,0.0013679890560875513,Shoulder,Tuesday,May
2024-05-28 22:00:00,75,263,5,0,343,5,634,2,0,641,28.0,90,3,10.5,984,False,22,80,897,7,0,2024-05-28,False,False,False,0.9115853658536586,0.08130081300813008,0.007113821138211382,0.0,Shoulder,Tuesday,May
2024-05-28 23:00:00,84,128,3,0,215,41,575,4,1,621,27.2,92,51,10.5,836,False,23,125,703,7,1,2024-05-28,False,False,False,0.8409090909090909,0.14952153110047847,0.008373205741626795,0.0011961722488038277,Shoulder,Tuesday,May
2024-05-29 00:00:00,45,165,7,1,218,24,195,6,1,226,26.8,93,3,5.1,444,False,0,69,360,13,2,2024-05-29,False,False,False,0.8108108108108109,0.1554054054054054,0.02927927927927928,0.0045045045045045045,Off-Peak,Wednesday,May
2024-05-29 01:00:00,15,239,4,0,258,48,378,4,0,430,26.9,91,3,6.9,688,False,1,63,617,8,0,2024-05-29,False,False,False,0.8968023255813954,0.09156976744186046,0.011627906976744186,0.0,Off-Peak,Wednesday,May
2024-05-29 02:00:00,27,129,12,1,169,57,249,5,0,311,26.6,92,3,7.3,480,False,2,84,378,17,1,2024-05-29,False,False,False,0.7875,0.175,0.035416666666666666,0.0020833333333333333,Off-Peak,Wednesday,May
2024-05-29 03:00:00,10,339,13,0,362,44,345,5,1,395,26.2,93,3,7.3,757,False,3,54,684,18,1,2024-05-29,False,False,False,0.9035667107001321,0.071334214002642,0.023778071334214,0.001321003963011889,Off-Peak,Wednesday,May
2024-05-29 04:00:00,107,394,4,1,506,40,223,3,0,266,26.1,93,3,6.5,772,False,4,147,617,7,1,2024-05-29,False,False,False,0.7992227979274611,0.19041450777202074,0.009067357512953367,0.0012953367875647669,Off-Peak,Wednesday,May
2024-05-29 05:00:00,132,281,7,0,420,42,384,2,0,428,25.9,94,3,3.6,848,False,5,174,665,9,0,2024-05-29,False,False,False,0.7841981132075472,0.20518867924528303,0.01061320754716981,0.0,Shoulder,Wednesday,May
2024-05-29 06:00:00,193,780,6,1,980,21,1150,13,2,1186,25.9,95,3,4.0,2166,False,6,214,1930,19,3,2024-05-29,False,False,True,0.8910433979686058,0.09879963065558633,0.008771929824561403,0.0013850415512465374,Shoulder,Wednesday,May
2024-05-29 07:00:00,205,1121,19,1,1346,55,847,5,0,907,25.4,96,3,3.6,2253,False,7,260,1968,24,1,2024-05-29,False,False,True,0.8735019973368842,0.11540168664003551,0.010652463382157125,0.0004438526409232135,Peak,Wednesday,May
2024-05-29 08:00:00,153,597,14,2,766,32,279,5,1,317,26.7,92,3,5.8,1083,False,8,185,876,19,3,2024-05-29,False,False,False,0.8088642659279779,0.17082179132040629,0.017543859649122806,0.002770083102493075,Peak,Wednesday,May
2024-05-29 09:00:00,44,396,3,1,444,65,405,18,0,488,28.4,93,3,3.5,932,False,9,109,801,21,1,2024-05-29,False,False,False,0.8594420600858369,0.11695278969957082,0.022532188841201718,0.001072961373390558,Shoulder,Wednesday,May
2024-05-29 10:00:00,60,481,4,0,545,23,260,4,0,287,30.3,84,3,6.1,832,False,10,83,741,8,0,2024-05-29,False,False,False,0.890625,0.09975961538461539,0.009615384615384616,0.0,Shoulder,Wednesday,May
2024-05-29 11:00:00,49,484,8,0,541,15,850,2,0,867,31.5,73,51,12.5,1408,False,11,64,1334,10,0,2024-05-29,False,False,True,0.9474431818181818,0.045454545454545456,0.007102272727272727,0.0,Peak,Wednesday,May
2024-05-29 12:00:00,89,461,7,0,557,58,409,4,1,472,31.9,69,51,14.7,1029,False,12,147,870,11,1,2024-05-29,False,False,False,0.8454810495626822,0.14285714285714285,0.010689990281827016,0.0009718172983479105,Peak,Wednesday,May
2024-05-29 13:00:00,83,661,9,0,753,57,228,3,1,289,32.3,68,51,13.3,1042,False,13,140,889,12,1,2024-05-29,False,False,False,0.8531669865642995,0.1343570057581574,0.011516314779270634,0.0009596928982725527,Peak,Wednesday,May
2024-05-29 14:00:00,48,494,14,0,556,43,521,6,0,570,30.5,77,63,7.6,1126,False,14,91,1015,20,0,2024-05-29,False,False,False,0.9014209591474245,0.08081705150976909,0.017761989342806393,0.0,Peak,Wednesday,May
2024-05-29 15:00:00,59,231,10,1,301,18,264,11,1,294,30.6,76,51,8.2,595,False,15,77,495,21,2,2024-05-29,False,False,False,0.8319327731092437,0.12941176470588237,0.03529411764705882,0.0033613445378151263,Peak,Wednesday,May
2024-05-29 16:00:00,136,533,11,0,680,87,567,9,0,663,29.8,78,63,7.7,1343,False,16,223,1100,20,0,2024-05-29,False,False,False,0.8190618019359642,0.16604616530156366,0.014892032762472078,0.0,Peak,Wednesday,May
2024-05-29 17:00:00,197,909,2,0,1108,61,681,10,1,753,29.1,80,53,8.1,1861,False,17,258,1590,12,1,2024-05-29,False,False,True,0.8543793659322945,0.138635142396561,0.006448146157979581,0.0005373455131649651,Peak,Wednesday,May
2024-05-29 18:00:00,30,608,13,1,652,45,538,6,2,591,27.8,88,51,11.6,1243,False,18,75,1146,19,3,2024-05-29,False,False,False,0.9219629927594529,0.06033789219629927,0.015285599356395816,0.002413515687851971,Peak,Wednesday,May
2024-05-29 19:00:00,137,255,5,0,397,54,510,5,0,569,27.4,90,3,9.4,966,False,19,191,765,10,0,2024-05-29,False,False,False,0.7919254658385093,0.19772256728778467,0.010351966873706004,0.0,Peak,Wednesday,May
2024-05-29 20:00:00,60,394,3,1,458,30,432,2,1,465,27.4,91,3,4.6,923,False,20,90,826,5,2,2024-05-29,False,False,False,0.894907908992416,0.09750812567713976,0.005417118093174431,0.0021668472372697724,Shoulder,Wednesday,May
2024-05-29 21:00:00,74,339,3,0,416,59,689,4,0,752,27.4,89,3,1.8,1168,False,21,133,1028,7,0,2024-05-29,False,False,False,0.8801369863013698,0.11386986301369863,0.0059931506849315065,0.0,Shoulder,Wednesday,May
2024-05-29 22:00:00,138,479,4,1,622,30,461,5,0,496,27.7,88,2,1.8,1118,False,22,168,940,9,1,2024-05-29,False,False,False,0.8407871198568873,0.15026833631484796,0.008050089445438283,0.0008944543828264759,Shoulder,Wednesday,May
2024-05-29 23:00:00,27,235,9,1,272,20,140,2,1,163,27.0,92,3,4.3,435,False,23,47,375,11,2,2024-05-29,False,False,False,0.8620689655172413,0.10804597701149425,0.02528735632183908,0.004597701149425287,Shoulder,Wednesday,May
2024-05-30 00:00:00,20,331,4,0,355,27,242,1,1,271,26.7,93,3,2.1,626,False,0,47,573,5,1,2024-05-30,False,True,False,0.9153354632587859,0.07507987220447285,0.007987220447284345,0.001597444089456869,Off-Peak,Thursday,May
2024-05-30 01:00:00,15,258,1,1,275,42,386,3,1,432,26.2,96,3,1.5,707,False,1,57,644,4,2,2024-05-30,False,True,False,0.9108910891089109,0.08062234794908062,0.005657708628005658,0.002828854314002829,Off-Peak,Thursday,May
2024-05-30 02:00:00,49,327,2,1,379,18,319,7,0,344,26.2,97,3,2.3,723,False,2,67,646,9,1,2024-05-30,False,True,False,0.8934993084370678,0.09266943291839558,0.012448132780082987,0.0013831258644536654,Off-Peak,Thursday,May
2024-05-30 03:00:00,91,465,3,0,559,30,749,4,0,783,26.3,96,3,3.1,1342,False,3,121,1214,7,0,2024-05-30,False,True,False,0.9046199701937406,0.09016393442622951,0.005216095380029807,0.0,Off-Peak,Thursday,May
2024-05-30 04:00:00,44,296,13,1,354,24,212,4,1,241,26.3,96,3,5.1,595,False,4,68,508,17,2,2024-05-30,False,True,False,0.853781512605042,0.11428571428571428,0.02857142857142857,0.0033613445378151263,Off-Peak,Thursday,May
2024-05-30 05:00:00,125,602,13,0,740,62,442,1,0,505,27.0,92,3,7.6,1245,False,5,187,1044,14,0,2024-05-30,False,True,False,0.8385542168674699,0.1502008032128514,0.011244979919678716,0.0,Shoulder,Thursday,May
2024-05-30 06:00:00,90,641,14,1,746,48,801,16,1,866,25.6,93,63,6.1,1612,False,6,138,1442,30,2,2024-05-30,False,True,True,0.8945409429280397,0.08560794044665013,0.018610421836228287,0.0012406947890818859,Shoulder,Thursday,May
2024-05-30 07:00:00,204,591,9,1,805,76,661,5,0,742,25.7,96,61,3.0,1547,False,7,280,1252,14,1,2024-05-30,False,True,True,0.8093083387201034,0.18099547511312217,0.00904977375565611,0.0006464124111182935,Peak,Thursday,May
2024-05-30 08:00:00,140,950,20,1,1111,67,489,12,0,568,26.3,96,51,3.8,1679,False,8,207,1439,32,1,2024-05-30,False,True,True,0.8570577724836212,0.1232876712328767,0.019058963668850508,0.0005955926146515784,Peak,Thursday,May
2024-05-30 09:00:00,94,479,12,0,585,31,267,9,1,308,27.9,89,51,7.8,893,False,9,125,746,21,1,2024-05-30,False,True,False,0.8353863381858903,0.13997760358342665,0.023516237402015677,0.0011198208286674132,Shoulder,Thursday,May
2024-05-30 10:00:00,87,292,4,0,383,50,370,4,0,424,28.2,86,63,14.4,807,False,10,137,662,8,0,2024-05-30,False,True,False,0.8203221809169765,0.1697645600991326,0.009913258983890954,0.0,Shoulder,Thursday,May
2024-05-30 11:00:00,111,630,13,0,754,26,581,11,1,619,28.8,83,55,15.2,1373,False,11,137,1211,24,1,2024-05-30,False,True,False,0.8820101966496723,0.09978150036416605,0.01747997086671522,0.0007283321194464676,Peak,Thursday,May
2024-05-30 12:00:00,89,481,10,1,581,30,492,14,0,536,29.7,79,51,13.8,1117,False,12,119,973,24,1,2024-05-30,False,True,False,0.8710832587287377,0.10653536257833482,0.021486123545210387,0.0008952551477170994,Peak,Thursday,May
2024-05-30 13:00:00,78,287,4,0,369,20,351,3,1,375,30.5,76,51,12.6,744,False,13,98,638,7,1,2024-05-30,False,True,False,0.8575268817204301,0.13172043010752688,0.009408602150537635,0.0013440860215053765,Peak,Thursday,May
2024-05-30 14:00:00,99,776,4,0,879,45,577,10,1,633,30.3,74,51,13.8,1512,False,14,144,1353,14,1,2024-05-30,False,True,True,0.8948412698412699,0.09523809523809523,0.009259259259259259,0.0006613756613756613,Peak,Thursday,May
2024-05-30 15:00:00,81,512,8,0,601,67,499,12,0,578,30.4,78,3,11.8,1179,False,15,148,1011,20,0,2024-05-30,False,True,False,0.8575063613231552,0.1255301102629347,0.016963528413910092,0.0,Peak,Thursday,May
2024-05-30 16:00:00,204,480,2,1,687,100,307,9,1,417,30.4,77,3,11.6,1104,False,16,304,787,11,2,2024-05-30,False,True,False,0.7128623188405797,0.2753623188405797,0.009963768115942028,0.0018115942028985507,Peak,Thursday,May
2024-05-30 17:00:00,184,236,20,1,441,54,394,8,1,457,30.0,77,3,10.2,898,False,17,238,630,28,2,2024-05-30,False,True,False,0.7015590200445434,0.2650334075723831,0.031180400890868598,0.0022271714922048997,Peak,Thursday,May
2024-05-30 18:00:00,84,358,10,1,453,26,607,1,1,635,29.7,78,3,8.7,1088,False,18,110,965,11,2,2024-05-30,False,True,False,0.8869485294117647,0.10110294117647059,0.01011029411764706,0.001838235294117647,Peak,Thursday,May
2024-05-30 19:00:00,83,220,11,1,315,21,438,1,0,460,29.1,82,3,5.9,775,False,19,104,658,12,1,2024-05-30,False,True,False,0.8490322580645161,0.13419354838709677,0.015483870967741935,0.0012903225806451613,Peak,Thursday,May
2024-05-30 20:00:00,63,638,3,1,705,43,734,1,0,778,28.6,84,3,5.4,1483,False,20,106,1372,4,1,2024-05-30,False,True,True,0.9251517194875253,0.07147673634524612,0.0026972353337828725,0.0006743088334457181,Shoulder,Thursday,May
2024-05-30 21:00:00,65,295,6,0,366,18,222,1,1,242,28.6,84,3,10.2,608,False,21,83,517,7,1,2024-05-30,False,True,False,0.850328947368421,0.13651315789473684,0.011513157894736841,0.001644736842105263,Shoulder,Thursday,May
2024-05-30 22:00:00,70,149,11,0,230,25,429,0,0,454,28.1,87,3,7.9,684,False,22,95,578,11,0,2024-05-30,False,True,False,0.8450292397660819,0.1388888888888889,0.01608187134502924,0.0,Shoulder,Thursday,May
2024-05-30 23:00:00,50,399,3,0,452,7,124,1,0,132,27.6,88,3,8.5,584,False,23,57,523,4,0,2024-05-30,False,True,False,0.8955479452054794,0.0976027397260274,0.00684931506849315,0.0,Shoulder,Thursday,May
2024-05-31 00:00:00,71,195,9,1,276,16,209,1,0,226,26.9,90,3,8.1,502,False,0,87,404,10,1,2024-05-31,False,True,False,0.8047808764940239,0.17330677290836655,0.0199203187250996,0.00199203187250996,Off-Peak,Friday,May
2024-05-31 01:00:00,64,224,1,0,289,22,203,5,0,230,26.6,91,3,6.8,519,False,1,86,427,6,0,2024-05-31,False,True,False,0.8227360308285164,0.16570327552986513,0.011560693641618497,0.0,Off-Peak,Friday,May
2024-05-31 02:00:00,28,312,6,1,347,30,266,4,1,301,26.5,91,3,7.8,648,False,2,58,578,10,2,2024-05-31,False,True,False,0.8919753086419753,0.08950617283950617,0.015432098765432098,0.0030864197530864196,Off-Peak,Friday,May
2024-05-31 03:00:00,31,232,5,1,269,42,150,3,1,196,26.4,91,3,8.0,465,False,3,73,382,8,2,2024-05-31,False,True,False,0.821505376344086,0.15698924731182795,0.017204301075268817,0.004301075268817204,Off-Peak,Friday,May
2024-05-31 04:00:00,70,265,5,1,341,41,242,5,1,289,26.3,91,3,6.8,630,False,4,111,507,10,2,2024-05-31,False,True,False,0.8047619047619048,0.1761904761904762,0.015873015873015872,0.0031746031746031746,Off-Peak,Friday,May
2024-05-31 05:00:00,56,242,2,1,301,26,606,3,0,635,26.1,92,3,6.2,936,False,5,82,848,5,1,2024-05-31,False,True,False,0.905982905982906,0.0876068376068376,0.005341880341880342,0.0010683760683760685,Shoulder,Friday,May
2024-05-31 06:00:00,111,808,7,1,927,33,733,6,0,772,26.1,92,3,4.3,1699,False,6,144,1541,13,1,2024-05-31,False,True,True,0.9070041200706298,0.08475573866980576,0.007651559741024131,0.0005885815185403178,Shoulder,Friday,May
2024-05-31 07:00:00,113,927,1,0,1041,66,910,10,1,987,25.1,96,63,4.2,2028,False,7,179,1837,11,1,2024-05-31,False,True,True,0.9058185404339251,0.08826429980276135,0.005424063116370809,0.0004930966469428008,Peak,Friday,May
2024-05-31 08:00:00,156,770,11,1,938,43,936,18,1,998,24.8,96,65,2.7,1936,False,8,199,1706,29,2,2024-05-31,False,True,True,0.881198347107438,0.10278925619834711,0.014979338842975207,0.0010330578512396695,Peak,Friday,May
2024-05-31 09:00:00,104,319,4,1,428,50,427,5,1,483,27.9,92,3,2.6,911,False,9,154,746,9,2,2024-05-31,False,True,False,0.818880351262349,0.1690450054884742,0.009879253567508232,0.0021953896816684962,Shoulder,Friday,May
2024-05-31 10:00:00,140,921,2,1,1064,49,308,4,0,361,29.6,86,3,6.2,1425,False,10,189,1229,6,1,2024-05-31,False,True,True,0.8624561403508771,0.13263157894736843,0.004210526315789474,0.0007017543859649122,Shoulder,Friday,May
2024-05-31 11:00:00,187,852,9,0,1048,57,555,6,0,618,31.0,73,3,10.5,1666,False,11,244,1407,15,0,2024-05-31,False,True,True,0.8445378151260504,0.14645858343337334,0.00900360144057623,0.0,Peak,Friday,May
2024-05-31 12:00:00,167,526,11,0,704,45,438,8,1,492,31.2,69,3,11.3,1196,False,12,212,964,19,1,2024-05-31,False,True,False,0.8060200668896321,0.17725752508361203,0.01588628762541806,0.0008361204013377926,Peak,Friday,May
2024-05-31 13:00:00,88,485,3,1,577,74,329,4,2,409,31.1,70,3,11.9,986,False,13,162,814,7,3,2024-05-31,False,True,False,0.8255578093306288,0.1643002028397566,0.007099391480730223,0.0030425963488843813,Peak,Friday,May
2024-05-31 14:00:00,119,419,8,1,547,60,484,3,0,547,28.3,82,63,17.7,1094,False,14,179,903,11,1,2024-05-31,False,True,False,0.8254113345521024,0.1636197440585009,0.010054844606946984,0.0009140767824497258,Peak,Friday,May
2024-05-31 15:00:00,111,739,6,1,857,51,486,5,2,544,28.2,85,1,10.9,1401,False,15,162,1225,11,3,2024-05-31,False,True,True,0.8743754461099215,0.11563169164882227,0.007851534618129907,0.0021413276231263384,Peak,Friday,May
2024-05-31 16:00:00,80,478,5,1,564,94,995,10,3,1102,29.7,78,2,11.4,1666,False,16,174,1473,15,4,2024-05-31,False,True,True,0.8841536614645858,0.10444177671068428,0.00900360144057623,0.0024009603841536613,Peak,Friday,May
2024-05-31 17:00:00,85,262,13,1,361,63,295,5,0,363,29.7,79,1,10.0,724,False,17,148,557,18,1,2024-05-31,False,True,False,0.7693370165745856,0.20441988950276244,0.024861878453038673,0.0013812154696132596,Peak,Friday,May
2024-05-31 18:00:00,161,146,3,1,311,47,224,3,1,275,29.2,81,2,9.1,586,False,18,208,370,6,2,2024-05-31,False,True,False,0.6313993174061433,0.35494880546075086,0.010238907849829351,0.0034129692832764505,Peak,Friday,May
2024-05-31 19:00:00,47,201,1,1,250,33,578,1,0,612,27.8,85,61,13.4,862,False,19,80,779,2,1,2024-05-31,False,True,False,0.9037122969837587,0.09280742459396751,0.002320185614849188,0.001160092807424594,Peak,Friday,May
2024-05-31 20:00:00,53,229,3,1,286,24,257,4,1,286,26.4,90,61,10.8,572,False,20,77,486,7,2,2024-05-31,False,True,False,0.8496503496503497,0.1346153846153846,0.012237762237762238,0.0034965034965034965,Shoulder,Friday,May
2024-05-31 21:00:00,73,408,3,0,484,38,216,6,1,261,28.4,83,3,10.5,745,False,21,111,624,9,1,2024-05-31,False,True,False,0.8375838926174497,0.14899328859060404,0.012080536912751677,0.0013422818791946308,Shoulder,Friday,May
2024-05-31 22:00:00,36,367,8,1,412,16,459,4,1,480,28.2,84,3,8.7,892,False,22,52,826,12,2,2024-05-31,False,True,False,0.9260089686098655,0.05829596412556054,0.013452914798206279,0.002242152466367713,Shoulder,Friday,May
2024-05-31 23:00:00,87,369,3,0,459,10,390,3,1,404,27.0,88,61,14.3,863,False,23,97,759,6,1,2024-05-31,False,True,False,0.8794901506373117,0.11239860950173812,0.006952491309385863,0.0011587485515643105,Shoulder,Friday,May
2024-06-01 00:00:00,46,277,4,0,327,63,387,8,0,458,26.3,91,63,10.0,785,True,0,109,664,12,0,2024-06-01,False,True,False,0.845859872611465,0.13885350318471337,0.015286624203821656,0.0,Off-Peak,Saturday,June
2024-06-01 01:00:00,49,279,4,0,332,24,184,4,0,212,26.3,93,51,7.9,544,True,1,73,463,8,0,2024-06-01,False,True,False,0.8511029411764706,0.13419117647058823,0.014705882352941176,0.0,Off-Peak,Saturday,June
2024-06-01 02:00:00,45,266,4,0,315,63,386,6,0,455,25.6,94,63,5.0,770,True,2,108,652,10,0,2024-06-01,False,True,False,0.8467532467532467,0.14025974025974025,0.012987012987012988,0.0,Off-Peak,Saturday,June
2024-06-01 03:00:00,49,281,4,0,334,19,169,3,0,191,25.8,93,53,9.5,525,True,3,68,450,7,0,2024-06-01,False,True,False,0.8571428571428571,0.1295238095238095,0.013333333333333334,0.0,Off-Peak,Saturday,June
2024-06-01 04:00:00,25,176,3,0,204,34,234,4,0,272,25.7,93,3,7.0,476,True,4,59,410,7,0,2024-06-01,False,True,False,0.8613445378151261,0.12394957983193278,0.014705882352941176,0.0,Off-Peak,Saturday,June
2024-06-01 05:00:00,27,191,3,0,221,27,210,3,0,240,25.5,95,3,4.4,461,True,5,54,401,6,0,2024-06-01,False,True,False,0.8698481561822126,0.11713665943600868,0.013015184381778741,0.0,Shoulder,Saturday,June
2024-06-01 06:00:00,34,217,3,0,254,24,183,4,0,211,25.3,95,3,5.6,465,True,6,58,400,7,0,2024-06-01,False,True,False,0.8602150537634409,0.12473118279569892,0.015053763440860216,0.0,Shoulder,Saturday,June
2024-06-01 07:00:00,70,365,7,0,442,69,414,9,0,492,26.4,91,3,3.5,934,True,7,139,779,16,0,2024-06-01,False,True,False,0.8340471092077087,0.14882226980728053,0.017130620985010708,0.0,Peak,Saturday,June
2024-06-01 08:00:00,38,239,5,1,283,34,242,4,0,280,26.7,92,3,5.4,563,True,8,72,481,9,1,2024-06-01,False,True,False,0.8543516873889876,0.12788632326820604,0.015985790408525755,0.0017761989342806395,Peak,Saturday,June
2024-06-01 09:00:00,45,262,4,0,311,24,193,3,0,220,26.7,93,3,4.4,531,True,9,69,455,7,0,2024-06-01,False,True,False,0.8568738229755178,0.12994350282485875,0.013182674199623353,0.0,Shoulder,Saturday,June
2024-06-01 10:00:00,47,266,6,0,319,24,188,3,0,215,28.5,88,3,4.6,534,True,10,71,454,9,0,2024-06-01,False,True,False,0.850187265917603,0.13295880149812733,0.016853932584269662,0.0,Shoulder,Saturday,June
2024-06-01 11:00:00,39,231,5,0,275,74,438,9,0,521,30.2,79,3,5.7,796,True,11,113,669,14,0,2024-06-01,False,True,False,0.8404522613065326,0.14195979899497488,0.017587939698492462,0.0,Peak,Saturday,June
2024-06-01 12:00:00,48,277,5,1,331,57,360,7,0,424,30.9,77,51,8.9,755,True,12,105,637,12,1,2024-06-01,False,True,False,0.8437086092715231,0.1390728476821192,0.015894039735099338,0.0013245033112582781,Peak,Saturday,June
2024-06-01 13:00:00,54,302,6,1,363,66,404,8,0,478,28.1,81,63,12.8,841,True,13,120,706,14,1,2024-06-01,False,True,False,0.8394768133174791,0.1426872770511296,0.016646848989298454,0.0011890606420927466,Peak,Saturday,June
2024-06-01 14:00:00,29,197,5,1,232,35,242,4,0,281,27.7,88,61,5.4,513,True,14,64,439,9,1,2024-06-01,False,True,False,0.8557504873294347,0.12475633528265107,0.017543859649122806,0.001949317738791423,Peak,Saturday,June
2024-06-01 15:00:00,86,424,8,1,519,54,343,8,0,405,27.6,85,61,14.5,924,True,15,140,767,16,1,2024-06-01,False,True,False,0.8300865800865801,0.15151515151515152,0.017316017316017316,0.0010822510822510823,Peak,Saturday,June
2024-06-01 16:00:00,93,448,9,1,551,58,358,9,1,426,26.6,91,61,5.4,977,True,16,151,806,18,2,2024-06-01,False,True,False,0.8249744114636642,0.15455475946775846,0.01842374616171955,0.0020470829068577278,Peak,Saturday,June
2024-06-01 17:00:00,32,209,5,1,247,27,206,3,1,237,27.1,90,61,3.2,484,True,17,59,415,8,2,2024-06-01,False,True,False,0.8574380165289256,0.12190082644628099,0.01652892561983471,0.004132231404958678,Peak,Saturday,June
2024-06-01 18:00:00,63,337,8,1,409,67,408,9,1,485,27.1,92,53,4.7,894,True,18,130,745,17,2,2024-06-01,False,True,False,0.8333333333333334,0.14541387024608501,0.01901565995525727,0.0022371364653243847,Peak,Saturday,June
2024-06-01 19:00:00,83,410,10,1,504,59,367,9,1,436,26.8,97,53,5.1,940,True,19,142,777,19,2,2024-06-01,False,True,False,0.8265957446808511,0.15106382978723404,0.02021276595744681,0.002127659574468085,Peak,Saturday,June
2024-06-01 20:00:00,91,440,11,1,543,56,355,8,1,420,26.7,97,53,5.5,963,True,20,147,795,19,2,2024-06-01,False,True,False,0.8255451713395638,0.1526479750778816,0.01973001038421599,0.0020768431983385254,Shoulder,Saturday,June
2024-06-01 21:00:00,67,354,8,1,430,28,204,5,2,239,27.5,77,3,11.8,669,True,21,95,558,13,3,2024-06-01,False,True,False,0.8340807174887892,0.14200298953662183,0.01943198804185351,0.004484304932735426,Shoulder,Saturday,June
2024-06-01 22:00:00,66,345,8,1,420,33,240,6,1,280,27.1,75,3,5.4,700,True,22,99,585,14,2,2024-06-01,False,True,False,0.8357142857142857,0.14142857142857143,0.02,0.002857142857142857,Shoulder,Saturday,June
2024-06-01 23:00:00,53,291,7,1,352,60,369,11,1,441,26.0,81,3,7.1,793,True,23,113,660,18,2,2024-06-01,False,True,False,0.832282471626734,0.1424968474148802,0.02269861286254729,0.0025220680958385876,Shoulder,Saturday,June
2024-06-02 00:00:00,42,411,5,0,458,63,272,7,0,342,25.6,79,3,6.1,800,True,0,105,683,12,0,2024-06-02,False,True,False,0.85375,0.13125,0.015,0.0,Off-Peak,Sunday,June
2024-06-02 01:00:00,65,639,7,1,712,49,172,5,0,226,25.1,83,3,7.6,938,True,1,114,811,12,1,2024-06-02,False,True,False,0.8646055437100213,0.12153518123667377,0.01279317697228145,0.0010660980810234541,Off-Peak,Sunday,June
2024-06-02 02:00:00,54,554,7,1,616,64,219,9,0,292,25.6,82,3,5.5,908,True,2,118,773,16,1,2024-06-02,False,True,False,0.8513215859030837,0.1299559471365639,0.01762114537444934,0.0011013215859030838,Off-Peak,Sunday,June
2024-06-02 03:00:00,72,740,8,1,821,53,186,6,0,245,25.4,82,3,5.4,1066,True,3,125,926,14,1,2024-06-02,False,True,False,0.8686679174484052,0.11726078799249531,0.013133208255159476,0.0009380863039399625,Off-Peak,Sunday,June
2024-06-02 04:00:00,68,679,8,1,756,56,219,7,1,283,26.3,77,3,2.5,1039,True,4,124,898,15,2,2024-06-02,False,True,False,0.8642925890279115,0.11934552454282965,0.014436958614051972,0.0019249278152069298,Off-Peak,Sunday,June
2024-06-02 05:00:00,85,845,9,1,940,63,370,7,0,440,24.9,89,3,4.0,1380,True,5,148,1215,16,1,2024-06-02,False,True,True,0.8804347826086957,0.1072463768115942,0.011594202898550725,0.0007246376811594203,Shoulder,Sunday,June
2024-06-02 06:00:00,36,323,4,1,364,28,432,3,0,463,24.6,90,3,4.3,827,True,6,64,755,7,1,2024-06-02,False,True,False,0.9129383313180169,0.0773881499395405,0.008464328899637243,0.0012091898428053204,Shoulder,Sunday,June
2024-06-02 07:00:00,70,709,10,1,790,54,600,6,2,662,24.2,92,3,6.1,1452,True,7,124,1309,16,3,2024-06-02,False,True,True,0.9015151515151515,0.08539944903581267,0.011019283746556474,0.002066115702479339,Peak,Sunday,June
2024-06-02 08:00:00,46,445,7,1,499,39,586,5,2,632,25.0,90,3,6.9,1131,True,8,85,1031,12,3,2024-06-02,False,True,False,0.9115826702033598,0.07515473032714412,0.010610079575596816,0.002652519893899204,Peak,Sunday,June
2024-06-02 09:00:00,48,470,8,1,527,41,577,5,1,624,26.5,93,51,9.1,1151,True,9,89,1047,13,2,2024-06-02,False,True,False,0.9096437880104257,0.07732406602953953,0.011294526498696786,0.0017376194613379669,Shoulder,Sunday,June
2024-06-02 10:00:00,35,321,6,2,364,50,415,6,0,471,27.6,90,51,4.3,835,True,10,85,736,12,2,2024-06-02,False,True,False,0.881437125748503,0.10179640718562874,0.01437125748502994,0.0023952095808383233,Shoulder,Sunday,June
2024-06-02 11:00:00,68,699,10,1,778,45,479,5,0,529,28.0,88,53,6.8,1307,True,11,113,1178,15,1,2024-06-02,False,True,False,0.901300688599847,0.0864575363427697,0.011476664116296864,0.0007651109410864575,Peak,Sunday,June
2024-06-02 12:00:00,68,678,10,1,757,21,641,3,3,668,29.7,75,51,12.8,1425,True,12,89,1319,13,4,2024-06-02,False,True,True,0.9256140350877193,0.062456140350877196,0.009122807017543859,0.002807017543859649,Peak,Sunday,June
2024-06-02 13:00:00,80,781,14,3,878,19,489,3,3,514,30.1,69,3,13.8,1392,True,13,99,1270,17,6,2024-06-02,False,True,True,0.9123563218390804,0.07112068965517242,0.01221264367816092,0.004310344827586207,Peak,Sunday,June
2024-06-02 14:00:00,67,672,9,1,749,60,636,6,0,702,30.3,64,3,13.4,1451,True,14,127,1308,15,1,2024-06-02,False,True,True,0.90144727773949,0.08752584424534804,0.010337698139214336,0.0006891798759476223,Peak,Sunday,June
2024-06-02 15:00:00,46,449,7,1,503,38,541,4,0,583,30.0,61,3,11.4,1086,True,15,84,990,11,1,2024-06-02,False,True,False,0.9116022099447514,0.07734806629834254,0.010128913443830571,0.0009208103130755065,Peak,Sunday,June
2024-06-02 16:00:00,71,724,11,1,807,46,472,5,2,525,29.5,64,3,7.6,1332,True,16,117,1196,16,3,2024-06-02,False,True,False,0.8978978978978979,0.08783783783783784,0.012012012012012012,0.0022522522522522522,Peak,Sunday,June
2024-06-02 17:00:00,42,385,7,2,436,47,478,5,0,530,29.8,65,3,7.0,966,True,17,89,863,12,2,2024-06-02,False,True,False,0.8933747412008282,0.09213250517598344,0.012422360248447204,0.002070393374741201,Peak,Sunday,June
2024-06-02 18:00:00,28,222,4,1,255,19,681,3,1,704,29.6,68,3,2.5,959,True,18,47,903,7,2,2024-06-02,False,True,False,0.9416058394160584,0.049009384775808136,0.0072992700729927005,0.0020855057351407717,Peak,Sunday,June
2024-06-02 19:00:00,62,600,8,1,671,62,651,8,0,721,28.3,83,3,2.2,1392,True,19,124,1251,16,1,2024-06-02,False,True,True,0.8987068965517241,0.08908045977011494,0.011494252873563218,0.0007183908045977011,Peak,Sunday,June
2024-06-02 20:00:00,75,742,11,2,830,50,503,6,1,560,27.1,80,3,5.8,1390,True,20,125,1245,17,3,2024-06-02,False,True,True,0.89568345323741,0.08992805755395683,0.01223021582733813,0.002158273381294964,Shoulder,Sunday,June
2024-06-02 21:00:00,46,425,7,1,479,48,662,6,1,717,26.8,92,3,4.7,1196,True,21,94,1087,13,2,2024-06-02,False,True,False,0.9088628762541806,0.07859531772575251,0.010869565217391304,0.0016722408026755853,Shoulder,Sunday,June
2024-06-02 22:00:00,62,566,9,2,639,40,425,6,0,471,26.9,90,3,6.8,1110,True,22,102,991,15,2,2024-06-02,False,True,False,0.8927927927927928,0.0918918918918919,0.013513513513513514,0.0018018018018018018,Shoulder,Sunday,June
2024-06-02 23:00:00,26,208,5,1,240,24,519,4,0,547,25.9,95,3,3.0,787,True,23,50,727,9,1,2024-06-02,False,True,False,0.9237611181702668,0.06353240152477764,0.011435832274459974,0.0012706480304955528,Shoulder,Sunday,June
2024-06-03 00:00:00,18,188,4,0,210,14,152,2,0,168,25.9,95,51,4.8,378,False,0,32,340,6,0,2024-06-03,True,True,False,0.8994708994708994,0.08465608465608465,0.015873015873015872,0.0,Off-Peak,Monday,June
2024-06-03 01:00:00,16,295,7,1,319,14,173,2,0,189,25.6,97,3,1.6,508,False,1,30,468,9,1,2024-06-03,True,True,False,0.9212598425196851,0.05905511811023622,0.017716535433070866,0.001968503937007874,Off-Peak,Monday,June
2024-06-03 02:00:00,26,382,5,1,414,37,198,3,1,239,25.1,95,53,3.1,653,False,2,63,580,8,2,2024-06-03,True,True,False,0.888208269525268,0.09647779479326186,0.01225114854517611,0.0030627871362940277,Off-Peak,Monday,June
2024-06-03 03:00:00,33,444,4,1,482,22,236,2,0,260,25.4,94,3,8.8,742,False,3,55,680,6,1,2024-06-03,True,True,False,0.9164420485175202,0.07412398921832884,0.008086253369272238,0.0013477088948787063,Off-Peak,Monday,June
2024-06-03 04:00:00,37,286,7,1,331,27,337,1,0,365,25.5,92,3,6.4,696,False,4,64,623,8,1,2024-06-03,True,True,False,0.8951149425287356,0.09195402298850575,0.011494252873563218,0.0014367816091954023,Off-Peak,Monday,June
2024-06-03 05:00:00,44,524,5,1,574,52,340,1,0,393,24.6,96,3,4.7,967,False,5,96,864,6,1,2024-06-03,True,True,False,0.8934850051706308,0.09927611168562564,0.0062047569803516025,0.001034126163391934,Shoulder,Monday,June
2024-06-03 06:00:00,82,732,3,1,818,57,565,2,0,624,24.7,96,51,3.7,1442,False,6,139,1297,5,1,2024-06-03,True,True,True,0.8994452149791956,0.09639389736477115,0.0034674063800277394,0.0006934812760055479,Shoulder,Monday,June
2024-06-03 07:00:00,65,705,4,1,775,52,942,2,1,997,24.8,97,51,4.3,1772,False,7,117,1647,6,2,2024-06-03,True,True,True,0.9294582392776524,0.06602708803611738,0.003386004514672686,0.001128668171557562,Peak,Monday,June
2024-06-03 08:00:00,46,514,5,1,566,48,678,2,0,728,25.3,96,3,3.5,1294,False,8,94,1192,7,1,2024-06-03,True,True,False,0.9211746522411128,0.07264296754250386,0.005409582689335394,0.0007727975270479134,Peak,Monday,June
2024-06-03 09:00:00,76,385,4,1,466,47,543,1,2,593,25.2,96,63,1.8,1059,False,9,123,928,5,3,2024-06-03,True,True,False,0.8762983947119924,0.11614730878186968,0.004721435316336166,0.0028328611898017,Shoulder,Monday,June
2024-06-03 10:00:00,33,379,6,1,419,51,562,2,1,616,25.8,93,51,8.4,1035,False,10,84,941,8,2,2024-06-03,True,True,False,0.9091787439613527,0.08115942028985507,0.007729468599033816,0.001932367149758454,Shoulder,Monday,June
2024-06-03 11:00:00,33,612,4,1,650,48,438,2,1,489,27.2,88,51,8.9,1139,False,11,81,1050,6,2,2024-06-03,True,True,False,0.9218612818261633,0.07111501316944688,0.0052677787532923615,0.001755926251097454,Peak,Monday,June
2024-06-03 12:00:00,64,585,7,1,657,31,306,1,1,339,29.3,82,51,7.7,996,False,12,95,891,8,2,2024-06-03,True,True,False,0.8945783132530121,0.09538152610441768,0.008032128514056224,0.002008032128514056,Peak,Monday,June
2024-06-03 13:00:00,53,580,10,2,645,50,495,3,1,549,29.8,79,51,5.9,1194,False,13,103,1075,13,3,2024-06-03,True,True,False,0.9003350083752094,0.08626465661641541,0.010887772194304857,0.002512562814070352,Peak,Monday,June
2024-06-03 14:00:00,50,654,6,1,711,52,622,3,1,678,30.3,76,3,4.1,1389,False,14,102,1276,9,2,2024-06-03,True,True,True,0.9186465082793377,0.0734341252699784,0.0064794816414686825,0.0014398848092152627,Peak,Monday,June
2024-06-03 15:00:00,35,691,5,1,732,31,605,3,1,640,30.9,74,3,1.6,1372,False,15,66,1296,8,2,2024-06-03,True,True,False,0.9446064139941691,0.048104956268221574,0.0058309037900874635,0.0014577259475218659,Peak,Monday,June
2024-06-03 16:00:00,64,965,8,1,1038,80,937,3,1,1021,30.6,74,51,5.5,2059,False,16,144,1902,11,2,2024-06-03,True,True,True,0.9237493929091792,0.06993686255463817,0.005342399222923749,0.0009713453132588635,Peak,Monday,June
2024-06-03 17:00:00,54,869,7,1,931,84,621,2,1,708,29.6,77,61,5.4,1639,False,17,138,1490,9,2,2024-06-03,True,True,True,0.9090909090909091,0.08419768151311775,0.005491153142159854,0.0012202562538133007,Peak,Monday,June
2024-06-03 18:00:00,57,817,7,1,882,44,646,2,0,692,26.8,89,63,6.4,1574,False,18,101,1463,9,1,2024-06-03,True,True,True,0.9294790343074968,0.06416772554002541,0.005717916137229987,0.0006353240152477764,Peak,Monday,June
2024-06-03 19:00:00,75,765,8,1,849,56,581,3,1,641,26.3,91,51,4.7,1490,False,19,131,1346,11,2,2024-06-03,True,True,True,0.9033557046979865,0.08791946308724832,0.00738255033557047,0.0013422818791946308,Peak,Monday,June
2024-06-03 20:00:00,59,740,4,1,804,26,524,2,0,552,26.2,91,51,2.3,1356,False,20,85,1264,6,1,2024-06-03,True,True,False,0.9321533923303835,0.06268436578171091,0.004424778761061947,0.0007374631268436578,Shoulder,Monday,June
2024-06-03 21:00:00,63,387,10,1,461,28,315,2,0,345,26.2,97,51,6.5,806,False,21,91,702,12,1,2024-06-03,True,True,False,0.8709677419354839,0.11290322580645161,0.01488833746898263,0.0012406947890818859,Shoulder,Monday,June
2024-06-03 22:00:00,28,239,10,1,278,20,259,6,0,285,25.9,97,3,3.3,563,False,22,48,498,16,1,2024-06-03,True,True,False,0.8845470692717584,0.0852575488454707,0.028419182948490232,0.0017761989342806395,Shoulder,Monday,June
2024-06-03 23:00:00,21,254,4,1,280,17,281,5,0,303,25.5,98,3,2.9,583,False,23,38,535,9,1,2024-06-03,True,True,False,0.9176672384219554,0.06518010291595197,0.015437392795883362,0.0017152658662092624,Shoulder,Monday,June
2024-06-04 00:00:00,32,189,3,0,224,22,237,0,0,259,25.5,97,3,2.9,483,False,0,54,426,3,0,2024-06-04,False,False,False,0.8819875776397516,0.11180124223602485,0.006211180124223602,0.0,Off-Peak,Tuesday,June
2024-06-04 01:00:00,34,295,3,0,332,28,262,1,0,291,25.4,97,55,8.9,623,False,1,62,557,4,0,2024-06-04,False,False,False,0.8940609951845907,0.09951845906902086,0.006420545746388443,0.0,Off-Peak,Tuesday,June
2024-06-04 02:00:00,27,253,2,0,282,46,277,1,0,324,24.7,96,61,5.5,606,False,2,73,530,3,0,2024-06-04,False,False,False,0.8745874587458746,0.12046204620462046,0.0049504950495049506,0.0,Off-Peak,Tuesday,June
2024-06-04 03:00:00,71,305,6,1,383,70,305,2,0,377,24.4,97,3,6.5,760,False,3,141,610,8,1,2024-06-04,False,False,False,0.8026315789473685,0.18552631578947368,0.010526315789473684,0.0013157894736842105,Off-Peak,Tuesday,June
2024-06-04 04:00:00,27,410,4,1,442,29,457,1,0,487,24.3,97,3,4.8,929,False,4,56,867,5,1,2024-06-04,False,False,False,0.9332615715823466,0.060279870828848225,0.005382131324004306,0.001076426264800861,Off-Peak,Tuesday,June
2024-06-04 05:00:00,34,640,4,1,679,47,669,2,0,718,24.1,97,3,6.0,1397,False,5,81,1309,6,1,2024-06-04,False,False,True,0.937007874015748,0.05798138869005011,0.004294917680744453,0.0007158196134574087,Shoulder,Tuesday,June
2024-06-04 06:00:00,71,815,7,1,894,20,769,1,0,790,23.9,97,3,5.0,1684,False,6,91,1584,8,1,2024-06-04,False,False,True,0.9406175771971497,0.054038004750593824,0.004750593824228029,0.0005938242280285036,Shoulder,Tuesday,June
2024-06-04 07:00:00,55,760,5,1,821,32,720,1,0,753,23.5,98,2,3.6,1574,False,7,87,1480,6,1,2024-06-04,False,False,True,0.940279542566709,0.055273189326556546,0.0038119440914866584,0.0006353240152477764,Peak,Tuesday,June
2024-06-04 08:00:00,58,733,6,1,798,43,351,1,0,395,24.8,95,3,2.9,1193,False,8,101,1084,7,1,2024-06-04,False,False,False,0.9086336965632859,0.08466051969823973,0.00586756077116513,0.0008382229673093043,Peak,Tuesday,June
2024-06-04 09:00:00,42,609,4,1,656,27,520,3,0,550,28.0,89,3,5.1,1206,False,9,69,1129,7,1,2024-06-04,False,False,False,0.9361525704809287,0.05721393034825871,0.005804311774461028,0.0008291873963515755,Shoulder,Tuesday,June
2024-06-04 10:00:00,17,668,4,1,690,50,531,2,0,583,29.5,81,3,2.9,1273,False,10,67,1199,6,1,2024-06-04,False,False,False,0.9418695993715632,0.05263157894736842,0.004713275726630008,0.0007855459544383347,Shoulder,Tuesday,June
2024-06-04 11:00:00,46,494,5,1,546,16,529,1,0,546,30.5,75,51,6.9,1092,False,11,62,1023,6,1,2024-06-04,False,False,False,0.9368131868131868,0.056776556776556776,0.005494505494505495,0.0009157509157509158,Peak,Tuesday,June
2024-06-04 12:00:00,26,539,3,1,569,26,344,2,1,373,28.3,83,61,11.7,942,False,12,52,883,5,2,2024-06-04,False,False,False,0.9373673036093418,0.055201698513800426,0.005307855626326964,0.0021231422505307855,Peak,Tuesday,June
2024-06-04 13:00:00,31,371,3,1,406,66,321,2,0,389,29.2,83,51,8.0,795,False,13,97,692,5,1,2024-06-04,False,False,False,0.8704402515723271,0.1220125786163522,0.006289308176100629,0.0012578616352201257,Peak,Tuesday,June
2024-06-04 14:00:00,72,337,6,1,416,72,440,2,0,514,29.8,79,51,8.8,930,False,14,144,777,8,1,2024-06-04,False,False,False,0.8354838709677419,0.15483870967741936,0.008602150537634409,0.001075268817204301,Peak,Tuesday,June
2024-06-04 15:00:00,67,642,6,1,716,61,415,2,0,478,29.9,79,51,10.5,1194,False,15,128,1057,8,1,2024-06-04,False,False,False,0.8852596314907872,0.10720268006700168,0.006700167504187605,0.0008375209380234506,Peak,Tuesday,June
2024-06-04 16:00:00,55,624,6,1,686,32,871,1,1,905,28.6,80,53,6.6,1591,False,16,87,1495,7,2,2024-06-04,False,False,True,0.9396605908233815,0.054682589566310495,0.0043997485857950975,0.001257071024512885,Peak,Tuesday,June
2024-06-04 17:00:00,21,828,3,1,853,24,774,2,1,801,28.0,83,51,3.7,1654,False,17,45,1602,5,2,2024-06-04,False,False,True,0.9685610640870617,0.02720677146311971,0.003022974607013301,0.0012091898428053204,Peak,Tuesday,June
2024-06-04 18:00:00,67,761,8,1,837,64,674,3,1,742,27.3,86,51,6.0,1579,False,18,131,1435,11,2,2024-06-04,False,False,True,0.9088030398986701,0.08296390120329322,0.006966434452184927,0.001266624445851805,Peak,Tuesday,June
2024-06-04 19:00:00,56,512,8,1,577,39,415,2,1,457,26.5,92,51,5.2,1034,False,19,95,927,10,2,2024-06-04,False,False,False,0.8965183752417795,0.09187620889748549,0.009671179883945842,0.0019342359767891683,Peak,Tuesday,June
2024-06-04 20:00:00,46,380,7,1,434,41,327,2,1,371,25.9,97,51,2.9,805,False,20,87,707,9,2,2024-06-04,False,False,False,0.8782608695652174,0.10807453416149068,0.011180124223602485,0.002484472049689441,Shoulder,Tuesday,June
2024-06-04 21:00:00,26,311,4,1,342,39,205,2,1,247,26.9,95,51,7.6,589,False,21,65,516,6,2,2024-06-04,False,False,False,0.8760611205432938,0.11035653650254669,0.010186757215619695,0.003395585738539898,Shoulder,Tuesday,June
2024-06-04 22:00:00,58,301,8,2,369,31,252,3,1,287,26.0,93,61,9.3,656,False,22,89,553,11,3,2024-06-04,False,False,False,0.8429878048780488,0.13567073170731708,0.01676829268292683,0.004573170731707317,Shoulder,Tuesday,June
2024-06-04 23:00:00,14,149,3,1,167,85,172,7,1,265,26.1,95,51,4.7,432,False,23,99,321,10,2,2024-06-04,False,False,False,0.7430555555555556,0.22916666666666666,0.023148148148148147,0.004629629629629629,Shoulder,Tuesday,June
2024-06-05 00:00:00,22,175,8,0,205,13,197,1,0,211,25.6,97,51,7.4,416,False,0,35,372,9,0,2024-06-05,False,False,False,0.8942307692307693,0.08413461538461539,0.021634615384615384,0.0,Off-Peak,Wednesday,June
2024-06-05 01:00:00,28,251,4,0,283,16,234,2,0,252,24.9,97,51,9.4,535,False,1,44,485,6,0,2024-06-05,False,False,False,0.9065420560747663,0.08224299065420561,0.011214953271028037,0.0,Off-Peak,Wednesday,June
2024-06-05 02:00:00,30,311,6,0,347,29,288,2,0,319,23.9,99,63,12.0,666,False,2,59,599,8,0,2024-06-05,False,False,False,0.8993993993993994,0.08858858858858859,0.012012012012012012,0.0,Off-Peak,Wednesday,June
2024-06-05 03:00:00,35,631,8,0,674,20,342,2,1,365,23.7,96,63,11.5,1039,False,3,55,973,10,1,2024-06-05,False,False,False,0.9364773820981713,0.05293551491819057,0.009624639076034648,0.0009624639076034649,Off-Peak,Wednesday,June
2024-06-05 04:00:00,34,691,8,0,733,34,490,1,1,526,23.8,96,51,5.7,1259,False,4,68,1181,9,1,2024-06-05,False,False,False,0.938046068308181,0.054011119936457505,0.007148530579825258,0.0007942811755361397,Off-Peak,Wednesday,June
2024-06-05 05:00:00,41,653,7,1,702,44,538,1,0,583,23.8,96,51,7.4,1285,False,5,85,1191,8,1,2024-06-05,False,False,False,0.9268482490272374,0.06614785992217899,0.0062256809338521405,0.0007782101167315176,Shoulder,Wednesday,June
2024-06-05 06:00:00,81,723,7,1,812,45,789,1,1,836,23.6,97,3,7.7,1648,False,6,126,1512,8,2,2024-06-05,False,False,True,0.9174757281553398,0.07645631067961164,0.0048543689320388345,0.0012135922330097086,Shoulder,Wednesday,June
2024-06-05 07:00:00,51,915,7,1,974,45,744,2,1,792,23.5,97,3,6.6,1766,False,7,96,1659,9,2,2024-06-05,False,False,True,0.9394110985277463,0.05436013590033975,0.005096262740656852,0.0011325028312570782,Peak,Wednesday,June
2024-06-05 08:00:00,53,644,5,0,702,67,636,2,0,705,24.2,97,3,5.1,1407,False,8,120,1280,7,0,2024-06-05,False,False,True,0.9097370291400142,0.08528784648187633,0.004975124378109453,0.0,Peak,Wednesday,June
2024-06-05 09:00:00,63,370,4,1,438,63,537,2,0,602,26.9,92,3,0.5,1040,False,9,126,907,6,1,2024-06-05,False,False,False,0.8721153846153846,0.12115384615384615,0.0057692307692307696,0.0009615384615384616,Shoulder,Wednesday,June
2024-06-05 10:00:00,53,390,5,0,448,60,539,1,1,601,28.6,85,3,4.7,1049,False,10,113,929,6,1,2024-06-05,False,False,False,0.8856053384175405,0.10772163965681601,0.005719733079122974,0.0009532888465204957,Shoulder,Wednesday,June
2024-06-05 11:00:00,52,494,6,1,553,54,570,2,0,626,29.7,81,51,9.1,1179,False,11,106,1064,8,1,2024-06-05,False,False,False,0.9024597116200169,0.0899067005937235,0.006785411365564037,0.0008481764206955047,Peak,Wednesday,June
2024-06-05 12:00:00,56,625,5,0,686,33,675,1,2,711,30.6,76,51,9.7,1397,False,12,89,1300,6,2,2024-06-05,False,False,True,0.9305654974946314,0.06370794559770938,0.004294917680744453,0.0014316392269148174,Peak,Wednesday,June
2024-06-05 13:00:00,61,753,10,2,826,43,775,1,0,819,31.0,72,51,10.8,1645,False,13,104,1528,11,2,2024-06-05,False,False,True,0.9288753799392098,0.06322188449848025,0.006686930091185411,0.0012158054711246201,Peak,Wednesday,June
2024-06-05 14:00:00,23,658,4,1,686,49,401,1,1,452,31.0,73,3,11.6,1138,False,14,72,1059,5,2,2024-06-05,False,False,False,0.9305799648506151,0.0632688927943761,0.004393673110720563,0.0017574692442882249,Peak,Wednesday,June
2024-06-05 15:00:00,66,800,9,0,875,57,560,3,0,620,30.9,73,0,10.7,1495,False,15,123,1360,12,0,2024-06-05,False,False,True,0.9096989966555183,0.0822742474916388,0.008026755852842809,0.0,Peak,Wednesday,June
2024-06-05 16:00:00,66,785,5,0,856,66,679,2,0,747,30.8,74,1,10.5,1603,False,16,132,1464,7,0,2024-06-05,False,False,True,0.9132875857766688,0.08234560199625701,0.004366812227074236,0.0,Peak,Wednesday,June
2024-06-05 17:00:00,71,813,11,1,896,50,704,3,0,757,30.5,74,3,9.1,1653,False,17,121,1517,14,1,2024-06-05,False,False,True,0.9177253478523896,0.07320024198427103,0.008469449485783424,0.0006049606775559589,Peak,Wednesday,June
2024-06-05 18:00:00,67,666,11,1,745,59,403,4,0,466,30.1,74,3,6.5,1211,False,18,126,1069,15,1,2024-06-05,False,False,False,0.8827415359207267,0.10404624277456648,0.012386457473162676,0.0008257638315441783,Peak,Wednesday,June
2024-06-05 19:00:00,57,363,10,2,432,42,446,2,0,490,29.1,81,2,4.1,922,False,19,99,809,12,2,2024-06-05,False,False,False,0.8774403470715835,0.10737527114967461,0.013015184381778741,0.0021691973969631237,Peak,Wednesday,June
2024-06-05 20:00:00,34,393,7,0,434,36,395,2,1,434,27.9,87,3,4.6,868,False,20,70,788,9,1,2024-06-05,False,False,False,0.9078341013824884,0.08064516129032258,0.010368663594470046,0.001152073732718894,Shoulder,Wednesday,June
2024-06-05 21:00:00,26,331,5,0,362,26,203,3,1,233,28.7,88,2,7.0,595,False,21,52,534,8,1,2024-06-05,False,False,False,0.8974789915966387,0.08739495798319327,0.013445378151260505,0.0016806722689075631,Shoulder,Wednesday,June
2024-06-05 22:00:00,20,246,10,0,276,18,177,3,0,198,28.4,90,1,7.5,474,False,22,38,423,13,0,2024-06-05,False,False,False,0.8924050632911392,0.08016877637130802,0.027426160337552744,0.0,Shoulder,Wednesday,June
2024-06-05 23:00:00,16,239,5,0,260,15,154,6,0,175,28.2,91,1,8.2,435,False,23,31,393,11,0,2024-06-05,False,False,False,0.903448275862069,0.07126436781609195,0.02528735632183908,0.0,Shoulder,Wednesday,June
2024-06-06 00:00:00,63,287,10,0,360,14,182,0,0,196,27.7,93,1,7.0,556,False,0,77,469,10,0,2024-06-06,False,False,False,0.8435251798561151,0.13848920863309352,0.017985611510791366,0.0,Off-Peak,Thursday,June
2024-06-06 01:00:00,41,223,7,0,271,25,205,0,0,230,25.7,95,63,14.5,501,False,1,66,428,7,0,2024-06-06,False,False,False,0.8542914171656687,0.1317365269461078,0.013972055888223553,0.0,Off-Peak,Thursday,June
2024-06-06 02:00:00,74,252,11,0,337,26,304,0,0,330,24.7,95,55,3.6,667,False,2,100,556,11,0,2024-06-06,False,False,False,0.8335832083958021,0.14992503748125938,0.01649175412293853,0.0,Off-Peak,Thursday,June
2024-06-06 03:00:00,39,359,7,0,405,33,327,0,0,360,24.5,97,3,1.8,765,False,3,72,686,7,0,2024-06-06,False,False,False,0.8967320261437909,0.09411764705882353,0.009150326797385621,0.0,Off-Peak,Thursday,June
2024-06-06 04:00:00,27,574,5,0,606,57,403,0,1,461,24.4,98,3,4.0,1067,False,4,84,977,5,1,2024-06-06,False,False,False,0.915651358950328,0.07872539831302718,0.004686035613870665,0.0009372071227741331,Off-Peak,Thursday,June
2024-06-06 05:00:00,60,663,9,0,732,59,577,1,0,637,24.0,97,63,11.7,1369,False,5,119,1240,10,0,2024-06-06,False,False,False,0.9057706355003652,0.08692476260043827,0.007304601899196494,0.0,Shoulder,Thursday,June
2024-06-06 06:00:00,54,797,8,0,859,38,729,4,2,773,23.7,96,65,11.8,1632,False,6,92,1526,12,2,2024-06-06,False,False,True,0.9350490196078431,0.056372549019607844,0.007352941176470588,0.0012254901960784314,Shoulder,Thursday,June
2024-06-06 07:00:00,24,773,5,0,802,63,826,2,0,891,24.0,96,51,5.4,1693,False,7,87,1599,7,0,2024-06-06,False,False,True,0.9444772593030124,0.05138806851742469,0.004134672179562906,0.0,Peak,Thursday,June
2024-06-06 08:00:00,34,500,7,0,541,44,671,10,2,727,24.2,96,53,11.4,1268,False,8,78,1171,17,2,2024-06-06,False,False,False,0.9235015772870663,0.061514195583596214,0.013406940063091483,0.0015772870662460567,Peak,Thursday,June
2024-06-06 09:00:00,72,640,11,1,724,38,578,2,1,619,27.6,92,3,8.4,1343,False,9,110,1218,13,2,2024-06-06,False,False,False,0.9069247952345495,0.08190618019359643,0.00967982129560685,0.0014892032762472078,Shoulder,Thursday,June
2024-06-06 10:00:00,37,421,7,1,466,50,493,9,1,553,29.0,86,3,6.5,1019,False,10,87,914,16,2,2024-06-06,False,False,False,0.8969578017664377,0.08537782139352307,0.015701668302257114,0.001962708537782139,Shoulder,Thursday,June
2024-06-06 11:00:00,22,446,5,1,474,23,459,8,0,490,30.4,77,51,6.7,964,False,11,45,905,13,1,2024-06-06,False,False,False,0.9387966804979253,0.046680497925311204,0.013485477178423237,0.001037344398340249,Peak,Thursday,June
2024-06-06 12:00:00,25,393,6,1,425,35,475,2,1,513,31.4,70,51,4.7,938,False,12,60,868,8,2,2024-06-06,False,False,False,0.9253731343283582,0.06396588486140725,0.008528784648187633,0.0021321961620469083,Peak,Thursday,June
2024-06-06 13:00:00,34,377,6,1,418,29,444,11,2,486,31.3,72,51,6.6,904,False,13,63,821,17,3,2024-06-06,False,False,False,0.9081858407079646,0.06969026548672566,0.018805309734513276,0.00331858407079646,Peak,Thursday,June
2024-06-06 14:00:00,87,326,14,1,428,43,494,3,0,540,28.4,83,63,5.8,968,False,14,130,820,17,1,2024-06-06,False,False,False,0.8471074380165289,0.13429752066115702,0.01756198347107438,0.0010330578512396695,Peak,Thursday,June
2024-06-06 15:00:00,86,646,13,1,746,36,557,8,0,601,28.5,82,51,2.2,1347,False,15,122,1203,21,1,2024-06-06,False,False,False,0.8930957683741648,0.09057164068299926,0.015590200445434299,0.0007423904974016332,Peak,Thursday,June
2024-06-06 16:00:00,78,912,12,1,1003,42,767,7,1,817,28.8,80,51,5.8,1820,False,16,120,1679,19,2,2024-06-06,False,False,True,0.9225274725274726,0.06593406593406594,0.010439560439560439,0.001098901098901099,Peak,Thursday,June
2024-06-06 17:00:00,64,894,12,2,972,63,742,3,1,809,28.6,81,3,6.4,1781,False,17,127,1636,15,3,2024-06-06,False,False,True,0.9185850645704661,0.07130825379000562,0.008422234699606962,0.0016844469399213925,Peak,Thursday,June
2024-06-06 18:00:00,24,821,6,1,852,46,447,3,1,497,27.9,83,51,7.0,1349,False,18,70,1268,9,2,2024-06-06,False,False,False,0.9399555226093402,0.05189028910303929,0.006671608598962194,0.0014825796886582653,Peak,Thursday,June
2024-06-06 19:00:00,34,762,8,1,805,38,360,4,1,403,27.0,88,51,7.4,1208,False,19,72,1122,12,2,2024-06-06,False,False,False,0.9288079470198676,0.059602649006622516,0.009933774834437087,0.0016556291390728477,Peak,Thursday,June
2024-06-06 20:00:00,50,426,11,1,488,31,352,0,0,383,26.6,90,51,6.0,871,False,20,81,778,11,1,2024-06-06,False,False,False,0.8932261768082663,0.09299655568312284,0.012629161882893225,0.001148105625717566,Shoulder,Thursday,June
2024-06-06 21:00:00,38,348,9,1,396,28,304,0,0,332,26.3,93,3,3.3,728,False,21,66,652,9,1,2024-06-06,False,False,False,0.8956043956043956,0.09065934065934066,0.012362637362637362,0.0013736263736263737,Shoulder,Thursday,June
2024-06-06 22:00:00,48,246,12,1,307,23,298,0,0,321,26.5,92,3,6.6,628,False,22,71,544,12,1,2024-06-06,False,False,False,0.8662420382165605,0.11305732484076433,0.01910828025477707,0.0015923566878980893,Shoulder,Thursday,June
2024-06-06 23:00:00,75,261,15,1,352,13,288,0,0,301,26.3,91,3,5.9,653,False,23,88,549,15,1,2024-06-06,False,False,False,0.8407350689127105,0.13476263399693722,0.022970903522205207,0.0015313935681470138,Shoulder,Thursday,June
2024-06-07 00:00:00,18,172,5,0,195,37,195,2,0,234,25.8,90,3,5.8,429,False,0,55,367,7,0,2024-06-07,False,False,False,0.8554778554778555,0.1282051282051282,0.016317016317016316,0.0,Off-Peak,Friday,June
2024-06-07 01:00:00,19,240,8,0,267,30,265,1,0,296,25.5,88,3,6.4,563,False,1,49,505,9,0,2024-06-07,False,False,False,0.8969804618117229,0.08703374777975133,0.015985790408525755,0.0,Off-Peak,Friday,June
2024-06-07 02:00:00,25,210,7,0,242,58,286,3,0,347,25.1,87,3,7.4,589,False,2,83,496,10,0,2024-06-07,False,False,False,0.8421052631578947,0.14091680814940577,0.01697792869269949,0.0,Off-Peak,Friday,June
2024-06-07 03:00:00,26,283,3,0,312,40,317,3,0,360,25.0,85,3,9.5,672,False,3,66,600,6,0,2024-06-07,False,False,False,0.8928571428571429,0.09821428571428571,0.008928571428571428,0.0,Off-Peak,Friday,June
2024-06-07 04:00:00,24,492,6,0,522,39,340,3,0,382,24.8,82,3,7.4,904,False,4,63,832,9,0,2024-06-07,False,False,False,0.9203539823008849,0.06969026548672566,0.00995575221238938,0.0,Off-Peak,Friday,June
2024-06-07 05:00:00,36,413,7,0,456,48,481,4,0,533,24.6,82,1,8.5,989,False,5,84,894,11,0,2024-06-07,False,False,False,0.9039433771486349,0.08493427704752275,0.011122345803842264,0.0,Shoulder,Friday,June
2024-06-07 06:00:00,92,619,11,0,722,61,547,3,0,611,24.3,83,1,5.2,1333,False,6,153,1166,14,0,2024-06-07,False,False,False,0.8747186796699175,0.11477869467366841,0.010502625656414103,0.0,Shoulder,Friday,June
2024-06-07 07:00:00,89,706,5,0,800,18,685,4,0,707,24.0,88,3,4.8,1507,False,7,107,1391,9,0,2024-06-07,False,False,True,0.9230258792302588,0.0710019907100199,0.005972130059721301,0.0,Peak,Friday,June
2024-06-07 08:00:00,56,927,3,0,986,45,677,3,0,725,24.9,85,3,4.6,1711,False,8,101,1604,6,0,2024-06-07,False,False,True,0.9374634716540035,0.05902980713033314,0.0035067212156633548,0.0,Peak,Friday,June
2024-06-07 09:00:00,65,542,3,0,610,16,804,2,0,822,26.9,81,2,1.3,1432,False,9,81,1346,5,0,2024-06-07,False,False,True,0.9399441340782123,0.05656424581005587,0.0034916201117318434,0.0,Shoulder,Friday,June
2024-06-07 10:00:00,50,837,9,0,896,64,599,3,0,666,28.6,72,2,1.4,1562,False,10,114,1436,12,0,2024-06-07,False,False,True,0.9193341869398207,0.07298335467349552,0.0076824583866837385,0.0,Shoulder,Friday,June
2024-06-07 11:00:00,44,923,5,0,972,24,511,2,0,537,29.6,65,3,1.1,1509,False,11,68,1434,7,0,2024-06-07,False,False,True,0.9502982107355865,0.04506295559973492,0.004638833664678595,0.0,Peak,Friday,June
2024-06-07 12:00:00,68,642,7,0,717,24,454,2,0,480,30.8,61,3,4.0,1197,False,12,92,1096,9,0,2024-06-07,False,False,False,0.9156223893065998,0.07685881370091896,0.007518796992481203,0.0,Peak,Friday,June
2024-06-07 13:00:00,65,710,8,1,784,70,477,4,0,551,31.3,60,3,5.9,1335,False,13,135,1187,12,1,2024-06-07,False,False,False,0.8891385767790262,0.10112359550561797,0.008988764044943821,0.000749063670411985,Peak,Friday,June
2024-06-07 14:00:00,73,228,4,1,306,39,442,2,0,483,31.4,61,3,7.9,789,False,14,112,670,6,1,2024-06-07,False,False,False,0.8491761723700887,0.14195183776932827,0.0076045627376425855,0.0012674271229404308,Peak,Friday,June
2024-06-07 15:00:00,95,375,5,1,476,31,410,2,0,443,31.3,61,3,8.9,919,False,15,126,785,7,1,2024-06-07,False,False,False,0.8541893362350381,0.13710554951033732,0.007616974972796518,0.001088139281828074,Peak,Friday,June
2024-06-07 16:00:00,107,1116,12,1,1236,30,761,2,0,793,30.9,61,3,10.3,2029,False,16,137,1877,14,1,2024-06-07,False,False,True,0.925086249383933,0.06752094627895515,0.006899950714637753,0.0004928536224741252,Peak,Friday,June
2024-06-07 17:00:00,84,998,9,1,1092,53,622,3,0,678,30.2,63,2,9.3,1770,False,17,137,1620,12,1,2024-06-07,False,False,True,0.9152542372881356,0.07740112994350283,0.006779661016949152,0.0005649717514124294,Peak,Friday,June
2024-06-07 18:00:00,76,994,9,1,1080,29,663,3,0,695,29.6,66,3,6.3,1775,False,18,105,1657,12,1,2024-06-07,False,False,True,0.9335211267605634,0.059154929577464786,0.0067605633802816905,0.0005633802816901409,Peak,Friday,June
2024-06-07 19:00:00,61,771,6,2,840,57,532,4,0,593,28.6,78,3,3.2,1433,False,19,118,1303,10,2,2024-06-07,False,False,True,0.9092812281926029,0.08234473133286811,0.006978367062107467,0.0013956734124214933,Peak,Friday,June
2024-06-07 20:00:00,38,662,8,1,709,35,365,4,2,406,27.9,81,3,4.7,1115,False,20,73,1027,12,3,2024-06-07,False,False,False,0.9210762331838565,0.06547085201793722,0.010762331838565023,0.0026905829596412557,Shoulder,Friday,June
2024-06-07 21:00:00,24,208,11,1,244,27,319,2,1,349,27.9,86,3,5.2,593,False,21,51,527,13,2,2024-06-07,False,False,False,0.8887015177065767,0.08600337268128162,0.021922428330522766,0.003372681281618887,Shoulder,Friday,June
2024-06-07 22:00:00,18,246,4,1,269,55,281,5,1,342,28.2,83,3,2.9,611,False,22,73,527,9,2,2024-06-07,False,False,False,0.8625204582651391,0.11947626841243862,0.014729950900163666,0.0032733224222585926,Shoulder,Friday,June
2024-06-07 23:00:00,18,184,5,1,208,50,171,5,1,227,27.1,90,3,1.1,435,False,23,68,355,10,2,2024-06-07,False,False,False,0.8160919540229885,0.15632183908045977,0.022988505747126436,0.004597701149425287,Shoulder,Friday,June
2024-06-08 00:00:00,18,165,7,0,190,16,181,1,0,198,27.3,85,3,0.4,388,True,0,34,346,8,0,2024-06-08,False,False,False,0.8917525773195877,0.08762886597938144,0.020618556701030927,0.0,Off-Peak,Saturday,June
2024-06-08 01:00:00,16,175,7,0,198,22,207,1,0,230,26.5,91,3,1.6,428,True,1,38,382,8,0,2024-06-08,False,False,False,0.8925233644859814,0.08878504672897196,0.018691588785046728,0.0,Off-Peak,Saturday,June
2024-06-08 02:00:00,24,235,4,0,263,39,361,2,0,402,26.3,95,3,2.4,665,True,2,63,596,6,0,2024-06-08,False,False,False,0.8962406015037594,0.09473684210526316,0.009022556390977444,0.0,Off-Peak,Saturday,June
2024-06-08 03:00:00,25,231,11,0,267,22,219,1,0,242,25.8,92,2,3.1,509,True,3,47,450,12,0,2024-06-08,False,False,False,0.8840864440078585,0.09233791748526522,0.023575638506876228,0.0,Off-Peak,Saturday,June
2024-06-08 04:00:00,35,559,5,0,599,32,348,1,0,381,25.6,96,3,8.6,980,True,4,67,907,6,0,2024-06-08,False,False,False,0.9255102040816326,0.06836734693877551,0.006122448979591836,0.0,Off-Peak,Saturday,June
2024-06-08 05:00:00,44,512,8,0,564,42,299,1,0,342,25.8,95,3,5.1,906,True,5,86,811,9,0,2024-06-08,False,False,False,0.8951434878587197,0.09492273730684327,0.009933774834437087,0.0,Shoulder,Saturday,June
2024-06-08 06:00:00,64,643,6,0,713,63,437,1,0,501,25.5,95,63,8.4,1214,True,6,127,1080,7,0,2024-06-08,False,False,False,0.8896210873146623,0.10461285008237232,0.005766062602965404,0.0,Shoulder,Saturday,June
2024-06-08 07:00:00,83,874,5,0,962,74,646,1,0,721,24.6,94,63,9.7,1683,True,7,157,1520,6,0,2024-06-08,False,False,True,0.9031491384432561,0.0932857991681521,0.0035650623885918,0.0,Peak,Saturday,June
2024-06-08 08:00:00,82,814,12,0,908,71,455,1,0,527,24.3,97,55,4.2,1435,True,8,153,1269,13,0,2024-06-08,False,False,True,0.8843205574912892,0.10662020905923345,0.009059233449477353,0.0,Peak,Saturday,June
2024-06-08 09:00:00,91,911,12,0,1014,56,749,2,0,807,25.4,93,51,3.7,1821,True,9,147,1660,14,0,2024-06-08,False,False,True,0.9115870400878638,0.08072487644151564,0.007688083470620538,0.0,Shoulder,Saturday,June
2024-06-08 10:00:00,67,337,6,0,410,46,692,2,1,741,26.7,87,3,2.6,1151,True,10,113,1029,8,1,2024-06-08,False,False,False,0.894005212858384,0.09817549956559514,0.0069504778453518675,0.0008688097306689834,Shoulder,Saturday,June
2024-06-08 11:00:00,66,458,7,1,532,55,229,3,2,289,28.5,81,3,4.8,821,True,11,121,687,10,3,2024-06-08,False,False,False,0.8367844092570037,0.14738124238733252,0.012180267965895249,0.0036540803897685747,Peak,Saturday,June
2024-06-08 12:00:00,37,689,10,1,737,34,309,1,1,345,29.2,77,3,6.4,1082,True,12,71,998,11,2,2024-06-08,False,False,False,0.922365988909427,0.06561922365988909,0.010166358595194085,0.0018484288354898336,Peak,Saturday,June
2024-06-08 13:00:00,56,374,11,1,442,30,522,2,1,555,30.2,72,51,7.9,997,True,13,86,896,13,2,2024-06-08,False,False,False,0.8986960882647944,0.08625877632898696,0.013039117352056168,0.0020060180541624875,Peak,Saturday,June
2024-06-08 14:00:00,37,628,4,1,670,59,319,1,1,380,30.7,69,51,9.3,1050,True,14,96,947,5,2,2024-06-08,False,False,False,0.9019047619047619,0.09142857142857143,0.004761904761904762,0.0019047619047619048,Peak,Saturday,June
2024-06-08 15:00:00,75,815,6,1,897,41,302,1,1,345,30.5,70,51,10.0,1242,True,15,116,1117,7,2,2024-06-08,False,False,False,0.8993558776167472,0.09339774557165861,0.005636070853462158,0.001610305958132045,Peak,Saturday,June
2024-06-08 16:00:00,81,764,6,1,852,50,575,2,1,628,30.4,69,3,9.5,1480,True,16,131,1339,8,2,2024-06-08,False,False,True,0.9047297297297298,0.08851351351351351,0.005405405405405406,0.0013513513513513514,Peak,Saturday,June
2024-06-08 17:00:00,77,986,12,2,1077,57,571,2,1,631,29.6,72,3,7.6,1708,True,17,134,1557,14,3,2024-06-08,False,False,True,0.9115925058548009,0.07845433255269321,0.00819672131147541,0.001756440281030445,Peak,Saturday,June
2024-06-08 18:00:00,97,851,15,1,964,36,430,1,1,468,29.4,73,3,1.3,1432,True,18,133,1281,16,2,2024-06-08,False,False,True,0.8945530726256983,0.09287709497206705,0.0111731843575419,0.0013966480446927375,Peak,Saturday,June
2024-06-08 19:00:00,83,717,12,1,813,31,231,2,1,265,28.8,79,3,2.1,1078,True,19,114,948,14,2,2024-06-08,False,False,False,0.8794063079777366,0.10575139146567718,0.012987012987012988,0.0018552875695732839,Peak,Saturday,June
2024-06-08 20:00:00,50,381,13,1,445,34,281,3,1,319,28.1,82,3,1.8,764,True,20,84,662,16,2,2024-06-08,False,False,False,0.8664921465968587,0.1099476439790576,0.020942408376963352,0.002617801047120419,Shoulder,Saturday,June
2024-06-08 21:00:00,23,238,12,1,274,31,309,2,1,343,28.8,77,3,1.0,617,True,21,54,547,14,2,2024-06-08,False,False,False,0.8865478119935171,0.08752025931928688,0.022690437601296597,0.0032414910858995136,Shoulder,Saturday,June
2024-06-08 22:00:00,16,151,5,1,173,26,503,3,1,533,28.4,79,3,1.3,706,True,22,42,654,8,2,2024-06-08,False,False,False,0.9263456090651558,0.059490084985835696,0.0113314447592068,0.0028328611898017,Shoulder,Saturday,June
2024-06-08 23:00:00,12,118,6,1,137,25,534,4,1,564,26.6,90,3,3.3,701,True,23,37,652,10,2,2024-06-08,False,False,False,0.9300998573466477,0.052781740370898715,0.014265335235378032,0.0028530670470756064,Shoulder,Saturday,June
2024-06-09 00:00:00,19,160,3,0,182,73,171,2,0,246,25.7,94,3,3.1,428,True,0,92,331,5,0,2024-06-09,False,False,False,0.7733644859813084,0.21495327102803738,0.011682242990654205,0.0,Off-Peak,Sunday,June
2024-06-09 01:00:00,22,178,2,0,202,52,244,2,0,298,25.4,95,3,3.6,500,True,1,74,422,4,0,2024-06-09,False,False,False,0.844,0.148,0.008,0.0,Off-Peak,Sunday,June
2024-06-09 02:00:00,27,204,3,0,234,43,221,1,0,265,25.2,94,3,3.3,499,True,2,70,425,4,0,2024-06-09,False,False,False,0.8517034068136272,0.1402805611222445,0.008016032064128256,0.0,Off-Peak,Sunday,June
2024-06-09 03:00:00,33,388,3,0,424,55,305,2,0,362,24.9,94,3,5.0,786,True,3,88,693,5,0,2024-06-09,False,False,False,0.8816793893129771,0.11195928753180662,0.006361323155216285,0.0,Off-Peak,Sunday,June
2024-06-09 04:00:00,46,433,5,0,484,32,420,1,0,453,24.9,92,3,5.0,937,True,4,78,853,6,0,2024-06-09,False,False,False,0.9103521878335112,0.0832443970117396,0.0064034151547491995,0.0,Off-Peak,Sunday,June
2024-06-09 05:00:00,41,667,3,0,711,48,552,3,0,603,24.9,91,3,4.3,1314,True,5,89,1219,6,0,2024-06-09,False,False,False,0.9277016742770168,0.06773211567732115,0.0045662100456621,0.0,Shoulder,Sunday,June
2024-06-09 06:00:00,53,306,3,0,362,61,660,2,0,723,25.4,92,3,5.8,1085,True,6,114,966,5,0,2024-06-09,False,False,False,0.8903225806451613,0.10506912442396313,0.004608294930875576,0.0,Shoulder,Sunday,June
2024-06-09 07:00:00,71,244,4,0,319,60,748,2,0,810,25.9,91,51,8.2,1129,True,7,131,992,6,0,2024-06-09,False,False,False,0.8786536758193091,0.11603188662533215,0.005314437555358724,0.0,Peak,Sunday,June
2024-06-09 08:00:00,81,521,7,0,609,65,475,3,0,543,26.7,89,3,10.0,1152,True,8,146,996,10,0,2024-06-09,False,False,False,0.8645833333333334,0.1267361111111111,0.008680555555555556,0.0,Peak,Sunday,June
2024-06-09 09:00:00,72,766,5,1,844,19,550,1,0,570,28.1,83,3,2.4,1414,True,9,91,1316,6,1,2024-06-09,False,False,True,0.9306930693069307,0.06435643564356436,0.004243281471004243,0.0007072135785007072,Shoulder,Sunday,June
2024-06-09 10:00:00,50,671,4,1,726,47,403,2,0,452,29.3,75,51,6.6,1178,True,10,97,1074,6,1,2024-06-09,False,False,False,0.9117147707979627,0.08234295415959253,0.0050933786078098476,0.0008488964346349745,Shoulder,Sunday,June
2024-06-09 11:00:00,45,812,7,1,865,43,374,1,0,418,30.0,71,3,8.1,1283,True,11,88,1186,8,1,2024-06-09,False,False,False,0.9243959469992206,0.06858924395947,0.006235385814497272,0.000779423226812159,Peak,Sunday,June
2024-06-09 12:00:00,23,456,4,1,484,27,494,2,0,523,30.6,68,51,9.7,1007,True,12,50,950,6,1,2024-06-09,False,False,False,0.9433962264150944,0.04965243296921549,0.005958291956305859,0.0009930486593843098,Peak,Sunday,June
2024-06-09 13:00:00,41,331,4,1,377,35,332,1,0,368,30.8,68,3,10.8,745,True,13,76,663,5,1,2024-06-09,False,False,False,0.8899328859060402,0.10201342281879194,0.006711409395973154,0.0013422818791946308,Peak,Sunday,June
2024-06-09 14:00:00,88,512,3,1,604,69,559,2,1,631,30.4,67,51,11.8,1235,True,14,157,1071,5,2,2024-06-09,False,False,False,0.8672064777327935,0.12712550607287448,0.004048582995951417,0.0016194331983805667,Peak,Sunday,June
2024-06-09 15:00:00,98,973,3,1,1075,26,546,1,1,574,30.3,72,51,10.4,1649,True,15,124,1519,4,2,2024-06-09,False,False,True,0.9211643420254699,0.07519708914493632,0.002425712553062462,0.001212856276531231,Peak,Sunday,June
2024-06-09 16:00:00,92,872,8,1,973,60,620,2,1,683,30.3,71,3,10.7,1656,True,16,152,1492,10,2,2024-06-09,False,False,True,0.9009661835748792,0.09178743961352658,0.006038647342995169,0.0012077294685990338,Peak,Sunday,June
2024-06-09 17:00:00,87,864,8,1,960,69,635,3,1,708,30.0,71,51,10.6,1668,True,17,156,1499,11,2,2024-06-09,False,False,True,0.8986810551558753,0.09352517985611511,0.006594724220623501,0.001199040767386091,Peak,Sunday,June
2024-06-09 18:00:00,107,798,6,1,912,55,487,3,1,546,29.6,71,3,9.4,1458,True,18,162,1285,9,2,2024-06-09,False,False,True,0.8813443072702332,0.1111111111111111,0.006172839506172839,0.0013717421124828531,Peak,Sunday,June
2024-06-09 19:00:00,57,494,5,1,557,46,410,3,1,460,28.8,77,3,8.0,1017,True,19,103,904,8,2,2024-06-09,False,False,False,0.8888888888888888,0.10127826941986234,0.007866273352999017,0.0019665683382497543,Peak,Sunday,June
2024-06-09 20:00:00,56,415,4,2,477,15,405,2,1,423,28.3,79,3,7.3,900,True,20,71,820,6,3,2024-06-09,False,False,False,0.9111111111111111,0.07888888888888888,0.006666666666666667,0.0033333333333333335,Shoulder,Sunday,June
2024-06-09 21:00:00,37,364,4,1,406,27,234,2,1,264,27.3,81,3,3.3,670,True,21,64,598,6,2,2024-06-09,False,False,False,0.8925373134328358,0.0955223880597015,0.008955223880597015,0.0029850746268656717,Shoulder,Sunday,June
2024-06-09 22:00:00,22,211,10,1,244,86,125,5,2,218,27.4,83,2,3.3,462,True,22,108,336,15,3,2024-06-09,False,False,False,0.7272727272727273,0.23376623376623376,0.032467532467532464,0.006493506493506494,Shoulder,Sunday,June
2024-06-09 23:00:00,21,199,7,1,228,18,154,2,1,175,26.9,88,3,4.7,403,True,23,39,353,9,2,2024-06-09,False,False,False,0.8759305210918115,0.0967741935483871,0.022332506203473945,0.004962779156327543,Shoulder,Sunday,June
2024-06-10 00:00:00,17,224,6,0,247,19,174,2,0,195,27.7,80,3,2.4,442,False,0,36,398,8,0,2024-06-10,False,False,False,0.9004524886877828,0.08144796380090498,0.01809954751131222,0.0,Off-Peak,Monday,June
2024-06-10 01:00:00,19,298,3,0,320,24,290,1,0,315,27.0,85,3,4.0,635,False,1,43,588,4,0,2024-06-10,False,False,False,0.925984251968504,0.06771653543307087,0.006299212598425197,0.0,Off-Peak,Monday,June
2024-06-10 02:00:00,29,231,3,1,264,25,277,1,0,303,26.8,86,3,4.8,567,False,2,54,508,4,1,2024-06-10,False,False,False,0.8959435626102292,0.09523809523809523,0.007054673721340388,0.001763668430335097,Off-Peak,Monday,June
2024-06-10 03:00:00,38,393,2,0,433,30,313,2,0,345,26.8,86,3,4.6,778,False,3,68,706,4,0,2024-06-10,False,False,False,0.9074550128534704,0.08740359897172237,0.005141388174807198,0.0,Off-Peak,Monday,June
2024-06-10 04:00:00,33,545,3,0,581,39,422,1,0,462,26.3,90,3,5.8,1043,False,4,72,967,4,0,2024-06-10,False,False,False,0.9271332694151486,0.06903163950143816,0.003835091083413231,0.0,Off-Peak,Monday,June
2024-06-10 05:00:00,38,575,5,0,618,51,508,2,0,561,26.8,85,3,1.0,1179,False,5,89,1083,7,0,2024-06-10,False,False,False,0.9185750636132316,0.07548770144189991,0.005937234944868533,0.0,Shoulder,Monday,June
2024-06-10 06:00:00,55,747,5,1,808,70,696,2,0,768,26.4,87,3,1.8,1576,False,6,125,1443,7,1,2024-06-10,False,False,True,0.9156091370558376,0.07931472081218274,0.004441624365482234,0.0006345177664974619,Shoulder,Monday,June
2024-06-10 07:00:00,65,1017,5,1,1088,131,1240,2,0,1373,26.2,88,3,0.4,2461,False,7,196,2257,7,1,2024-06-10,False,False,True,0.917106867127184,0.07964242177976433,0.0028443722064201544,0.0004063388866314506,Peak,Monday,June
2024-06-10 08:00:00,62,935,3,1,1001,75,818,2,0,895,26.4,90,3,2.7,1896,False,8,137,1753,5,1,2024-06-10,False,False,True,0.92457805907173,0.07225738396624473,0.0026371308016877636,0.0005274261603375527,Peak,Monday,June
2024-06-10 09:00:00,43,860,4,1,908,81,731,1,0,813,28.5,83,2,2.3,1721,False,9,124,1591,5,1,2024-06-10,False,False,True,0.9244625217896572,0.07205113306217316,0.002905287623474724,0.0005810575246949448,Shoulder,Monday,June
2024-06-10 10:00:00,36,463,2,1,502,55,541,2,1,599,29.6,73,51,7.3,1101,False,10,91,1004,4,2,2024-06-10,False,False,False,0.9118982742960945,0.08265213442325159,0.0036330608537693005,0.0018165304268846503,Shoulder,Monday,June
2024-06-10 11:00:00,54,387,3,1,445,43,318,1,1,363,30.1,71,51,8.9,808,False,11,97,705,4,2,2024-06-10,False,False,False,0.8725247524752475,0.12004950495049505,0.0049504950495049506,0.0024752475247524753,Peak,Monday,June
2024-06-10 12:00:00,41,367,6,1,415,32,338,2,1,373,30.3,71,51,8.7,788,False,12,73,705,8,2,2024-06-10,False,False,False,0.8946700507614214,0.09263959390862944,0.01015228426395939,0.0025380710659898475,Peak,Monday,June
2024-06-10 13:00:00,34,468,2,1,505,33,292,2,1,328,30.6,70,51,8.4,833,False,13,67,760,4,2,2024-06-10,False,False,False,0.9123649459783914,0.08043217286914765,0.004801920768307323,0.0024009603841536613,Peak,Monday,June
2024-06-10 14:00:00,27,507,4,1,539,31,243,2,1,277,30.6,70,3,8.4,816,False,14,58,750,6,2,2024-06-10,False,False,False,0.9191176470588235,0.07107843137254902,0.007352941176470588,0.0024509803921568627,Peak,Monday,June
2024-06-10 15:00:00,26,602,4,1,633,71,475,3,1,550,31.0,68,2,8.1,1183,False,15,97,1077,7,2,2024-06-10,False,False,False,0.9103972950126796,0.08199492814877431,0.005917159763313609,0.0016906170752324597,Peak,Monday,June
2024-06-10 16:00:00,69,959,5,1,1034,79,713,2,1,795,30.8,69,3,8.6,1829,False,16,148,1672,7,2,2024-06-10,False,False,True,0.9141607435757244,0.08091853471842538,0.0038272279934390375,0.0010934937124111536,Peak,Monday,June
2024-06-10 17:00:00,68,882,3,1,954,74,704,3,1,782,30.4,68,2,8.8,1736,False,17,142,1586,6,2,2024-06-10,False,False,True,0.913594470046083,0.08179723502304148,0.0034562211981566822,0.001152073732718894,Peak,Monday,June
2024-06-10 18:00:00,75,755,2,1,833,48,730,2,1,781,30.0,69,2,6.3,1614,False,18,123,1485,4,2,2024-06-10,False,False,True,0.9200743494423792,0.0762081784386617,0.0024783147459727386,0.0012391573729863693,Peak,Monday,June
2024-06-10 19:00:00,44,527,4,1,576,31,364,2,1,398,28.8,76,2,4.3,974,False,19,75,891,6,2,2024-06-10,False,False,False,0.9147843942505134,0.07700205338809035,0.006160164271047228,0.002053388090349076,Peak,Monday,June
2024-06-10 20:00:00,25,519,3,1,548,35,227,3,2,267,28.2,78,2,6.0,815,False,20,60,746,6,3,2024-06-10,False,False,False,0.9153374233128835,0.0736196319018405,0.007361963190184049,0.0036809815950920245,Shoulder,Monday,June
2024-06-10 21:00:00,21,205,3,1,230,24,242,3,1,270,27.8,80,3,5.5,500,False,21,45,447,6,2,2024-06-10,False,False,False,0.894,0.09,0.012,0.004,Shoulder,Monday,June
2024-06-10 22:00:00,16,299,8,1,324,26,212,3,1,242,27.5,82,2,6.9,566,False,22,42,511,11,2,2024-06-10,False,False,False,0.9028268551236749,0.07420494699646643,0.019434628975265017,0.0035335689045936395,Shoulder,Monday,June
2024-06-10 23:00:00,15,265,8,1,289,18,159,8,1,186,27.2,82,3,7.2,475,False,23,33,424,16,2,2024-06-10,False,False,False,0.8926315789473684,0.06947368421052631,0.03368421052631579,0.004210526315789474,Shoulder,Monday,June
2024-06-11 00:00:00,16,835,3,0,854,12,136,3,0,151,26.7,84,1,6.1,1005,False,0,28,971,6,0,2024-06-11,False,False,False,0.9661691542288557,0.027860696517412936,0.005970149253731343,0.0,Off-Peak,Tuesday,June
2024-06-11 01:00:00,24,571,4,1,600,26,206,2,0,234,26.4,85,1,7.2,834,False,1,50,777,6,1,2024-06-11,False,False,False,0.9316546762589928,0.05995203836930456,0.007194244604316547,0.001199040767386091,Off-Peak,Tuesday,June
2024-06-11 02:00:00,23,186,1,0,210,23,233,2,0,258,26.0,88,2,7.6,468,False,2,46,419,3,0,2024-06-11,False,False,False,0.8952991452991453,0.09829059829059829,0.00641025641025641,0.0,Off-Peak,Tuesday,June
2024-06-11 03:00:00,38,597,3,0,638,39,302,3,0,344,25.9,91,3,8.3,982,False,3,77,899,6,0,2024-06-11,False,False,False,0.9154786150712831,0.07841140529531568,0.006109979633401222,0.0,Off-Peak,Tuesday,June
2024-06-11 04:00:00,49,437,3,0,489,41,460,1,0,502,25.6,92,2,5.1,991,False,4,90,897,4,0,2024-06-11,False,False,False,0.905146316851665,0.09081735620585267,0.004036326942482341,0.0,Off-Peak,Tuesday,June
2024-06-11 05:00:00,50,191,2,0,243,62,594,2,0,658,25.3,93,2,4.5,901,False,5,112,785,4,0,2024-06-11,False,False,False,0.8712541620421753,0.12430632630410655,0.004439511653718091,0.0,Shoulder,Tuesday,June
2024-06-11 06:00:00,64,491,2,0,557,66,670,2,0,738,25.0,93,3,6.0,1295,False,6,130,1161,4,0,2024-06-11,False,False,False,0.8965250965250965,0.10038610038610038,0.003088803088803089,0.0,Shoulder,Tuesday,June
2024-06-11 07:00:00,71,641,4,0,716,64,627,5,1,697,25.1,92,3,7.7,1413,False,7,135,1268,9,1,2024-06-11,False,False,True,0.897381457891012,0.09554140127388536,0.006369426751592357,0.0007077140835102619,Peak,Tuesday,June
2024-06-11 08:00:00,56,654,3,0,713,64,384,4,1,453,26.0,90,1,4.9,1166,False,8,120,1038,7,1,2024-06-11,False,False,False,0.8902229845626072,0.10291595197255575,0.006003430531732418,0.0008576329331046312,Peak,Tuesday,June
2024-06-11 09:00:00,43,430,2,0,475,50,229,2,1,282,28.1,82,1,4.8,757,False,9,93,659,4,1,2024-06-11,False,False,False,0.8705416116248349,0.12285336856010567,0.005284015852047556,0.001321003963011889,Shoulder,Tuesday,June
2024-06-11 10:00:00,38,275,2,0,315,38,387,2,1,428,29.3,75,51,6.7,743,False,10,76,662,4,1,2024-06-11,False,False,False,0.8909825033647375,0.10228802153432032,0.005383580080753701,0.0013458950201884253,Shoulder,Tuesday,June
2024-06-11 11:00:00,37,450,2,0,489,63,240,4,2,309,29.9,74,53,8.5,798,False,11,100,690,6,2,2024-06-11,False,False,False,0.8646616541353384,0.12531328320802004,0.007518796992481203,0.002506265664160401,Peak,Tuesday,June
2024-06-11 12:00:00,56,747,3,0,806,62,237,3,1,303,29.2,77,63,10.0,1109,False,12,118,984,6,1,2024-06-11,False,False,False,0.8872858431018936,0.10640216411181244,0.005410279531109108,0.0009017132551848512,Peak,Tuesday,June
2024-06-11 13:00:00,46,261,2,0,309,39,366,3,1,409,29.3,81,61,5.4,718,False,13,85,627,5,1,2024-06-11,False,False,False,0.8732590529247911,0.11838440111420613,0.006963788300835654,0.001392757660167131,Peak,Tuesday,June
2024-06-11 14:00:00,43,829,3,0,875,41,484,2,1,528,30.2,77,51,5.8,1403,False,14,84,1313,5,1,2024-06-11,False,False,True,0.9358517462580185,0.05987170349251604,0.003563791874554526,0.0007127583749109052,Peak,Tuesday,June
2024-06-11 15:00:00,72,391,3,1,467,48,603,3,1,655,30.5,74,51,7.2,1122,False,15,120,994,6,2,2024-06-11,False,False,False,0.8859180035650623,0.10695187165775401,0.0053475935828877,0.0017825311942959,Peak,Tuesday,June
2024-06-11 16:00:00,77,860,3,1,941,78,733,2,1,814,30.2,75,51,6.6,1755,False,16,155,1593,5,2,2024-06-11,False,False,True,0.9076923076923077,0.08831908831908832,0.002849002849002849,0.0011396011396011395,Peak,Tuesday,June
2024-06-11 17:00:00,73,866,5,1,945,89,854,2,1,946,30.3,71,1,4.4,1891,False,17,162,1720,7,2,2024-06-11,False,False,True,0.9095716552088842,0.08566895822316235,0.0037017451084082496,0.0010576414595452142,Peak,Tuesday,June
2024-06-11 18:00:00,61,523,3,1,588,51,621,2,1,675,30.2,70,3,4.7,1263,False,18,112,1144,5,2,2024-06-11,False,False,False,0.9057798891528107,0.08867775138558986,0.00395882818685669,0.001583531274742676,Peak,Tuesday,June
2024-06-11 19:00:00,57,730,5,1,793,31,489,5,1,526,29.0,77,3,5.8,1319,False,19,88,1219,10,2,2024-06-11,False,False,False,0.9241849886277483,0.0667172100075815,0.0075815011372251705,0.001516300227445034,Peak,Tuesday,June
2024-06-11 20:00:00,36,626,3,1,666,24,607,3,1,635,28.3,81,3,6.6,1301,False,20,60,1233,6,2,2024-06-11,False,False,False,0.9477325134511914,0.04611837048424289,0.004611837048424289,0.0015372790161414297,Shoulder,Tuesday,June
2024-06-11 21:00:00,21,285,3,1,310,25,408,5,1,439,28.1,86,3,4.6,749,False,21,46,693,8,2,2024-06-11,False,False,False,0.9252336448598131,0.06141522029372497,0.010680907877169559,0.0026702269692923898,Shoulder,Tuesday,June
2024-06-11 22:00:00,25,227,2,1,255,24,355,4,1,384,27.5,89,3,5.5,639,False,22,49,582,6,2,2024-06-11,False,False,False,0.9107981220657277,0.07668231611893583,0.009389671361502348,0.003129890453834116,Shoulder,Tuesday,June
2024-06-11 23:00:00,16,496,5,1,518,19,197,4,1,221,27.8,86,2,6.2,739,False,23,35,693,9,2,2024-06-11,False,False,False,0.9377537212449256,0.04736129905277402,0.012178619756427604,0.0027063599458728013,Shoulder,Tuesday,June
2024-06-12 00:00:00,14,146,5,0,165,13,157,1,0,171,27.5,88,0,7.8,336,False,0,27,303,6,0,2024-06-12,False,False,False,0.9017857142857143,0.08035714285714286,0.017857142857142856,0.0,Off-Peak,Wednesday,June
2024-06-12 01:00:00,21,204,3,0,228,26,280,1,0,307,27.2,90,1,7.9,535,False,1,47,484,4,0,2024-06-12,False,False,False,0.9046728971962616,0.08785046728971962,0.007476635514018692,0.0,Off-Peak,Wednesday,June
2024-06-12 02:00:00,30,355,5,0,390,28,286,1,0,315,26.9,92,3,9.0,705,False,2,58,641,6,0,2024-06-12,False,False,False,0.9092198581560283,0.08226950354609928,0.00851063829787234,0.0,Off-Peak,Wednesday,June
2024-06-12 03:00:00,35,315,4,1,355,31,359,1,1,392,26.7,92,3,6.5,747,False,3,66,674,5,2,2024-06-12,False,False,False,0.9022757697456493,0.08835341365461848,0.006693440428380187,0.002677376171352075,Off-Peak,Wednesday,June
2024-06-12 04:00:00,37,424,2,0,463,45,472,1,1,519,25.9,94,3,3.7,982,False,4,82,896,3,1,2024-06-12,False,False,False,0.9124236252545825,0.0835030549898167,0.003054989816700611,0.0010183299389002036,Off-Peak,Wednesday,June
2024-06-12 05:00:00,42,758,5,0,805,60,499,1,1,561,25.8,96,3,2.1,1366,False,5,102,1257,6,1,2024-06-12,False,False,False,0.9202049780380673,0.0746705710102489,0.004392386530014641,0.0007320644216691069,Shoulder,Wednesday,June
2024-06-12 06:00:00,88,881,2,0,971,76,832,2,1,911,25.5,96,3,2.6,1882,False,6,164,1713,4,1,2024-06-12,False,False,True,0.910201912858661,0.0871413390010627,0.0021253985122210413,0.0005313496280552603,Shoulder,Wednesday,June
2024-06-12 07:00:00,82,815,5,0,902,68,565,1,1,635,25.2,97,3,1.6,1537,False,7,150,1380,6,1,2024-06-12,False,False,True,0.8978529603122967,0.09759271307742355,0.003903708523096942,0.0006506180871828237,Peak,Wednesday,June
2024-06-12 08:00:00,78,793,5,0,876,64,807,2,2,875,26.2,95,3,4.3,1751,False,8,142,1600,7,2,2024-06-12,False,False,True,0.9137635636778983,0.08109651627641348,0.003997715591090805,0.001142204454597373,Peak,Wednesday,June
2024-06-12 09:00:00,43,417,4,0,464,52,700,1,1,754,28.2,83,3,6.3,1218,False,9,95,1117,5,1,2024-06-12,False,False,False,0.9170771756978654,0.07799671592775041,0.004105090311986864,0.0008210180623973727,Shoulder,Wednesday,June
2024-06-12 10:00:00,65,656,5,0,726,26,649,1,1,677,29.6,76,1,6.8,1403,False,10,91,1305,6,1,2024-06-12,False,False,True,0.9301496792587313,0.06486101211689238,0.0042765502494654314,0.0007127583749109052,Shoulder,Wednesday,June
2024-06-12 11:00:00,75,723,2,0,800,32,363,1,1,397,30.7,70,51,7.4,1197,False,11,107,1086,3,1,2024-06-12,False,False,False,0.9072681704260651,0.08939014202172096,0.002506265664160401,0.000835421888053467,Peak,Wednesday,June
2024-06-12 12:00:00,51,481,3,1,536,54,573,1,1,629,31.3,66,1,8.2,1165,False,12,105,1054,4,2,2024-06-12,False,False,False,0.9047210300429185,0.09012875536480687,0.0034334763948497852,0.0017167381974248926,Peak,Wednesday,June
2024-06-12 13:00:00,73,736,2,1,812,59,595,1,1,656,30.9,69,51,10.8,1468,False,13,132,1331,3,2,2024-06-12,False,False,True,0.9066757493188011,0.08991825613079019,0.0020435967302452314,0.0013623978201634877,Peak,Wednesday,June
2024-06-12 14:00:00,72,492,5,1,570,59,662,2,1,724,29.8,77,61,9.1,1294,False,14,131,1154,7,2,2024-06-12,False,False,False,0.8918083462132921,0.10123647604327667,0.005409582689335394,0.0015455950540958269,Peak,Wednesday,June
2024-06-12 15:00:00,61,595,6,1,663,40,407,2,1,450,30.2,75,51,9.2,1113,False,15,101,1002,8,2,2024-06-12,False,False,False,0.9002695417789758,0.09074573225516622,0.0071877807726864335,0.0017969451931716084,Peak,Wednesday,June
2024-06-12 16:00:00,72,359,8,1,440,65,704,2,1,772,30.0,75,51,7.7,1212,False,16,137,1063,10,2,2024-06-12,False,False,False,0.8770627062706271,0.11303630363036303,0.00825082508250825,0.0016501650165016502,Peak,Wednesday,June
2024-06-12 17:00:00,87,904,2,1,994,72,735,1,1,809,29.5,75,3,3.7,1803,False,17,159,1639,3,2,2024-06-12,False,False,True,0.9090404880754298,0.08818635607321132,0.0016638935108153079,0.0011092623405435386,Peak,Wednesday,June
2024-06-12 18:00:00,76,731,6,1,814,65,513,2,1,581,29.4,73,55,4.7,1395,False,18,141,1244,8,2,2024-06-12,False,False,True,0.8917562724014337,0.1010752688172043,0.005734767025089606,0.0014336917562724014,Peak,Wednesday,June
2024-06-12 19:00:00,52,685,6,1,744,48,682,2,1,733,28.5,81,51,1.5,1477,False,19,100,1367,8,2,2024-06-12,False,False,True,0.9255247122545701,0.06770480704129993,0.005416384563303994,0.0013540961408259986,Peak,Wednesday,June
2024-06-12 20:00:00,49,501,5,1,556,53,599,2,1,655,27.4,91,3,3.0,1211,False,20,102,1100,7,2,2024-06-12,False,False,False,0.9083402146985962,0.08422791081750619,0.005780346820809248,0.0016515276630883566,Shoulder,Wednesday,June
2024-06-12 21:00:00,27,262,4,1,294,46,369,2,1,418,28.0,84,3,2.4,712,False,21,73,631,6,2,2024-06-12,False,False,False,0.8862359550561798,0.10252808988764045,0.008426966292134831,0.0028089887640449437,Shoulder,Wednesday,June
2024-06-12 22:00:00,20,227,5,1,253,34,290,3,1,328,27.7,84,3,4.7,581,False,22,54,517,8,2,2024-06-12,False,False,False,0.8898450946643718,0.09294320137693632,0.013769363166953529,0.0034423407917383822,Shoulder,Wednesday,June
2024-06-12 23:00:00,24,207,7,1,239,12,132,2,1,147,26.7,89,2,4.7,386,False,23,36,339,9,2,2024-06-12,False,False,False,0.8782383419689119,0.09326424870466321,0.023316062176165803,0.0051813471502590676,Shoulder,Wednesday,June
2024-06-13 00:00:00,13,146,6,0,165,15,218,5,1,239,26.4,89,2,4.5,404,False,0,28,364,11,1,2024-06-13,False,False,False,0.900990099009901,0.06930693069306931,0.027227722772277228,0.0024752475247524753,Off-Peak,Thursday,June
2024-06-13 01:00:00,24,306,5,0,335,27,290,3,0,320,26.2,89,3,7.3,655,False,1,51,596,8,0,2024-06-13,False,False,False,0.9099236641221374,0.07786259541984733,0.012213740458015267,0.0,Off-Peak,Thursday,June
2024-06-13 02:00:00,30,391,6,0,427,27,303,3,0,333,25.9,90,2,5.5,760,False,2,57,694,9,0,2024-06-13,False,False,False,0.9131578947368421,0.075,0.011842105263157895,0.0,Off-Peak,Thursday,June
2024-06-13 03:00:00,35,426,5,0,466,33,391,3,1,428,25.2,94,3,4.6,894,False,3,68,817,8,1,2024-06-13,False,False,False,0.9138702460850112,0.07606263982102908,0.008948545861297539,0.0011185682326621924,Off-Peak,Thursday,June
2024-06-13 04:00:00,37,565,4,0,606,31,426,6,1,464,24.9,96,3,4.1,1070,False,4,68,991,10,1,2024-06-13,False,False,False,0.9261682242990654,0.06355140186915888,0.009345794392523364,0.0009345794392523365,Off-Peak,Thursday,June
2024-06-13 05:00:00,44,778,4,0,826,59,653,2,1,715,25.1,93,3,6.3,1541,False,5,103,1431,6,1,2024-06-13,False,False,True,0.9286177806619078,0.06683971447112265,0.003893575600259572,0.0006489292667099286,Shoulder,Thursday,June
2024-06-13 06:00:00,66,875,7,0,948,63,764,5,1,833,24.7,95,3,3.8,1781,False,6,129,1639,12,1,2024-06-13,False,False,True,0.9202695115103874,0.07243121841661988,0.00673778775968557,0.0005614823133071309,Shoulder,Thursday,June
2024-06-13 07:00:00,49,822,3,0,874,66,859,6,1,932,24.9,93,51,5.2,1806,False,7,115,1681,9,1,2024-06-13,False,False,True,0.9307862679955703,0.0636766334440753,0.0049833887043189366,0.0005537098560354374,Peak,Thursday,June
2024-06-13 08:00:00,42,593,3,0,638,68,737,3,1,809,25.6,93,3,6.5,1447,False,8,110,1330,6,1,2024-06-13,False,False,True,0.9191430545957153,0.07601935038009675,0.00414651002073255,0.000691085003455425,Peak,Thursday,June
2024-06-13 09:00:00,38,439,3,0,480,51,355,6,1,413,27.5,83,3,6.5,893,False,9,89,794,9,1,2024-06-13,False,False,False,0.8891377379619261,0.09966405375139978,0.010078387458006719,0.0011198208286674132,Shoulder,Thursday,June
2024-06-13 10:00:00,24,499,2,0,525,37,446,2,1,486,29.1,77,3,3.5,1011,False,10,61,945,4,1,2024-06-13,False,False,False,0.9347181008902077,0.06033630069238378,0.003956478733926805,0.0009891196834817012,Shoulder,Thursday,June
2024-06-13 11:00:00,41,497,4,0,542,35,391,4,1,431,30.3,70,2,1.4,973,False,11,76,888,8,1,2024-06-13,False,False,False,0.9126413155190134,0.07810894141829394,0.008221993833504625,0.0010277492291880781,Peak,Thursday,June
2024-06-13 12:00:00,52,589,5,0,646,20,754,3,1,778,31.2,65,3,2.9,1424,False,12,72,1343,8,1,2024-06-13,False,False,True,0.9431179775280899,0.05056179775280899,0.0056179775280898875,0.0007022471910112359,Peak,Thursday,June
2024-06-13 13:00:00,48,616,6,1,671,29,213,3,1,246,31.7,63,3,5.6,917,False,13,77,829,9,2,2024-06-13,False,False,False,0.9040348964013086,0.08396946564885496,0.009814612868047983,0.0021810250817884407,Peak,Thursday,June
2024-06-13 14:00:00,41,516,4,1,562,37,461,4,1,503,31.6,64,51,8.4,1065,False,14,78,977,8,2,2024-06-13,False,False,False,0.9173708920187793,0.07323943661971831,0.007511737089201878,0.0018779342723004694,Peak,Thursday,June
2024-06-13 15:00:00,44,595,6,1,646,40,487,6,1,534,31.4,68,51,9.9,1180,False,15,84,1082,12,2,2024-06-13,False,False,False,0.9169491525423729,0.0711864406779661,0.010169491525423728,0.001694915254237288,Peak,Thursday,June
2024-06-13 16:00:00,49,866,5,1,921,70,267,4,1,342,30.9,71,51,8.6,1263,False,16,119,1133,9,2,2024-06-13,False,False,False,0.897070467141726,0.09422011084718923,0.007125890736342043,0.001583531274742676,Peak,Thursday,June
2024-06-13 17:00:00,60,704,5,1,770,89,1074,4,1,1168,30.5,72,3,7.4,1938,False,17,149,1778,9,2,2024-06-13,False,False,True,0.9174406604747162,0.07688338493292053,0.0046439628482972135,0.0010319917440660474,Peak,Thursday,June
2024-06-13 18:00:00,63,658,6,1,728,66,830,5,1,902,30.0,74,2,7.2,1630,False,18,129,1488,11,2,2024-06-13,False,False,True,0.912883435582822,0.07914110429447853,0.006748466257668712,0.001226993865030675,Peak,Thursday,June
2024-06-13 19:00:00,59,624,6,2,691,32,884,4,1,921,29.2,77,0,7.4,1612,False,19,91,1508,10,3,2024-06-13,False,False,True,0.9354838709677419,0.056451612903225805,0.00620347394540943,0.0018610421836228288,Peak,Thursday,June
2024-06-13 20:00:00,47,464,4,1,516,31,429,9,1,470,28.8,77,1,10.7,986,False,20,78,893,13,2,2024-06-13,False,False,False,0.9056795131845842,0.07910750507099391,0.013184584178498986,0.002028397565922921,Shoulder,Thursday,June
2024-06-13 21:00:00,36,313,5,1,355,21,392,3,1,417,28.1,80,3,7.7,772,False,21,57,705,8,2,2024-06-13,False,False,False,0.9132124352331606,0.07383419689119171,0.010362694300518135,0.0025906735751295338,Shoulder,Thursday,June
2024-06-13 22:00:00,21,286,6,1,314,22,288,7,1,318,27.8,81,3,5.8,632,False,22,43,574,13,2,2024-06-13,False,False,False,0.9082278481012658,0.0680379746835443,0.020569620253164556,0.0031645569620253164,Shoulder,Thursday,June
2024-06-13 23:00:00,13,163,3,1,180,16,203,8,1,228,27.4,84,3,3.9,408,False,23,29,366,11,2,2024-06-13,False,False,False,0.8970588235294118,0.07107843137254902,0.02696078431372549,0.004901960784313725,Shoulder,Thursday,June
2024-06-14 00:00:00,19,171,4,0,194,19,178,3,0,200,27.0,88,3,3.6,394,False,0,38,349,7,0,2024-06-14,False,False,False,0.8857868020304569,0.09644670050761421,0.017766497461928935,0.0,Off-Peak,Friday,June
2024-06-14 01:00:00,28,244,5,0,277,27,283,3,0,313,26.8,88,3,4.7,590,False,1,55,527,8,0,2024-06-14,False,False,False,0.8932203389830509,0.09322033898305085,0.013559322033898305,0.0,Off-Peak,Friday,June
2024-06-14 02:00:00,39,343,3,0,385,39,198,3,0,240,25.9,92,3,5.1,625,False,2,78,541,6,0,2024-06-14,False,False,False,0.8656,0.1248,0.0096,0.0,Off-Peak,Friday,June
2024-06-14 03:00:00,36,494,3,0,533,28,288,3,1,320,25.1,96,3,6.6,853,False,3,64,782,6,1,2024-06-14,False,False,False,0.9167643610785463,0.07502930832356389,0.007033997655334115,0.0011723329425556857,Off-Peak,Friday,June
2024-06-14 04:00:00,67,433,6,0,506,36,503,3,1,543,24.9,96,3,6.5,1049,False,4,103,936,9,1,2024-06-14,False,False,False,0.892278360343184,0.09818875119161107,0.008579599618684462,0.0009532888465204957,Off-Peak,Friday,June
2024-06-14 05:00:00,33,857,4,1,895,69,729,4,1,803,24.7,97,3,4.7,1698,False,5,102,1586,8,2,2024-06-14,False,False,True,0.934040047114252,0.06007067137809187,0.004711425206124852,0.001177856301531213,Shoulder,Friday,June
2024-06-14 06:00:00,67,741,3,0,811,78,818,5,1,902,24.5,97,3,5.9,1713,False,6,145,1559,8,1,2024-06-14,False,False,True,0.9100992410974897,0.0846468184471687,0.004670169293636894,0.0005837711617046118,Shoulder,Friday,June
2024-06-14 07:00:00,62,810,6,0,878,60,633,5,1,699,24.4,97,2,4.6,1577,False,7,122,1443,11,1,2024-06-14,False,False,True,0.9150285351934052,0.07736207989854153,0.006975269499048827,0.0006341154090044388,Peak,Friday,June
2024-06-14 08:00:00,33,634,4,0,671,40,371,4,2,417,25.2,95,0,3.8,1088,False,8,73,1005,8,2,2024-06-14,False,False,False,0.9237132352941176,0.06709558823529412,0.007352941176470588,0.001838235294117647,Peak,Friday,June
2024-06-14 09:00:00,59,416,6,0,481,64,653,4,1,722,27.2,86,0,3.6,1203,False,9,123,1069,10,1,2024-06-14,False,False,False,0.8886118038237739,0.10224438902743142,0.00831255195344971,0.0008312551953449709,Shoulder,Friday,June
2024-06-14 10:00:00,65,826,6,0,897,54,429,2,1,486,28.1,79,3,8.7,1383,False,10,119,1255,8,1,2024-06-14,False,False,True,0.9074475777295734,0.08604483007953724,0.005784526391901663,0.0007230657989877079,Shoulder,Friday,June
2024-06-14 11:00:00,31,408,4,0,443,74,777,6,1,858,28.8,78,3,10.2,1301,False,11,105,1185,10,1,2024-06-14,False,False,False,0.9108378170637971,0.08070714834742505,0.007686395080707148,0.0007686395080707148,Peak,Friday,June
2024-06-14 12:00:00,62,783,6,0,851,64,505,4,1,574,29.6,75,51,11.4,1425,False,12,126,1288,10,1,2024-06-14,False,False,True,0.903859649122807,0.08842105263157894,0.007017543859649123,0.0007017543859649122,Peak,Friday,June
2024-06-14 13:00:00,64,779,6,0,849,48,486,5,1,540,30.3,70,51,10.5,1389,False,13,112,1265,11,1,2024-06-14,False,False,True,0.9107271418286537,0.08063354931605471,0.007919366450683946,0.0007199424046076314,Peak,Friday,June
2024-06-14 14:00:00,26,322,4,0,352,48,500,6,1,555,29.0,74,61,12.5,907,False,14,74,822,10,1,2024-06-14,False,False,False,0.906284454244763,0.08158765159867695,0.011025358324145534,0.0011025358324145535,Peak,Friday,June
2024-06-14 15:00:00,41,518,5,0,564,49,659,4,1,713,29.0,77,51,5.9,1277,False,15,90,1177,9,1,2024-06-14,False,False,False,0.9216914643696162,0.07047768206734534,0.007047768206734534,0.0007830853563038371,Peak,Friday,June
2024-06-14 16:00:00,53,849,5,0,907,98,975,4,1,1078,28.3,76,53,9.0,1985,False,16,151,1824,9,1,2024-06-14,False,False,True,0.9188916876574307,0.07607052896725441,0.004534005037783375,0.0005037783375314861,Peak,Friday,June
2024-06-14 17:00:00,58,721,6,0,785,75,804,3,1,883,28.3,81,51,7.0,1668,False,17,133,1525,9,1,2024-06-14,False,False,True,0.9142685851318945,0.07973621103117506,0.00539568345323741,0.0005995203836930455,Peak,Friday,June
2024-06-14 18:00:00,15,778,3,1,797,81,757,5,1,844,28.5,81,51,2.9,1641,False,18,96,1535,8,2,2024-06-14,False,False,True,0.935405240706886,0.05850091407678245,0.004875076173065204,0.001218769043266301,Peak,Friday,June
2024-06-14 19:00:00,12,571,4,1,588,51,590,4,1,646,27.9,85,51,4.5,1234,False,19,63,1161,8,2,2024-06-14,False,False,False,0.9408427876823339,0.051053484602917344,0.006482982171799027,0.0016207455429497568,Peak,Friday,June
2024-06-14 20:00:00,36,452,5,1,494,28,396,4,1,429,27.3,88,3,6.9,923,False,20,64,848,9,2,2024-06-14,False,False,False,0.9187432286023836,0.06933911159263272,0.009750812567713976,0.0021668472372697724,Shoulder,Friday,June
2024-06-14 21:00:00,63,508,7,1,579,28,284,3,1,316,27.3,87,3,3.4,895,False,21,91,792,10,2,2024-06-14,False,False,False,0.8849162011173184,0.10167597765363129,0.0111731843575419,0.0022346368715083797,Shoulder,Friday,June
2024-06-14 22:00:00,46,414,6,1,467,20,283,9,1,313,27.1,88,3,3.7,780,False,22,66,697,15,2,2024-06-14,False,False,False,0.8935897435897436,0.08461538461538462,0.019230769230769232,0.002564102564102564,Shoulder,Friday,June
2024-06-14 23:00:00,51,138,8,1,198,20,192,8,1,221,27.0,90,3,5.2,419,False,23,71,330,16,2,2024-06-14,False,False,False,0.7875894988066826,0.16945107398568018,0.03818615751789976,0.00477326968973747,Shoulder,Friday,June
2024-06-15 00:00:00,18,174,11,0,203,19,219,3,0,241,26.9,90,3,7.0,444,True,0,37,393,14,0,2024-06-15,False,False,False,0.8851351351351351,0.08333333333333333,0.03153153153153153,0.0,Off-Peak,Saturday,June
2024-06-15 01:00:00,25,213,10,0,248,21,253,5,0,279,26.6,90,1,5.7,527,True,1,46,466,15,0,2024-06-15,False,False,False,0.8842504743833017,0.0872865275142315,0.028462998102466792,0.0,Off-Peak,Saturday,June
2024-06-15 02:00:00,23,255,9,0,287,26,320,2,0,348,26.1,92,1,4.3,635,True,2,49,575,11,0,2024-06-15,False,False,False,0.905511811023622,0.07716535433070866,0.01732283464566929,0.0,Off-Peak,Saturday,June
2024-06-15 03:00:00,35,499,11,0,545,44,392,6,1,443,25.7,94,0,4.5,988,True,3,79,891,17,1,2024-06-15,False,False,False,0.9018218623481782,0.07995951417004049,0.01720647773279352,0.0010121457489878543,Off-Peak,Saturday,June
2024-06-15 04:00:00,20,435,8,0,463,23,556,5,0,584,25.6,93,0,3.7,1047,True,4,43,991,13,0,2024-06-15,False,False,False,0.9465138490926457,0.041069723018147083,0.012416427889207259,0.0,Off-Peak,Saturday,June
2024-06-15 05:00:00,46,541,7,0,594,45,551,4,0,600,25.9,93,1,5.7,1194,True,5,91,1092,11,0,2024-06-15,False,False,False,0.914572864321608,0.076214405360134,0.009212730318257957,0.0,Shoulder,Saturday,June
2024-06-15 06:00:00,65,682,10,0,757,61,511,4,0,576,26.0,93,2,8.8,1333,True,6,126,1193,14,0,2024-06-15,False,False,False,0.894973743435859,0.09452363090772693,0.010502625656414103,0.0,Shoulder,Saturday,June
2024-06-15 07:00:00,68,1071,6,0,1145,54,605,6,0,665,25.9,93,3,7.6,1810,True,7,122,1676,12,0,2024-06-15,False,False,True,0.9259668508287293,0.06740331491712707,0.0066298342541436465,0.0,Peak,Saturday,June
2024-06-15 08:00:00,57,812,9,0,878,59,744,5,0,808,26.6,90,1,6.6,1686,True,8,116,1556,14,0,2024-06-15,False,False,True,0.9228944246737841,0.06880189798339265,0.00830367734282325,0.0,Peak,Saturday,June
2024-06-15 09:00:00,36,657,4,0,697,34,697,3,0,734,26.1,93,63,10.5,1431,True,9,70,1354,7,0,2024-06-15,False,False,True,0.9461914744933613,0.04891684136967156,0.004891684136967156,0.0,Shoulder,Saturday,June
2024-06-15 10:00:00,42,512,7,1,562,27,639,3,0,669,27.1,86,61,16.1,1231,True,10,69,1151,10,1,2024-06-15,False,False,False,0.9350121852152722,0.056051990251827784,0.008123476848090982,0.0008123476848090983,Shoulder,Saturday,June
2024-06-15 11:00:00,52,399,9,0,460,46,529,5,0,580,26.9,85,51,13.6,1040,True,11,98,928,14,0,2024-06-15,False,False,False,0.8923076923076924,0.09423076923076923,0.013461538461538462,0.0,Peak,Saturday,June
2024-06-15 12:00:00,44,260,4,0,308,23,325,2,0,350,27.9,80,3,12.0,658,True,12,67,585,6,0,2024-06-15,False,False,False,0.8890577507598785,0.10182370820668693,0.00911854103343465,0.0,Peak,Saturday,June
2024-06-15 13:00:00,41,533,6,1,581,64,327,3,0,394,28.7,74,51,14.3,975,True,13,105,860,9,1,2024-06-15,False,False,False,0.882051282051282,0.1076923076923077,0.009230769230769232,0.0010256410256410256,Peak,Saturday,June
2024-06-15 14:00:00,21,518,4,1,544,48,523,2,0,573,28.8,71,51,13.8,1117,True,14,69,1041,6,1,2024-06-15,False,False,False,0.9319606087735004,0.06177260519247986,0.005371530886302597,0.0008952551477170994,Peak,Saturday,June
2024-06-15 15:00:00,45,826,7,1,879,64,248,4,0,316,29.1,68,51,13.6,1195,True,15,109,1074,11,1,2024-06-15,False,False,False,0.8987447698744769,0.09121338912133892,0.009205020920502092,0.0008368200836820083,Peak,Saturday,June
2024-06-15 16:00:00,105,1270,10,1,1386,64,733,5,1,803,29.0,68,51,12.4,2189,True,16,169,2003,15,2,2024-06-15,False,False,True,0.9150296939241663,0.07720420283234354,0.006852444038373686,0.0009136592051164915,Peak,Saturday,June
2024-06-15 17:00:00,76,923,11,1,1011,61,748,4,1,814,29.7,66,51,10.7,1825,True,17,137,1671,15,2,2024-06-15,False,False,True,0.9156164383561644,0.07506849315068494,0.00821917808219178,0.001095890410958904,Peak,Saturday,June
2024-06-15 18:00:00,90,524,8,1,623,51,735,3,1,790,29.2,68,3,8.7,1413,True,18,141,1259,11,2,2024-06-15,False,False,True,0.8910120311394196,0.09978768577494693,0.00778485491861288,0.0014154281670205238,Peak,Saturday,June
2024-06-15 19:00:00,41,451,5,1,498,44,691,5,1,741,28.1,75,3,6.9,1239,True,19,85,1142,10,2,2024-06-15,False,False,False,0.9217110573042776,0.06860371267150928,0.008071025020177562,0.0016142050040355124,Peak,Saturday,June
2024-06-15 20:00:00,33,284,4,1,322,30,512,3,1,546,27.3,78,3,6.1,868,True,20,63,796,7,2,2024-06-15,False,False,False,0.9170506912442397,0.07258064516129033,0.008064516129032258,0.002304147465437788,Shoulder,Saturday,June
2024-06-15 21:00:00,20,308,11,1,340,46,286,7,1,340,28.0,75,3,7.8,680,True,21,66,594,18,2,2024-06-15,False,False,False,0.8735294117647059,0.09705882352941177,0.026470588235294117,0.0029411764705882353,Shoulder,Saturday,June
2024-06-15 22:00:00,17,245,10,1,273,29,223,9,1,262,28.1,76,3,7.6,535,True,22,46,468,19,2,2024-06-15,False,False,False,0.874766355140187,0.08598130841121496,0.03551401869158879,0.003738317757009346,Shoulder,Saturday,June
2024-06-15 23:00:00,14,201,8,1,224,20,271,4,1,296,27.8,79,3,7.4,520,True,23,34,472,12,2,2024-06-15,False,False,False,0.9076923076923077,0.06538461538461539,0.023076923076923078,0.0038461538461538464,Shoulder,Saturday,June
2024-06-16 00:00:00,15,180,3,0,198,25,198,5,0,228,26.9,85,3,3.7,426,True,0,40,378,8,0,2024-06-16,False,True,False,0.8873239436619719,0.09389671361502347,0.018779342723004695,0.0,Off-Peak,Sunday,June
2024-06-16 01:00:00,19,229,5,0,253,26,211,5,0,242,26.7,87,3,4.6,495,True,1,45,440,10,0,2024-06-16,False,True,False,0.8888888888888888,0.09090909090909091,0.020202020202020204,0.0,Off-Peak,Sunday,June
2024-06-16 02:00:00,27,380,7,0,414,35,294,5,0,334,26.3,89,3,4.0,748,True,2,62,674,12,0,2024-06-16,False,True,False,0.9010695187165776,0.08288770053475936,0.016042780748663103,0.0,Off-Peak,Sunday,June
2024-06-16 03:00:00,42,395,3,0,440,38,376,2,0,416,26.0,89,3,3.7,856,True,3,80,771,5,0,2024-06-16,False,True,False,0.9007009345794392,0.09345794392523364,0.005841121495327103,0.0,Off-Peak,Sunday,June
2024-06-16 04:00:00,33,328,7,0,368,38,303,2,1,344,25.7,91,3,4.4,712,True,4,71,631,9,1,2024-06-16,False,True,False,0.8862359550561798,0.0997191011235955,0.012640449438202247,0.0014044943820224719,Off-Peak,Sunday,June
2024-06-16 05:00:00,56,646,6,0,708,36,329,3,2,370,25.5,91,51,6.4,1078,True,5,92,975,9,2,2024-06-16,False,True,False,0.9044526901669759,0.08534322820037106,0.008348794063079777,0.0018552875695732839,Shoulder,Sunday,June
2024-06-16 06:00:00,60,724,6,0,790,62,331,6,1,400,24.4,96,53,11.8,1190,True,6,122,1055,12,1,2024-06-16,False,True,False,0.8865546218487395,0.10252100840336134,0.010084033613445379,0.0008403361344537816,Shoulder,Sunday,June
2024-06-16 07:00:00,68,807,9,1,885,64,558,3,1,626,25.1,94,51,7.5,1511,True,7,132,1365,12,2,2024-06-16,False,True,True,0.9033752481800132,0.08735936465916612,0.007941760423560556,0.0013236267372600927,Peak,Sunday,June
2024-06-16 08:00:00,58,703,3,0,764,65,554,3,1,623,25.5,95,3,9.0,1387,True,8,123,1257,6,1,2024-06-16,False,True,True,0.9062725306416727,0.08868060562364816,0.004325883201153569,0.0007209805335255948,Peak,Sunday,June
2024-06-16 09:00:00,40,529,3,0,572,39,557,6,1,603,26.5,87,3,6.0,1175,True,9,79,1086,9,1,2024-06-16,False,True,False,0.9242553191489362,0.06723404255319149,0.007659574468085106,0.000851063829787234,Shoulder,Sunday,June
2024-06-16 10:00:00,31,459,8,0,498,44,315,5,1,365,27.7,83,1,1.8,863,True,10,75,774,13,1,2024-06-16,False,True,False,0.8968713789107764,0.08690614136732329,0.015063731170336037,0.0011587485515643105,Shoulder,Sunday,June
2024-06-16 11:00:00,44,533,5,1,583,60,243,5,1,309,28.9,79,51,5.8,892,True,11,104,776,10,2,2024-06-16,False,True,False,0.8699551569506726,0.11659192825112108,0.011210762331838564,0.002242152466367713,Peak,Sunday,June
2024-06-16 12:00:00,56,311,8,1,376,36,547,3,1,587,29.7,77,51,9.4,963,True,12,92,858,11,2,2024-06-16,False,True,False,0.8909657320872274,0.09553478712357218,0.01142263759086189,0.0020768431983385254,Peak,Sunday,June
2024-06-16 13:00:00,52,430,4,1,487,52,468,5,1,526,29.8,76,51,11.9,1013,True,13,104,898,9,2,2024-06-16,False,True,False,0.8864758144126358,0.10266535044422508,0.008884501480750246,0.0019743336623889436,Peak,Sunday,June
2024-06-16 14:00:00,38,671,3,1,713,60,462,5,1,528,29.9,74,0,12.1,1241,True,14,98,1133,8,2,2024-06-16,False,True,False,0.9129734085414988,0.0789685737308622,0.0064464141821112,0.0016116035455278,Peak,Sunday,June
2024-06-16 15:00:00,44,526,6,1,577,37,315,4,1,357,30.1,71,1,10.8,934,True,15,81,841,10,2,2024-06-16,False,True,False,0.9004282655246253,0.0867237687366167,0.010706638115631691,0.0021413276231263384,Peak,Sunday,June
2024-06-16 16:00:00,66,652,5,1,724,99,516,4,1,620,30.0,70,1,8.8,1344,True,16,165,1168,9,2,2024-06-16,False,True,False,0.8690476190476191,0.12276785714285714,0.006696428571428571,0.001488095238095238,Peak,Sunday,June
2024-06-16 17:00:00,69,753,4,1,827,60,834,5,1,900,29.7,69,0,7.9,1727,True,17,129,1587,9,2,2024-06-16,False,True,True,0.9189345686160972,0.07469600463231037,0.0052113491603937466,0.0011580775911986102,Peak,Sunday,June
2024-06-16 18:00:00,58,834,7,1,900,53,550,5,1,609,29.4,70,1,5.6,1509,True,18,111,1384,12,2,2024-06-16,False,True,True,0.9171636845593109,0.073558648111332,0.007952286282306162,0.0013253810470510272,Peak,Sunday,June
2024-06-16 19:00:00,69,811,4,1,885,63,542,4,1,610,28.3,76,2,6.2,1495,True,19,132,1353,8,2,2024-06-16,False,True,True,0.9050167224080268,0.0882943143812709,0.005351170568561873,0.0013377926421404682,Peak,Sunday,June
2024-06-16 20:00:00,28,617,6,1,652,34,319,4,1,358,28.0,75,2,7.8,1010,True,20,62,936,10,2,2024-06-16,False,True,False,0.9267326732673268,0.061386138613861385,0.009900990099009901,0.0019801980198019802,Shoulder,Sunday,June
2024-06-16 21:00:00,22,268,9,1,300,29,274,8,1,312,27.9,78,3,15.5,612,True,21,51,542,17,2,2024-06-16,False,True,False,0.8856209150326797,0.08333333333333333,0.027777777777777776,0.0032679738562091504,Shoulder,Sunday,June
2024-06-16 22:00:00,24,289,8,1,322,29,248,7,1,285,27.0,83,2,10.5,607,True,22,53,537,15,2,2024-06-16,False,True,False,0.8846787479406919,0.08731466227347612,0.02471169686985173,0.0032948929159802307,Shoulder,Sunday,June
2024-06-16 23:00:00,14,179,7,1,201,22,192,9,1,224,26.7,86,3,8.7,425,True,23,36,371,16,2,2024-06-16,False,True,False,0.8729411764705882,0.08470588235294117,0.03764705882352941,0.004705882352941176,Shoulder,Sunday,June
2024-06-17 00:00:00,15,183,4,0,202,18,139,6,0,163,26.5,88,3,8.9,365,False,0,33,322,10,0,2024-06-17,True,True,False,0.8821917808219178,0.09041095890410959,0.0273972602739726,0.0,Off-Peak,Monday,June
2024-06-17 01:00:00,29,224,6,0,259,28,155,5,0,188,26.3,89,3,5.5,447,False,1,57,379,11,0,2024-06-17,True,True,False,0.8478747203579419,0.12751677852348994,0.024608501118568233,0.0,Off-Peak,Monday,June
2024-06-17 02:00:00,35,365,5,0,405,25,224,5,0,254,25.8,92,53,7.7,659,False,2,60,589,10,0,2024-06-17,True,True,False,0.8937784522003035,0.09104704097116843,0.015174506828528073,0.0,Off-Peak,Monday,June
2024-06-17 03:00:00,33,460,6,0,499,35,250,6,0,291,25.0,94,63,8.6,790,False,3,68,710,12,0,2024-06-17,True,True,False,0.8987341772151899,0.08607594936708861,0.015189873417721518,0.0,Off-Peak,Monday,June
2024-06-17 04:00:00,39,505,4,0,548,36,356,6,0,398,24.8,95,63,5.2,946,False,4,75,861,10,0,2024-06-17,True,True,False,0.9101479915433404,0.07928118393234672,0.010570824524312896,0.0,Off-Peak,Monday,June
2024-06-17 05:00:00,40,493,3,0,536,54,495,3,0,552,24.4,94,61,7.3,1088,False,5,94,988,6,0,2024-06-17,True,True,False,0.9080882352941176,0.08639705882352941,0.0055147058823529415,0.0,Shoulder,Monday,June
2024-06-17 06:00:00,66,665,6,0,737,89,523,3,0,615,24.9,93,51,5.4,1352,False,6,155,1188,9,0,2024-06-17,True,True,False,0.878698224852071,0.11464497041420119,0.006656804733727811,0.0,Shoulder,Monday,June
2024-06-17 07:00:00,67,782,6,0,855,65,612,6,0,683,24.8,95,51,5.4,1538,False,7,132,1394,12,0,2024-06-17,True,True,True,0.9063719115734721,0.0858257477243173,0.007802340702210663,0.0,Peak,Monday,June
2024-06-17 08:00:00,70,791,5,0,866,53,656,4,0,713,25.6,94,3,7.2,1579,False,8,123,1447,9,0,2024-06-17,True,True,True,0.9164027865737808,0.077897403419886,0.005699810006333122,0.0,Peak,Monday,June
2024-06-17 09:00:00,41,482,6,0,529,40,396,5,1,442,26.6,85,53,13.0,971,False,9,81,878,11,1,2024-06-17,True,True,False,0.9042224510813595,0.08341915550978372,0.01132852729145211,0.0010298661174047373,Shoulder,Monday,June
2024-06-17 10:00:00,42,554,4,0,600,42,307,4,0,353,25.9,87,63,12.2,953,False,10,84,861,8,0,2024-06-17,True,True,False,0.9034627492130115,0.08814270724029381,0.008394543546694649,0.0,Shoulder,Monday,June
2024-06-17 11:00:00,54,373,4,0,431,24,211,5,0,240,27.6,82,51,13.9,671,False,11,78,584,9,0,2024-06-17,True,True,False,0.8703427719821163,0.11624441132637854,0.013412816691505217,0.0,Peak,Monday,June
2024-06-17 12:00:00,43,413,4,0,460,35,540,8,0,583,29.4,77,51,13.0,1043,False,12,78,953,12,0,2024-06-17,True,True,False,0.9137104506232023,0.07478427612655801,0.011505273250239693,0.0,Peak,Monday,June
2024-06-17 13:00:00,40,314,6,0,360,47,319,4,1,371,30.0,74,3,13.4,731,False,13,87,633,10,1,2024-06-17,True,True,False,0.86593707250342,0.11901504787961696,0.013679890560875513,0.0013679890560875513,Peak,Monday,June
2024-06-17 14:00:00,24,352,4,0,380,55,399,4,1,459,30.3,70,3,11.9,839,False,14,79,751,8,1,2024-06-17,True,True,False,0.8951132300357568,0.09415971394517282,0.009535160905840286,0.0011918951132300357,Peak,Monday,June
2024-06-17 15:00:00,44,508,8,0,560,41,261,3,1,306,30.2,71,3,13.3,866,False,15,85,769,11,1,2024-06-17,True,True,False,0.8879907621247113,0.09815242494226328,0.012702078521939953,0.0011547344110854503,Peak,Monday,June
2024-06-17 16:00:00,63,777,10,0,850,67,607,4,1,679,30.0,71,3,12.4,1529,False,16,130,1384,14,1,2024-06-17,True,True,True,0.9051667756703728,0.08502289077828647,0.009156311314584695,0.0006540222367560497,Peak,Monday,June
2024-06-17 17:00:00,72,842,9,0,923,70,820,5,1,896,29.7,71,3,9.8,1819,False,17,142,1662,14,1,2024-06-17,True,True,True,0.9136888400219901,0.07806487080813634,0.007696536558548653,0.0005497526113249038,Peak,Monday,June
2024-06-17 18:00:00,53,820,4,0,877,72,677,8,1,758,29.1,73,3,6.1,1635,False,18,125,1497,12,1,2024-06-17,True,True,True,0.9155963302752294,0.0764525993883792,0.007339449541284404,0.0006116207951070336,Peak,Monday,June
2024-06-17 19:00:00,30,669,5,0,704,29,420,6,1,456,28.3,79,1,4.1,1160,False,19,59,1089,11,1,2024-06-17,True,True,False,0.9387931034482758,0.05086206896551724,0.009482758620689655,0.0008620689655172414,Peak,Monday,June
2024-06-17 20:00:00,28,467,7,0,502,27,368,7,1,403,27.4,83,1,4.6,905,False,20,55,835,14,1,2024-06-17,True,True,False,0.9226519337016574,0.06077348066298342,0.015469613259668509,0.0011049723756906078,Shoulder,Monday,June
2024-06-17 21:00:00,28,333,6,0,367,24,257,9,1,291,26.7,80,3,9.4,658,False,21,52,590,15,1,2024-06-17,True,True,False,0.8966565349544073,0.0790273556231003,0.022796352583586626,0.001519756838905775,Shoulder,Monday,June
2024-06-17 22:00:00,20,287,6,0,313,14,230,5,1,250,26.3,82,3,9.5,563,False,22,34,517,11,1,2024-06-17,True,True,False,0.9182948490230906,0.06039076376554174,0.019538188277087035,0.0017761989342806395,Shoulder,Monday,June
2024-06-17 23:00:00,16,196,7,2,221,15,135,10,1,161,25.7,86,2,7.7,382,False,23,31,331,17,3,2024-06-17,True,True,False,0.8664921465968587,0.08115183246073299,0.04450261780104712,0.007853403141361256,Shoulder,Monday,June
2024-06-18 00:00:00,18,190,2,0,210,19,142,2,0,163,25.2,87,2,6.7,373,False,0,37,332,4,0,2024-06-18,True,True,False,0.8900804289544236,0.09919571045576407,0.010723860589812333,0.0,Off-Peak,Tuesday,June
2024-06-18 01:00:00,16,215,4,0,235,25,205,1,0,231,24.9,86,1,7.3,466,False,1,41,420,5,0,2024-06-18,True,True,False,0.9012875536480687,0.08798283261802575,0.01072961373390558,0.0,Off-Peak,Tuesday,June
2024-06-18 02:00:00,29,227,4,1,261,26,262,2,0,290,24.6,82,3,7.3,551,False,2,55,489,6,1,2024-06-18,True,True,False,0.8874773139745916,0.0998185117967332,0.010889292196007259,0.0018148820326678765,Off-Peak,Tuesday,June
2024-06-18 03:00:00,31,384,2,0,417,45,308,3,0,356,24.2,81,3,5.5,773,False,3,76,692,5,0,2024-06-18,True,True,False,0.8952134540750324,0.09831824062095731,0.00646830530401035,0.0,Off-Peak,Tuesday,June
2024-06-18 04:00:00,30,480,5,0,515,41,410,2,0,453,23.8,83,3,4.8,968,False,4,71,890,7,0,2024-06-18,True,True,False,0.9194214876033058,0.07334710743801653,0.007231404958677686,0.0,Off-Peak,Tuesday,June
2024-06-18 05:00:00,47,379,3,0,429,52,570,3,0,625,23.5,84,3,5.9,1054,False,5,99,949,6,0,2024-06-18,True,True,False,0.9003795066413662,0.09392789373814042,0.0056925996204933585,0.0,Shoulder,Tuesday,June
2024-06-18 06:00:00,49,858,2,0,909,65,690,3,1,759,23.5,84,0,5.5,1668,False,6,114,1548,5,1,2024-06-18,True,True,True,0.9280575539568345,0.0683453237410072,0.002997601918465228,0.0005995203836930455,Shoulder,Tuesday,June
2024-06-18 07:00:00,62,1018,5,0,1085,63,720,2,0,785,24.1,80,1,5.6,1870,False,7,125,1738,7,0,2024-06-18,True,True,True,0.9294117647058824,0.06684491978609626,0.0037433155080213902,0.0,Peak,Tuesday,June
2024-06-18 08:00:00,104,879,5,0,988,67,597,3,0,667,25.2,79,0,6.7,1655,False,8,171,1476,8,0,2024-06-18,True,True,True,0.8918429003021148,0.10332326283987915,0.004833836858006042,0.0,Peak,Tuesday,June
2024-06-18 09:00:00,63,654,3,0,720,52,373,2,0,427,27.8,75,0,4.3,1147,False,9,115,1027,5,0,2024-06-18,True,True,False,0.8953792502179599,0.1002615518744551,0.004359197907585004,0.0,Shoulder,Tuesday,June
2024-06-18 10:00:00,22,316,5,0,343,30,203,2,0,235,29.3,72,2,7.0,578,False,10,52,519,7,0,2024-06-18,True,True,False,0.8979238754325259,0.08996539792387544,0.012110726643598616,0.0,Shoulder,Tuesday,June
2024-06-18 11:00:00,46,450,4,0,500,29,472,3,0,504,29.9,70,51,9.2,1004,False,11,75,922,7,0,2024-06-18,True,True,False,0.9183266932270916,0.07470119521912351,0.0069721115537848604,0.0,Peak,Tuesday,June
2024-06-18 12:00:00,32,672,5,0,709,29,310,2,0,341,30.2,69,1,9.7,1050,False,12,61,982,7,0,2024-06-18,True,True,False,0.9352380952380952,0.058095238095238096,0.006666666666666667,0.0,Peak,Tuesday,June
2024-06-18 13:00:00,48,415,5,0,468,30,429,3,0,462,30.5,69,1,10.4,930,False,13,78,844,8,0,2024-06-18,True,True,False,0.9075268817204301,0.08387096774193549,0.008602150537634409,0.0,Peak,Tuesday,June
2024-06-18 14:00:00,28,656,6,0,690,38,520,3,0,561,30.6,69,1,9.1,1251,False,14,66,1176,9,0,2024-06-18,True,True,False,0.9400479616306955,0.05275779376498801,0.007194244604316547,0.0,Peak,Tuesday,June
2024-06-18 15:00:00,28,397,6,0,431,49,563,4,0,616,30.7,67,3,9.4,1047,False,15,77,960,10,0,2024-06-18,True,True,False,0.9169054441260746,0.07354345749761222,0.009551098376313277,0.0,Peak,Tuesday,June
2024-06-18 16:00:00,63,615,4,0,682,59,713,3,0,775,30.4,67,3,8.5,1457,False,16,122,1328,7,0,2024-06-18,True,True,True,0.911461908030199,0.08373369938229239,0.004804392587508579,0.0,Peak,Tuesday,June
2024-06-18 17:00:00,76,1408,4,0,1488,65,652,2,1,720,29.6,71,3,7.1,2208,False,17,141,2060,6,1,2024-06-18,True,True,True,0.9329710144927537,0.06385869565217392,0.002717391304347826,0.0004528985507246377,Peak,Tuesday,June
2024-06-18 18:00:00,49,860,4,1,914,60,723,5,1,789,29.4,72,3,5.1,1703,False,18,109,1583,9,2,2024-06-18,True,True,True,0.9295361127422196,0.06400469759248385,0.005284791544333529,0.0011743981209630064,Peak,Tuesday,June
2024-06-18 19:00:00,34,666,3,1,704,55,558,3,1,617,28.4,78,3,4.1,1321,False,19,89,1224,6,2,2024-06-18,True,True,False,0.9265707797123391,0.06737320211960636,0.004542013626040878,0.001514004542013626,Peak,Tuesday,June
2024-06-18 20:00:00,28,368,5,1,402,34,341,6,1,382,27.6,80,1,4.2,784,False,20,62,709,11,2,2024-06-18,True,True,False,0.9043367346938775,0.07908163265306123,0.01403061224489796,0.002551020408163265,Shoulder,Tuesday,June
2024-06-18 21:00:00,23,371,3,1,398,20,292,3,1,316,27.2,85,3,4.5,714,False,21,43,663,6,2,2024-06-18,True,True,False,0.9285714285714286,0.06022408963585434,0.008403361344537815,0.0028011204481792717,Shoulder,Tuesday,June
2024-06-18 22:00:00,18,315,9,1,343,19,295,4,1,319,26.7,86,3,4.2,662,False,22,37,610,13,2,2024-06-18,True,True,False,0.9214501510574018,0.055891238670694864,0.019637462235649546,0.0030211480362537764,Shoulder,Tuesday,June
2024-06-18 23:00:00,17,234,4,1,256,14,212,6,1,233,26.0,90,3,3.6,489,False,23,31,446,10,2,2024-06-18,True,True,False,0.9120654396728016,0.06339468302658487,0.02044989775051125,0.00408997955010225,Shoulder,Tuesday,June
2024-06-19 00:00:00,18,192,7,0,217,16,183,1,0,200,26.0,90,3,2.6,417,False,0,34,375,8,0,2024-06-19,False,False,False,0.8992805755395683,0.0815347721822542,0.019184652278177457,0.0,Off-Peak,Wednesday,June
2024-06-19 01:00:00,17,201,6,0,224,19,128,2,1,150,25.7,91,3,2.0,374,False,1,36,329,8,1,2024-06-19,False,False,False,0.8796791443850267,0.0962566844919786,0.0213903743315508,0.00267379679144385,Off-Peak,Wednesday,June
2024-06-19 02:00:00,30,207,6,0,243,30,283,2,0,315,25.8,87,3,6.3,558,False,2,60,490,8,0,2024-06-19,False,False,False,0.8781362007168458,0.10752688172043011,0.014336917562724014,0.0,Off-Peak,Wednesday,June
2024-06-19 03:00:00,45,350,6,0,401,26,346,1,0,373,25.8,88,3,7.2,774,False,3,71,696,7,0,2024-06-19,False,False,False,0.8992248062015504,0.0917312661498708,0.00904392764857881,0.0,Off-Peak,Wednesday,June
2024-06-19 04:00:00,44,518,5,0,567,35,321,1,0,357,25.4,94,3,4.8,924,False,4,79,839,6,0,2024-06-19,False,False,False,0.908008658008658,0.0854978354978355,0.006493506493506494,0.0,Off-Peak,Wednesday,June
2024-06-19 05:00:00,50,744,4,0,798,38,421,2,0,461,25.3,95,51,3.7,1259,False,5,88,1165,6,0,2024-06-19,False,False,False,0.9253375694996029,0.0698967434471803,0.004765687053216839,0.0,Shoulder,Wednesday,June
2024-06-19 06:00:00,32,763,6,0,801,47,671,2,0,720,25.0,95,51,3.2,1521,False,6,79,1434,8,0,2024-06-19,False,False,True,0.9428007889546351,0.05193951347797501,0.005259697567389875,0.0,Shoulder,Wednesday,June
2024-06-19 07:00:00,61,684,7,0,752,63,727,3,0,793,25.2,94,51,5.7,1545,False,7,124,1411,10,0,2024-06-19,False,False,True,0.9132686084142395,0.08025889967637541,0.006472491909385114,0.0,Peak,Wednesday,June
2024-06-19 08:00:00,58,609,4,0,671,59,687,3,0,749,26.5,91,3,4.0,1420,False,8,117,1296,7,0,2024-06-19,False,False,True,0.9126760563380282,0.0823943661971831,0.004929577464788733,0.0,Peak,Wednesday,June
2024-06-19 09:00:00,56,670,8,0,734,60,655,3,0,718,28.2,86,3,3.7,1452,False,9,116,1325,11,0,2024-06-19,False,False,True,0.912534435261708,0.07988980716253444,0.007575757575757576,0.0,Shoulder,Wednesday,June
2024-06-19 10:00:00,38,510,6,0,554,58,533,4,0,595,29.3,78,51,9.1,1149,False,10,96,1043,10,0,2024-06-19,False,False,False,0.9077458659704091,0.0835509138381201,0.008703220191470844,0.0,Shoulder,Wednesday,June
2024-06-19 11:00:00,57,389,6,1,453,17,420,2,1,440,29.7,76,51,11.1,893,False,11,74,809,8,2,2024-06-19,False,False,False,0.9059350503919373,0.08286674132138858,0.008958566629339306,0.0022396416573348264,Peak,Wednesday,June
2024-06-19 12:00:00,36,556,7,1,600,46,394,3,1,444,30.0,74,51,11.1,1044,False,12,82,950,10,2,2024-06-19,False,False,False,0.9099616858237548,0.07854406130268199,0.009578544061302681,0.0019157088122605363,Peak,Wednesday,June
2024-06-19 13:00:00,50,743,7,1,801,39,411,5,1,456,30.1,73,3,11.0,1257,False,13,89,1154,12,2,2024-06-19,False,False,False,0.9180588703261734,0.07080350039777247,0.00954653937947494,0.0015910898965791568,Peak,Wednesday,June
2024-06-19 14:00:00,50,432,6,1,489,44,486,3,1,534,30.1,73,3,10.8,1023,False,14,94,918,9,2,2024-06-19,False,False,False,0.8973607038123167,0.09188660801564028,0.008797653958944282,0.0019550342130987292,Peak,Wednesday,June
2024-06-19 15:00:00,62,594,6,1,663,53,559,3,1,616,29.8,73,3,10.5,1279,False,15,115,1153,9,2,2024-06-19,False,False,False,0.9014855355746677,0.08991399530883502,0.007036747458952306,0.001563721657544957,Peak,Wednesday,June
2024-06-19 16:00:00,62,722,7,1,792,67,754,3,1,825,29.7,73,3,9.0,1617,False,16,129,1476,10,2,2024-06-19,False,False,True,0.9128014842300557,0.07977736549165121,0.006184291898577613,0.0012368583797155227,Peak,Wednesday,June
2024-06-19 17:00:00,87,1003,4,1,1095,62,539,2,1,604,29.4,74,3,8.1,1699,False,17,149,1542,6,2,2024-06-19,False,False,True,0.90759270158917,0.08769864626250735,0.003531489111241907,0.0011771630370806356,Peak,Wednesday,June
2024-06-19 18:00:00,65,661,4,2,732,48,675,2,1,726,29.2,75,2,6.3,1458,False,18,113,1336,6,3,2024-06-19,False,False,True,0.9163237311385459,0.0775034293552812,0.00411522633744856,0.00205761316872428,Peak,Wednesday,June
2024-06-19 19:00:00,46,583,3,1,633,39,513,4,1,557,28.5,80,1,3.8,1190,False,19,85,1096,7,2,2024-06-19,False,False,False,0.9210084033613445,0.07142857142857142,0.0058823529411764705,0.0016806722689075631,Peak,Wednesday,June
2024-06-19 20:00:00,37,448,4,1,490,37,433,3,1,474,27.6,83,2,4.1,964,False,20,74,881,7,2,2024-06-19,False,False,False,0.9139004149377593,0.07676348547717843,0.007261410788381743,0.002074688796680498,Shoulder,Wednesday,June
2024-06-19 21:00:00,23,413,5,1,442,28,201,5,1,235,27.8,82,1,5.6,677,False,21,51,614,10,2,2024-06-19,False,False,False,0.9069423929098966,0.07533234859675036,0.014771048744460856,0.0029542097488921715,Shoulder,Wednesday,June
2024-06-19 22:00:00,19,265,12,1,297,16,163,5,1,185,27.2,86,3,4.3,482,False,22,35,428,17,2,2024-06-19,False,False,False,0.8879668049792531,0.07261410788381743,0.035269709543568464,0.004149377593360996,Shoulder,Wednesday,June
2024-06-19 23:00:00,18,191,10,1,220,11,193,2,1,207,26.6,89,3,4.3,427,False,23,29,384,12,2,2024-06-19,False,False,False,0.8992974238875878,0.06791569086651054,0.02810304449648712,0.00468384074941452,Shoulder,Wednesday,June
2024-06-20 00:00:00,19,192,6,0,217,17,132,6,0,155,26.1,90,3,3.9,372,False,0,36,324,12,0,2024-06-20,False,False,False,0.8709677419354839,0.0967741935483871,0.03225806451612903,0.0,Off-Peak,Thursday,June
2024-06-20 01:00:00,25,234,4,0,263,13,166,3,0,182,25.7,92,3,3.7,445,False,1,38,400,7,0,2024-06-20,False,False,False,0.898876404494382,0.0853932584269663,0.015730337078651686,0.0,Off-Peak,Thursday,June
2024-06-20 02:00:00,30,254,3,0,287,40,374,5,0,419,25.8,91,3,7.2,706,False,2,70,628,8,0,2024-06-20,False,False,False,0.8895184135977338,0.09915014164305949,0.0113314447592068,0.0,Off-Peak,Thursday,June
2024-06-20 03:00:00,48,304,4,0,356,58,214,5,0,277,26.2,90,53,14.8,633,False,3,106,518,9,0,2024-06-20,False,False,False,0.8183254344391785,0.1674565560821485,0.014218009478672985,0.0,Off-Peak,Thursday,June
2024-06-20 04:00:00,24,512,4,1,541,62,194,3,0,259,24.9,94,53,8.7,800,False,4,86,706,7,1,2024-06-20,False,False,False,0.8825,0.1075,0.00875,0.00125,Off-Peak,Thursday,June
2024-06-20 05:00:00,85,565,9,0,659,65,507,7,1,580,24.6,95,3,11.2,1239,False,5,150,1072,16,1,2024-06-20,False,False,False,0.8652138821630347,0.12106537530266344,0.0129136400322841,0.0008071025020177562,Shoulder,Thursday,June
2024-06-20 06:00:00,72,900,7,0,979,71,602,6,0,679,24.3,96,3,6.8,1658,False,6,143,1502,13,0,2024-06-20,False,False,True,0.9059107358262968,0.08624849215922799,0.007840772014475271,0.0,Shoulder,Thursday,June
2024-06-20 07:00:00,54,1138,6,0,1198,23,750,5,0,778,24.2,95,3,8.1,1976,False,7,77,1888,11,0,2024-06-20,False,False,True,0.9554655870445344,0.03896761133603239,0.005566801619433198,0.0,Peak,Thursday,June
2024-06-20 08:00:00,59,854,6,0,919,20,675,4,1,700,25.0,93,3,7.9,1619,False,8,79,1529,10,1,2024-06-20,False,False,True,0.9444101297096974,0.04879555281037678,0.006176652254478073,0.0006176652254478073,Peak,Thursday,June
2024-06-20 09:00:00,50,742,6,0,798,42,426,5,1,474,25.4,90,51,7.4,1272,False,9,92,1168,11,1,2024-06-20,False,False,False,0.9182389937106918,0.07232704402515723,0.008647798742138365,0.0007861635220125787,Shoulder,Thursday,June
2024-06-20 10:00:00,86,530,9,0,625,34,357,5,1,397,26.2,88,3,7.1,1022,False,10,120,887,14,1,2024-06-20,False,False,False,0.8679060665362035,0.11741682974559686,0.0136986301369863,0.0009784735812133072,Shoulder,Thursday,June
2024-06-20 11:00:00,26,240,3,0,269,66,662,7,1,736,28.4,80,3,12.8,1005,False,11,92,902,10,1,2024-06-20,False,False,False,0.8975124378109453,0.09154228855721393,0.009950248756218905,0.0009950248756218905,Peak,Thursday,June
2024-06-20 12:00:00,27,253,5,0,285,36,342,4,1,383,29.2,76,3,14.0,668,False,12,63,595,9,1,2024-06-20,False,False,False,0.8907185628742516,0.09431137724550898,0.01347305389221557,0.0014970059880239522,Peak,Thursday,June
2024-06-20 13:00:00,28,622,5,0,655,59,599,7,1,666,30.3,70,3,12.4,1321,False,13,87,1221,12,1,2024-06-20,False,False,False,0.9242997728993188,0.06585919757759273,0.009084027252081756,0.000757002271006813,Peak,Thursday,June
2024-06-20 14:00:00,53,527,6,0,586,50,488,6,1,545,31.0,66,2,12.6,1131,False,14,103,1015,12,1,2024-06-20,False,False,False,0.8974358974358975,0.09106984969053934,0.010610079575596816,0.0008841732979664014,Peak,Thursday,June
2024-06-20 15:00:00,79,795,10,0,884,50,634,6,1,691,30.8,66,1,14.1,1575,False,15,129,1429,16,1,2024-06-20,False,False,True,0.9073015873015873,0.08190476190476191,0.010158730158730159,0.0006349206349206349,Peak,Thursday,June
2024-06-20 16:00:00,84,889,4,0,977,77,624,7,1,709,30.7,66,2,13.7,1686,False,16,161,1513,11,1,2024-06-20,False,False,True,0.8973902728351127,0.09549228944246738,0.006524317912218268,0.0005931198102016608,Peak,Thursday,June
2024-06-20 17:00:00,111,670,9,0,790,73,711,8,1,793,30.3,67,3,12.9,1583,False,17,184,1381,17,1,2024-06-20,False,False,True,0.8723941882501579,0.1162349968414403,0.010739102969046115,0.0006317119393556538,Peak,Thursday,June
2024-06-20 18:00:00,98,968,5,1,1072,61,759,6,1,827,29.6,71,3,13.0,1899,False,18,159,1727,11,2,2024-06-20,False,False,True,0.9094260136914165,0.08372827804107424,0.005792522380200105,0.00105318588730911,Peak,Thursday,June
2024-06-20 19:00:00,64,279,5,1,349,43,451,5,1,500,28.8,74,3,9.1,849,False,19,107,730,10,2,2024-06-20,False,False,False,0.8598351001177856,0.12603062426383982,0.011778563015312132,0.002355712603062426,Peak,Thursday,June
2024-06-20 20:00:00,25,299,5,1,330,35,341,6,1,383,28.2,78,3,10.2,713,False,20,60,640,11,2,2024-06-20,False,False,False,0.8976157082748948,0.08415147265077139,0.015427769985974754,0.002805049088359046,Shoulder,Thursday,June
2024-06-20 21:00:00,28,298,13,1,340,34,336,5,1,376,27.9,80,3,4.9,716,False,21,62,634,18,2,2024-06-20,False,False,False,0.8854748603351955,0.08659217877094973,0.025139664804469275,0.002793296089385475,Shoulder,Thursday,June
2024-06-20 22:00:00,27,268,11,1,307,27,253,6,1,287,27.6,81,3,5.1,594,False,22,54,521,17,2,2024-06-20,False,False,False,0.877104377104377,0.09090909090909091,0.02861952861952862,0.003367003367003367,Shoulder,Thursday,June
2024-06-20 23:00:00,23,233,14,1,271,19,163,12,1,195,26.9,87,3,5.9,466,False,23,42,396,26,2,2024-06-20,False,False,False,0.8497854077253219,0.09012875536480687,0.055793991416309016,0.004291845493562232,Shoulder,Thursday,June
2024-06-21 00:00:00,18,211,6,0,235,17,191,7,0,215,27.7,78,3,3.5,450,False,0,35,402,13,0,2024-06-21,False,False,False,0.8933333333333333,0.07777777777777778,0.028888888888888888,0.0,Off-Peak,Friday,June
2024-06-21 01:00:00,26,302,5,0,333,19,246,4,0,269,26.2,90,3,15.4,602,False,1,45,548,9,0,2024-06-21,False,False,False,0.9102990033222591,0.07475083056478406,0.014950166112956811,0.0,Off-Peak,Friday,June
2024-06-21 02:00:00,34,402,9,0,445,24,299,4,0,327,25.9,88,51,14.8,772,False,2,58,701,13,0,2024-06-21,False,False,False,0.9080310880829016,0.07512953367875648,0.01683937823834197,0.0,Off-Peak,Friday,June
2024-06-21 03:00:00,34,376,8,0,418,27,370,6,0,403,25.8,85,51,15.5,821,False,3,61,746,14,0,2024-06-21,False,False,False,0.9086479902557856,0.07429963459196103,0.01705237515225335,0.0,Off-Peak,Friday,June
2024-06-21 04:00:00,50,643,8,1,702,39,395,3,0,437,25.9,88,51,11.0,1139,False,4,89,1038,11,1,2024-06-21,False,False,False,0.9113257243195786,0.0781387181738367,0.009657594381035996,0.000877963125548727,Off-Peak,Friday,June
2024-06-21 05:00:00,41,542,8,2,593,47,733,6,0,786,26.0,88,3,10.9,1379,False,5,88,1275,14,2,2024-06-21,False,False,True,0.9245830311820159,0.06381435823060189,0.01015228426395939,0.0014503263234227702,Shoulder,Friday,June
2024-06-21 06:00:00,59,781,6,1,847,59,672,6,0,737,25.6,89,51,12.7,1584,False,6,118,1453,12,1,2024-06-21,False,False,True,0.9172979797979798,0.07449494949494949,0.007575757575757576,0.0006313131313131314,Shoulder,Friday,June
2024-06-21 07:00:00,80,969,5,1,1055,63,775,5,0,843,25.3,90,51,9.0,1898,False,7,143,1744,10,1,2024-06-21,False,False,True,0.9188619599578504,0.07534246575342465,0.005268703898840885,0.0005268703898840885,Peak,Friday,June
2024-06-21 08:00:00,66,603,8,1,678,56,554,4,0,614,25.5,91,61,8.8,1292,False,8,122,1157,12,1,2024-06-21,False,False,False,0.8955108359133127,0.09442724458204334,0.009287925696594427,0.0007739938080495357,Peak,Friday,June
2024-06-21 09:00:00,52,458,7,1,518,44,459,4,0,507,26.6,86,51,13.7,1025,False,9,96,917,11,1,2024-06-21,False,False,False,0.8946341463414634,0.09365853658536585,0.010731707317073172,0.000975609756097561,Shoulder,Friday,June
2024-06-21 10:00:00,35,521,6,1,563,21,489,6,0,516,26.9,83,51,10.5,1079,False,10,56,1010,12,1,2024-06-21,False,False,False,0.9360518999073216,0.051899907321594066,0.011121408711770158,0.0009267840593141798,Shoulder,Friday,June
2024-06-21 11:00:00,38,423,7,1,469,38,205,7,0,250,27.9,79,51,12.7,719,False,11,76,628,14,1,2024-06-21,False,False,False,0.8734353268428373,0.10570236439499305,0.019471488178025034,0.0013908205841446453,Peak,Friday,June
2024-06-21 12:00:00,44,560,7,1,612,32,410,6,2,450,28.3,77,51,14.0,1062,False,12,76,970,13,3,2024-06-21,False,False,False,0.9133709981167608,0.07156308851224105,0.01224105461393597,0.002824858757062147,Peak,Friday,June
2024-06-21 13:00:00,37,577,5,1,620,31,370,3,1,405,28.3,77,51,14.2,1025,False,13,68,947,8,2,2024-06-21,False,False,False,0.9239024390243903,0.06634146341463415,0.007804878048780488,0.001951219512195122,Peak,Friday,June
2024-06-21 14:00:00,31,597,7,1,636,31,640,7,1,679,28.2,76,51,14.8,1315,False,14,62,1237,14,2,2024-06-21,False,False,False,0.9406844106463879,0.04714828897338403,0.01064638783269962,0.001520912547528517,Peak,Friday,June
2024-06-21 15:00:00,48,893,8,1,950,33,517,5,1,556,27.4,81,61,7.9,1506,False,15,81,1410,13,2,2024-06-21,False,False,True,0.9362549800796812,0.053784860557768925,0.008632138114209827,0.0013280212483399733,Peak,Friday,June
2024-06-21 16:00:00,56,786,11,1,854,53,687,3,1,744,27.1,83,3,7.6,1598,False,16,109,1473,14,2,2024-06-21,False,False,True,0.9217772215269087,0.06821026282853566,0.008760951188986232,0.0012515644555694619,Peak,Friday,June
2024-06-21 17:00:00,77,724,4,1,806,59,740,6,1,806,27.4,83,3,5.2,1612,False,17,136,1464,10,2,2024-06-21,False,False,True,0.9081885856079405,0.08436724565756824,0.00620347394540943,0.0012406947890818859,Peak,Friday,June
2024-06-21 18:00:00,65,599,9,1,674,60,687,8,1,756,27.5,82,3,6.9,1430,False,18,125,1286,17,2,2024-06-21,False,False,True,0.8993006993006993,0.08741258741258741,0.011888111888111888,0.0013986013986013986,Peak,Friday,June
2024-06-21 19:00:00,71,669,7,1,748,60,453,8,1,522,26.9,87,3,6.0,1270,False,19,131,1122,15,2,2024-06-21,False,False,False,0.8834645669291339,0.1031496062992126,0.011811023622047244,0.0015748031496062992,Peak,Friday,June
2024-06-21 20:00:00,51,387,7,1,446,45,354,4,1,404,26.6,89,3,3.7,850,False,20,96,741,11,2,2024-06-21,False,False,False,0.8717647058823529,0.11294117647058824,0.012941176470588235,0.002352941176470588,Shoulder,Friday,June
2024-06-21 21:00:00,44,448,7,1,500,29,229,10,1,269,27.0,93,51,3.3,769,False,21,73,677,17,2,2024-06-21,False,False,False,0.8803641092327699,0.09492847854356307,0.022106631989596878,0.002600780234070221,Shoulder,Friday,June
2024-06-21 22:00:00,49,397,11,1,458,18,189,5,1,213,25.0,94,63,12.6,671,False,22,67,586,16,2,2024-06-21,False,False,False,0.8733233979135618,0.09985096870342772,0.02384500745156483,0.0029806259314456036,Shoulder,Friday,June
2024-06-21 23:00:00,29,253,12,1,295,12,145,8,1,166,25.4,93,61,3.4,461,False,23,41,398,20,2,2024-06-21,False,False,False,0.8633405639913232,0.08893709327548807,0.04338394793926247,0.004338394793926247,Shoulder,Friday,June
2024-06-22 00:00:00,14,171,9,0,194,12,84,2,0,98,25.3,93,61,4.0,292,True,0,26,255,11,0,2024-06-22,False,False,False,0.8732876712328768,0.08904109589041095,0.03767123287671233,0.0,Off-Peak,Saturday,June
2024-06-22 01:00:00,26,205,10,0,241,11,106,2,0,119,25.2,94,55,7.2,360,True,1,37,311,12,0,2024-06-22,False,False,False,0.8638888888888889,0.10277777777777777,0.03333333333333333,0.0,Off-Peak,Saturday,June
2024-06-22 02:00:00,39,319,4,0,362,29,118,3,0,150,25.3,93,61,8.3,512,True,2,68,437,7,0,2024-06-22,False,False,False,0.853515625,0.1328125,0.013671875,0.0,Off-Peak,Saturday,June
2024-06-22 03:00:00,45,398,3,0,446,39,109,3,0,151,25.2,93,51,10.1,597,True,3,84,507,6,0,2024-06-22,False,False,False,0.8492462311557789,0.1407035175879397,0.010050251256281407,0.0,Off-Peak,Saturday,June
2024-06-22 04:00:00,54,460,3,0,517,38,289,4,0,331,25.4,91,51,12.1,848,True,4,92,749,7,0,2024-06-22,False,False,False,0.8832547169811321,0.10849056603773585,0.008254716981132075,0.0,Off-Peak,Saturday,June
2024-06-22 05:00:00,59,435,8,0,502,39,267,6,0,312,25.3,91,53,11.7,814,True,5,98,702,14,0,2024-06-22,False,False,False,0.8624078624078624,0.12039312039312039,0.0171990171990172,0.0,Shoulder,Saturday,June
2024-06-22 06:00:00,73,646,7,0,726,28,264,4,0,296,25.2,91,53,11.3,1022,True,6,101,910,11,0,2024-06-22,False,False,False,0.8904109589041096,0.09882583170254403,0.010763209393346379,0.0,Shoulder,Saturday,June
2024-06-22 07:00:00,64,767,10,1,842,29,261,3,0,293,25.1,92,51,8.9,1135,True,7,93,1028,13,1,2024-06-22,False,False,False,0.905726872246696,0.08193832599118943,0.01145374449339207,0.000881057268722467,Peak,Saturday,June
2024-06-22 08:00:00,65,758,8,0,831,50,363,4,0,417,25.8,90,51,9.2,1248,True,8,115,1121,12,0,2024-06-22,False,False,False,0.8982371794871795,0.0921474358974359,0.009615384615384616,0.0,Peak,Saturday,June
2024-06-22 09:00:00,37,501,6,0,544,55,500,5,0,560,25.0,86,53,11.2,1104,True,9,92,1001,11,0,2024-06-22,False,False,False,0.9067028985507246,0.08333333333333333,0.009963768115942028,0.0,Shoulder,Saturday,June
2024-06-22 10:00:00,44,406,6,0,456,59,552,5,0,616,24.9,87,55,10.8,1072,True,10,103,958,11,0,2024-06-22,False,False,False,0.8936567164179104,0.0960820895522388,0.010261194029850746,0.0,Shoulder,Saturday,June
2024-06-22 11:00:00,38,447,6,0,491,59,453,5,0,517,25.1,87,53,10.6,1008,True,11,97,900,11,0,2024-06-22,False,False,False,0.8928571428571429,0.09623015873015874,0.010912698412698412,0.0,Peak,Saturday,June
2024-06-22 12:00:00,36,471,6,1,514,48,282,5,1,336,25.7,83,53,12.4,850,True,12,84,753,11,2,2024-06-22,False,False,False,0.8858823529411765,0.0988235294117647,0.012941176470588235,0.002352941176470588,Peak,Saturday,June
2024-06-22 13:00:00,34,530,9,1,574,27,489,3,1,520,26.3,79,51,12.5,1094,True,13,61,1019,12,2,2024-06-22,False,False,False,0.9314442413162706,0.055758683729433274,0.010968921389396709,0.0018281535648994515,Peak,Saturday,June
2024-06-22 14:00:00,41,579,6,1,627,49,534,5,1,589,26.3,80,51,10.7,1216,True,14,90,1113,11,2,2024-06-22,False,False,False,0.915296052631579,0.07401315789473684,0.009046052631578948,0.001644736842105263,Peak,Saturday,June
2024-06-22 15:00:00,45,532,6,1,584,47,585,4,1,637,26.4,83,53,10.2,1221,True,15,92,1117,10,2,2024-06-22,False,False,False,0.9148239148239148,0.07534807534807535,0.00819000819000819,0.001638001638001638,Peak,Saturday,June
2024-06-22 16:00:00,56,678,7,1,742,47,571,5,1,624,26.6,82,51,11.1,1366,True,16,103,1249,12,2,2024-06-22,False,False,False,0.9143484626647145,0.07540263543191801,0.008784773060029283,0.0014641288433382138,Peak,Saturday,June
2024-06-22 17:00:00,65,862,7,1,935,51,462,5,2,520,26.4,79,51,10.6,1455,True,17,116,1324,12,3,2024-06-22,False,False,True,0.9099656357388316,0.07972508591065292,0.008247422680412371,0.002061855670103093,Peak,Saturday,June
2024-06-22 18:00:00,73,767,7,1,848,59,453,4,1,517,26.1,76,3,7.9,1365,True,18,132,1220,11,2,2024-06-22,False,False,False,0.8937728937728938,0.0967032967032967,0.00805860805860806,0.0014652014652014652,Peak,Saturday,June
2024-06-22 19:00:00,50,836,11,1,898,53,453,2,1,509,25.4,79,3,4.7,1407,True,19,103,1289,13,2,2024-06-22,False,False,True,0.916133617626155,0.07320540156361052,0.00923951670220327,0.0014214641080312722,Peak,Saturday,June
2024-06-22 20:00:00,43,622,8,1,674,47,339,2,1,389,25.2,79,3,5.4,1063,True,20,90,961,10,2,2024-06-22,False,False,False,0.9040451552210724,0.08466603951081844,0.00940733772342427,0.0018814675446848542,Shoulder,Saturday,June
2024-06-22 21:00:00,32,367,7,1,407,28,375,4,1,408,25.3,88,3,4.1,815,True,21,60,742,11,2,2024-06-22,False,False,False,0.9104294478527607,0.0736196319018405,0.013496932515337423,0.00245398773006135,Shoulder,Saturday,June
2024-06-22 22:00:00,28,382,7,1,418,12,468,6,1,487,26.1,75,3,10.3,905,True,22,40,850,13,2,2024-06-22,False,False,False,0.9392265193370166,0.04419889502762431,0.014364640883977901,0.0022099447513812156,Shoulder,Saturday,June
2024-06-22 23:00:00,18,309,7,1,335,8,406,6,1,421,26.3,73,3,9.2,756,True,23,26,715,13,2,2024-06-22,False,False,False,0.9457671957671958,0.03439153439153439,0.017195767195767195,0.0026455026455026454,Shoulder,Saturday,June
2024-06-23 00:00:00,17,186,2,0,205,11,87,4,0,102,25.8,77,3,5.4,307,True,0,28,273,6,0,2024-06-23,False,False,False,0.8892508143322475,0.09120521172638436,0.019543973941368076,0.0,Off-Peak,Sunday,June
2024-06-23 01:00:00,14,132,9,0,155,26,244,6,0,276,24.8,86,3,6.2,431,True,1,40,376,15,0,2024-06-23,False,False,False,0.8723897911832946,0.09280742459396751,0.03480278422273782,0.0,Off-Peak,Sunday,June
2024-06-23 02:00:00,18,134,6,0,158,29,225,4,0,258,25.4,87,3,5.9,416,True,2,47,359,10,0,2024-06-23,False,False,False,0.8629807692307693,0.11298076923076923,0.02403846153846154,0.0,Off-Peak,Sunday,June
2024-06-23 03:00:00,30,200,6,0,236,30,219,5,0,254,25.5,90,3,6.3,490,True,3,60,419,11,0,2024-06-23,False,False,False,0.8551020408163266,0.12244897959183673,0.022448979591836733,0.0,Off-Peak,Sunday,June
2024-06-23 04:00:00,66,392,8,0,466,37,260,6,0,303,25.8,89,3,7.3,769,True,4,103,652,14,0,2024-06-23,False,False,False,0.8478543563068921,0.13394018205461639,0.018205461638491547,0.0,Off-Peak,Sunday,June
2024-06-23 05:00:00,40,166,6,0,212,37,272,5,0,314,26.0,88,3,8.7,526,True,5,77,438,11,0,2024-06-23,False,False,False,0.8326996197718631,0.14638783269961977,0.02091254752851711,0.0,Shoulder,Sunday,June
2024-06-23 06:00:00,49,479,8,0,536,56,355,5,0,416,25.8,90,3,8.9,952,True,6,105,834,13,0,2024-06-23,False,False,False,0.8760504201680672,0.11029411764705882,0.01365546218487395,0.0,Shoulder,Sunday,June
2024-06-23 07:00:00,64,409,5,0,478,46,505,5,0,556,25.7,90,2,7.9,1034,True,7,110,914,10,0,2024-06-23,False,False,False,0.8839458413926499,0.10638297872340426,0.009671179883945842,0.0,Peak,Sunday,June
2024-06-23 08:00:00,46,343,3,0,392,52,326,5,0,383,26.3,89,2,9.7,775,True,8,98,669,8,0,2024-06-23,False,False,False,0.863225806451613,0.12645161290322582,0.01032258064516129,0.0,Peak,Sunday,June
2024-06-23 09:00:00,63,575,7,0,645,44,472,4,0,520,27.8,81,3,11.1,1165,True,9,107,1047,11,0,2024-06-23,False,False,False,0.8987124463519314,0.09184549356223176,0.00944206008583691,0.0,Shoulder,Sunday,June
2024-06-23 10:00:00,51,619,8,0,678,42,392,7,1,442,28.6,77,51,15.3,1120,True,10,93,1011,15,1,2024-06-23,False,False,False,0.9026785714285714,0.08303571428571428,0.013392857142857142,0.0008928571428571428,Shoulder,Sunday,June
2024-06-23 11:00:00,57,409,5,0,471,42,304,4,0,350,29.2,76,51,14.4,821,True,11,99,713,9,0,2024-06-23,False,False,False,0.8684531059683313,0.12058465286236297,0.010962241169305725,0.0,Peak,Sunday,June
2024-06-23 12:00:00,13,697,9,0,719,31,442,4,0,477,29.7,75,51,14.0,1196,True,12,44,1139,13,0,2024-06-23,False,False,False,0.9523411371237458,0.03678929765886288,0.010869565217391304,0.0,Peak,Sunday,June
2024-06-23 13:00:00,65,743,5,0,813,32,384,5,0,421,30.0,74,3,14.7,1234,True,13,97,1127,10,0,2024-06-23,False,False,False,0.913290113452188,0.07860615883306321,0.008103727714748784,0.0,Peak,Sunday,June
2024-06-23 14:00:00,15,482,7,0,504,56,339,6,0,401,30.2,73,3,15.4,905,True,14,71,821,13,0,2024-06-23,False,False,False,0.907182320441989,0.07845303867403315,0.014364640883977901,0.0,Peak,Sunday,June
2024-06-23 15:00:00,45,553,4,0,602,44,472,5,0,521,30.0,73,3,15.2,1123,True,15,89,1025,9,0,2024-06-23,False,False,False,0.9127337488869101,0.0792520035618878,0.008014247551202136,0.0,Peak,Sunday,June
2024-06-23 16:00:00,39,501,6,0,546,44,355,5,0,404,29.9,74,3,16.3,950,True,16,83,856,11,0,2024-06-23,False,False,False,0.9010526315789473,0.08736842105263158,0.011578947368421053,0.0,Peak,Sunday,June
2024-06-23 17:00:00,48,533,6,0,587,63,371,8,0,442,29.5,78,3,15.3,1029,True,17,111,904,14,0,2024-06-23,False,False,False,0.8785228377065112,0.10787172011661808,0.013605442176870748,0.0,Peak,Sunday,June
2024-06-23 18:00:00,49,546,7,0,602,58,525,6,0,589,29.2,78,3,15.6,1191,True,18,107,1071,13,0,2024-06-23,False,False,False,0.8992443324937027,0.08984047019311503,0.0109151973131822,0.0,Peak,Sunday,June
2024-06-23 19:00:00,49,713,5,1,768,59,476,6,1,542,28.7,78,3,15.0,1310,True,19,108,1189,11,2,2024-06-23,False,False,False,0.9076335877862596,0.08244274809160305,0.008396946564885497,0.0015267175572519084,Peak,Sunday,June
2024-06-23 20:00:00,37,731,3,1,772,40,304,4,1,349,28.6,75,3,13.5,1121,True,20,77,1035,7,2,2024-06-23,False,False,False,0.9232827832292596,0.06868867082961641,0.006244424620874219,0.001784121320249777,Shoulder,Sunday,June
2024-06-23 21:00:00,75,776,10,2,863,55,216,8,1,280,28.1,75,3,11.1,1143,True,21,130,992,18,3,2024-06-23,False,False,False,0.8678915135608049,0.1137357830271216,0.015748031496062992,0.0026246719160104987,Shoulder,Sunday,June
2024-06-23 22:00:00,36,415,4,1,456,25,439,3,1,468,27.6,78,3,10.8,924,True,22,61,854,7,2,2024-06-23,False,False,False,0.9242424242424242,0.06601731601731602,0.007575757575757576,0.0021645021645021645,Shoulder,Sunday,June
2024-06-23 23:00:00,49,498,10,1,558,47,355,7,1,410,27.3,81,3,9.8,968,True,23,96,853,17,2,2024-06-23,False,False,False,0.881198347107438,0.09917355371900827,0.01756198347107438,0.002066115702479339,Shoulder,Sunday,June
2024-06-24 00:00:00,44,275,4,0,323,53,303,7,0,363,26.9,83,3,9.0,686,False,0,97,578,11,0,2024-06-24,False,False,False,0.8425655976676385,0.141399416909621,0.016034985422740525,0.0,Off-Peak,Monday,June
2024-06-24 01:00:00,24,268,2,0,294,69,276,9,0,354,26.5,85,3,7.1,648,False,1,93,544,11,0,2024-06-24,False,False,False,0.8395061728395061,0.14351851851851852,0.016975308641975308,0.0,Off-Peak,Monday,June
2024-06-24 02:00:00,19,227,3,0,249,24,223,4,0,251,26.0,86,3,5.8,500,False,2,43,450,7,0,2024-06-24,False,False,False,0.9,0.086,0.014,0.0,Off-Peak,Monday,June
2024-06-24 03:00:00,21,206,9,0,236,24,159,8,0,191,25.4,88,3,5.0,427,False,3,45,365,17,0,2024-06-24,False,False,False,0.8548009367681498,0.1053864168618267,0.03981264637002342,0.0,Off-Peak,Monday,June
2024-06-24 04:00:00,18,191,7,0,216,33,164,5,0,202,24.9,90,3,4.5,418,False,4,51,355,12,0,2024-06-24,False,False,False,0.8492822966507177,0.12200956937799043,0.028708133971291867,0.0,Off-Peak,Monday,June
2024-06-24 05:00:00,16,471,2,0,489,14,138,2,0,154,25.1,89,3,3.3,643,False,5,30,609,4,0,2024-06-24,False,False,False,0.9471228615863142,0.04665629860031104,0.006220839813374806,0.0,Shoulder,Monday,June
2024-06-24 06:00:00,43,513,5,0,561,62,264,8,0,334,25.0,90,3,2.9,895,False,6,105,777,13,0,2024-06-24,False,False,False,0.8681564245810056,0.11731843575418995,0.01452513966480447,0.0,Shoulder,Monday,June
2024-06-24 07:00:00,86,881,5,0,972,58,744,5,0,807,24.9,89,3,4.0,1779,False,7,144,1625,10,0,2024-06-24,False,False,True,0.9134345137717819,0.08094435075885328,0.005621135469364812,0.0,Peak,Monday,June
2024-06-24 08:00:00,87,999,9,0,1095,53,828,7,0,888,26.1,87,3,5.8,1983,False,8,140,1827,16,0,2024-06-24,False,False,True,0.9213313161875946,0.07060010085728693,0.008068582955118508,0.0,Peak,Monday,June
2024-06-24 09:00:00,26,324,3,0,353,26,590,4,0,620,28.1,80,3,6.9,973,False,9,52,914,7,0,2024-06-24,False,False,False,0.9393627954779034,0.05344295991778006,0.007194244604316547,0.0,Shoulder,Monday,June
2024-06-24 10:00:00,77,863,7,0,947,45,506,7,1,559,29.0,72,51,12.1,1506,False,10,122,1369,14,1,2024-06-24,False,False,True,0.9090305444887118,0.08100929614873838,0.009296148738379814,0.0006640106241699867,Shoulder,Monday,June
2024-06-24 11:00:00,42,991,9,0,1042,75,851,13,0,939,29.5,71,2,13.0,1981,False,11,117,1842,22,0,2024-06-24,False,False,True,0.9298334174659263,0.05906108026249369,0.01110550227158001,0.0,Peak,Monday,June
2024-06-24 12:00:00,25,540,3,0,568,58,692,9,0,759,30.0,70,2,12.6,1327,False,12,83,1232,12,0,2024-06-24,False,False,False,0.9284099472494348,0.06254709871891484,0.00904295403165034,0.0,Peak,Monday,June
2024-06-24 13:00:00,57,834,6,0,897,30,344,4,0,378,30.3,69,3,14.2,1275,False,13,87,1178,10,0,2024-06-24,False,False,False,0.923921568627451,0.06823529411764706,0.00784313725490196,0.0,Peak,Monday,June
2024-06-24 14:00:00,78,887,10,0,975,19,669,3,0,691,30.5,67,3,14.5,1666,False,14,97,1556,13,0,2024-06-24,False,False,True,0.9339735894357744,0.05822328931572629,0.0078031212484993995,0.0,Peak,Monday,June
2024-06-24 15:00:00,80,1102,5,1,1188,73,790,10,0,873,30.4,65,2,14.2,2061,False,15,153,1892,15,1,2024-06-24,False,False,True,0.9180009704027171,0.07423580786026202,0.00727802037845706,0.00048520135856380397,Peak,Monday,June
2024-06-24 16:00:00,88,966,10,0,1064,59,756,9,0,824,30.2,64,3,14.0,1888,False,16,147,1722,19,0,2024-06-24,False,False,True,0.9120762711864406,0.07786016949152542,0.010063559322033898,0.0,Peak,Monday,June
2024-06-24 17:00:00,62,695,2,1,760,36,672,6,1,715,29.7,66,3,13.1,1475,False,17,98,1367,8,2,2024-06-24,False,False,True,0.9267796610169492,0.06644067796610169,0.005423728813559322,0.0013559322033898306,Peak,Monday,June
2024-06-24 18:00:00,40,619,4,1,664,66,587,10,1,664,29.3,68,3,13.2,1328,False,18,106,1206,14,2,2024-06-24,False,False,False,0.9081325301204819,0.07981927710843373,0.010542168674698794,0.0015060240963855422,Peak,Monday,June
2024-06-24 19:00:00,74,495,10,1,580,38,409,7,1,455,28.7,74,3,11.1,1035,False,19,112,904,17,2,2024-06-24,False,False,False,0.8734299516908213,0.10821256038647344,0.01642512077294686,0.001932367149758454,Peak,Monday,June
2024-06-24 20:00:00,102,447,13,1,563,12,428,2,1,443,28.2,78,3,9.7,1006,False,20,114,875,15,2,2024-06-24,False,False,False,0.8697813121272365,0.11332007952286283,0.014910536779324055,0.0019880715705765406,Shoulder,Monday,June
2024-06-24 21:00:00,32,351,6,1,390,63,653,11,1,728,27.9,79,3,8.4,1118,False,21,95,1004,17,2,2024-06-24,False,False,False,0.8980322003577818,0.08497316636851521,0.01520572450805009,0.0017889087656529517,Shoulder,Monday,June
2024-06-24 22:00:00,50,261,7,1,319,28,372,6,1,407,27.6,81,1,9.4,726,False,22,78,633,13,2,2024-06-24,False,False,False,0.871900826446281,0.10743801652892562,0.01790633608815427,0.0027548209366391185,Shoulder,Monday,June
2024-06-24 23:00:00,32,288,5,1,326,13,279,3,1,296,27.2,81,3,10.5,622,False,23,45,567,8,2,2024-06-24,False,False,False,0.9115755627009646,0.07234726688102894,0.012861736334405145,0.003215434083601286,Shoulder,Monday,June
2024-06-25 00:00:00,72,335,5,0,412,73,344,12,0,429,27.1,83,2,10.5,841,False,0,145,679,17,0,2024-06-25,False,False,False,0.807372175980975,0.1724137931034483,0.020214030915576695,0.0,Off-Peak,Tuesday,June
2024-06-25 01:00:00,68,228,3,1,300,43,303,9,0,355,26.7,85,3,10.1,655,False,1,111,531,12,1,2024-06-25,False,False,False,0.8106870229007633,0.16946564885496182,0.0183206106870229,0.0015267175572519084,Off-Peak,Tuesday,June
2024-06-25 02:00:00,43,207,3,0,253,33,263,2,0,298,26.5,87,3,9.7,551,False,2,76,470,5,0,2024-06-25,False,False,False,0.852994555353902,0.13793103448275862,0.009074410163339383,0.0,Off-Peak,Tuesday,June
2024-06-25 03:00:00,29,208,4,0,241,12,136,7,0,155,26.2,89,3,6.5,396,False,3,41,344,11,0,2024-06-25,False,False,False,0.8686868686868687,0.10353535353535354,0.027777777777777776,0.0,Off-Peak,Tuesday,June
2024-06-25 04:00:00,19,193,1,0,213,39,108,5,0,152,26.0,90,3,5.9,365,False,4,58,301,6,0,2024-06-25,False,False,False,0.8246575342465754,0.1589041095890411,0.01643835616438356,0.0,Off-Peak,Tuesday,June
2024-06-25 05:00:00,17,282,4,0,303,34,215,4,0,253,25.6,93,3,4.2,556,False,5,51,497,8,0,2024-06-25,False,False,False,0.8938848920863309,0.09172661870503597,0.014388489208633094,0.0,Shoulder,Tuesday,June
2024-06-25 06:00:00,52,608,3,0,663,70,478,4,0,552,25.1,96,3,4.1,1215,False,6,122,1086,7,0,2024-06-25,False,False,False,0.8938271604938272,0.10041152263374485,0.005761316872427984,0.0,Shoulder,Tuesday,June
2024-06-25 07:00:00,64,722,2,0,788,66,773,5,0,844,25.3,93,3,3.9,1632,False,7,130,1495,7,0,2024-06-25,False,False,True,0.9160539215686274,0.07965686274509803,0.00428921568627451,0.0,Peak,Tuesday,June
2024-06-25 08:00:00,60,848,1,0,909,37,760,5,0,802,25.9,91,3,7.3,1711,False,8,97,1608,6,0,2024-06-25,False,False,True,0.9398012857977791,0.05669199298655757,0.0035067212156633548,0.0,Peak,Tuesday,June
2024-06-25 09:00:00,57,320,2,0,379,27,379,6,1,413,27.8,84,2,7.6,792,False,9,84,699,8,1,2024-06-25,False,False,False,0.8825757575757576,0.10606060606060606,0.010101010101010102,0.0012626262626262627,Shoulder,Tuesday,June
2024-06-25 10:00:00,31,669,4,0,704,51,576,9,0,636,29.4,76,51,9.2,1340,False,10,82,1245,13,0,2024-06-25,False,False,False,0.9291044776119403,0.06119402985074627,0.009701492537313432,0.0,Shoulder,Tuesday,June
2024-06-25 11:00:00,23,260,3,0,286,54,627,8,0,689,30.1,72,3,11.2,975,False,11,77,887,11,0,2024-06-25,False,False,False,0.9097435897435897,0.07897435897435898,0.011282051282051283,0.0,Peak,Tuesday,June
2024-06-25 12:00:00,26,506,2,0,534,23,431,5,0,459,30.7,70,3,12.6,993,False,12,49,937,7,0,2024-06-25,False,False,False,0.9436052366565961,0.04934541792547835,0.007049345417925478,0.0,Peak,Tuesday,June
2024-06-25 13:00:00,20,602,3,0,625,37,393,5,0,435,31.1,68,2,12.6,1060,False,13,57,995,8,0,2024-06-25,False,False,False,0.9386792452830188,0.05377358490566038,0.007547169811320755,0.0,Peak,Tuesday,June
2024-06-25 14:00:00,50,823,4,0,877,51,595,9,0,655,31.1,69,51,14.2,1532,False,14,101,1418,13,0,2024-06-25,False,False,True,0.9255874673629243,0.06592689295039164,0.008485639686684074,0.0,Peak,Tuesday,June
2024-06-25 15:00:00,77,907,6,0,990,56,605,10,0,671,31.0,69,2,14.8,1661,False,15,133,1512,16,0,2024-06-25,False,False,True,0.9102950030102348,0.08007224563515954,0.00963275135460566,0.0,Peak,Tuesday,June
2024-06-25 16:00:00,51,603,4,0,658,35,374,6,0,415,30.8,69,1,15.3,1073,False,16,86,977,10,0,2024-06-25,False,False,False,0.9105312208760484,0.08014911463187326,0.009319664492078284,0.0,Peak,Tuesday,June
2024-06-25 17:00:00,47,562,4,0,613,31,734,11,0,776,30.5,71,0,15.0,1389,False,17,78,1296,15,0,2024-06-25,False,False,True,0.9330453563714903,0.056155507559395246,0.01079913606911447,0.0,Peak,Tuesday,June
2024-06-25 18:00:00,59,766,5,0,830,50,535,9,0,594,30.1,72,1,12.3,1424,False,18,109,1301,14,0,2024-06-25,False,False,True,0.913623595505618,0.07654494382022473,0.009831460674157303,0.0,Peak,Tuesday,June
2024-06-25 19:00:00,62,726,5,1,794,69,758,10,1,838,29.4,75,0,10.2,1632,False,19,131,1484,15,2,2024-06-25,False,False,True,0.9093137254901961,0.08026960784313726,0.009191176470588236,0.0012254901960784314,Peak,Tuesday,June
2024-06-25 20:00:00,17,336,3,1,357,52,560,9,1,622,28.8,77,1,11.5,979,False,20,69,896,12,2,2024-06-25,False,False,False,0.9152196118488254,0.07048008171603677,0.012257405515832482,0.0020429009193054137,Shoulder,Tuesday,June
2024-06-25 21:00:00,23,674,6,1,704,19,381,5,1,406,28.7,80,1,8.9,1110,False,21,42,1055,11,2,2024-06-25,False,False,False,0.9504504504504504,0.03783783783783784,0.00990990990990991,0.0018018018018018018,Shoulder,Tuesday,June
2024-06-25 22:00:00,51,566,6,1,624,39,423,9,1,472,28.3,81,1,11.5,1096,False,22,90,989,15,2,2024-06-25,False,False,False,0.9023722627737226,0.08211678832116788,0.013686131386861315,0.0018248175182481751,Shoulder,Tuesday,June
2024-06-25 23:00:00,36,409,4,1,450,11,369,4,1,385,27.8,84,1,12.1,835,False,23,47,778,8,2,2024-06-25,False,False,False,0.9317365269461078,0.0562874251497006,0.009580838323353293,0.0023952095808383233,Shoulder,Tuesday,June
2024-06-26 00:00:00,64,261,9,0,334,54,186,1,0,241,27.4,85,0,11.7,575,False,0,118,447,10,0,2024-06-26,False,False,False,0.7773913043478261,0.20521739130434782,0.017391304347826087,0.0,Off-Peak,Wednesday,June
2024-06-26 01:00:00,56,200,4,0,260,57,158,2,0,217,26.9,86,0,10.1,477,False,1,113,358,6,0,2024-06-26,False,False,False,0.750524109014675,0.23689727463312368,0.012578616352201259,0.0,Off-Peak,Wednesday,June
2024-06-26 02:00:00,20,166,9,0,195,14,141,4,0,159,26.4,86,1,8.7,354,False,2,34,307,13,0,2024-06-26,False,False,False,0.867231638418079,0.096045197740113,0.03672316384180791,0.0,Off-Peak,Wednesday,June
2024-06-26 03:00:00,16,155,4,0,175,22,134,1,0,157,26.0,87,3,8.3,332,False,3,38,289,5,0,2024-06-26,False,False,False,0.8704819277108434,0.1144578313253012,0.015060240963855422,0.0,Off-Peak,Wednesday,June
2024-06-26 04:00:00,15,135,3,0,153,14,128,4,0,146,25.8,88,2,9.1,299,False,4,29,263,7,0,2024-06-26,False,False,False,0.8795986622073578,0.09698996655518395,0.023411371237458192,0.0,Off-Peak,Wednesday,June
2024-06-26 05:00:00,13,131,7,0,151,33,214,3,0,250,25.7,88,1,8.8,401,False,5,46,345,10,0,2024-06-26,False,False,False,0.8603491271820449,0.11471321695760599,0.02493765586034913,0.0,Shoulder,Wednesday,June
2024-06-26 06:00:00,38,383,2,0,423,74,728,6,0,808,25.5,89,2,6.8,1231,False,6,112,1111,8,0,2024-06-26,False,False,False,0.9025182778229082,0.09098294069861901,0.006498781478472786,0.0,Shoulder,Wednesday,June
2024-06-26 07:00:00,69,738,9,0,816,71,930,2,0,1003,25.3,90,3,6.6,1819,False,7,140,1668,11,0,2024-06-26,False,False,True,0.9169873556899395,0.07696536558548653,0.006047278724573941,0.0,Peak,Wednesday,June
2024-06-26 08:00:00,28,686,5,0,719,17,818,3,0,838,25.8,90,3,5.2,1557,False,8,45,1504,8,0,2024-06-26,False,False,True,0.9659601798330122,0.028901734104046242,0.005138086062941554,0.0,Peak,Wednesday,June
2024-06-26 09:00:00,35,560,5,0,600,53,560,4,0,617,27.9,81,1,10.3,1217,False,9,88,1120,9,0,2024-06-26,False,False,False,0.9202958093672966,0.07230895645028759,0.007395234182415777,0.0,Shoulder,Wednesday,June
2024-06-26 10:00:00,18,300,4,0,322,41,417,3,0,461,29.4,72,2,8.7,783,False,10,59,717,7,0,2024-06-26,False,False,False,0.9157088122605364,0.07535121328224777,0.008939974457215836,0.0,Shoulder,Wednesday,June
2024-06-26 11:00:00,57,605,8,0,670,19,336,2,0,357,30.4,65,3,9.8,1027,False,11,76,941,10,0,2024-06-26,False,False,False,0.9162609542356378,0.07400194741966894,0.009737098344693282,0.0,Peak,Wednesday,June
2024-06-26 12:00:00,32,316,5,0,353,41,438,3,0,482,31.3,62,3,8.7,835,False,12,73,754,8,0,2024-06-26,False,False,False,0.9029940119760479,0.08742514970059881,0.009580838323353293,0.0,Peak,Wednesday,June
2024-06-26 13:00:00,36,390,6,0,432,78,556,5,0,639,30.6,65,51,8.4,1071,False,13,114,946,11,0,2024-06-26,False,False,False,0.8832866479925303,0.10644257703081232,0.01027077497665733,0.0,Peak,Wednesday,June
2024-06-26 14:00:00,41,442,6,0,489,51,520,4,0,575,30.4,69,51,8.4,1064,False,14,92,962,10,0,2024-06-26,False,False,False,0.9041353383458647,0.08646616541353383,0.009398496240601503,0.0,Peak,Wednesday,June
2024-06-26 15:00:00,80,836,10,0,926,70,731,5,0,806,30.3,72,51,8.7,1732,False,15,150,1567,15,0,2024-06-26,False,False,True,0.9047344110854504,0.08660508083140878,0.008660508083140877,0.0,Peak,Wednesday,June
2024-06-26 16:00:00,50,737,7,0,794,30,312,3,0,345,30.0,72,53,9.3,1139,False,16,80,1049,10,0,2024-06-26,False,False,False,0.9209833187006146,0.07023705004389816,0.00877963125548727,0.0,Peak,Wednesday,June
2024-06-26 17:00:00,64,667,10,0,741,25,587,2,0,614,29.9,74,51,10.2,1355,False,17,89,1254,12,0,2024-06-26,False,False,False,0.9254612546125461,0.06568265682656826,0.008856088560885609,0.0,Peak,Wednesday,June
2024-06-26 18:00:00,29,519,4,2,554,13,768,2,1,784,29.4,75,3,8.2,1338,False,18,42,1287,6,3,2024-06-26,False,False,False,0.9618834080717489,0.03139013452914798,0.004484304932735426,0.002242152466367713,Peak,Wednesday,June
2024-06-26 19:00:00,75,780,13,1,869,30,316,3,1,350,28.8,78,3,6.0,1219,False,19,105,1096,16,2,2024-06-26,False,False,False,0.8990976210008204,0.08613617719442165,0.013125512715340444,0.0016406890894175555,Peak,Wednesday,June
2024-06-26 20:00:00,56,582,9,1,648,44,419,5,1,469,28.1,80,3,8.0,1117,False,20,100,1001,14,2,2024-06-26,False,False,False,0.8961504028648165,0.08952551477170993,0.012533572068039392,0.0017905102954341987,Shoulder,Wednesday,June
2024-06-26 21:00:00,26,442,5,1,474,57,579,5,1,642,27.4,88,3,3.9,1116,False,21,83,1021,10,2,2024-06-26,False,False,False,0.9148745519713262,0.07437275985663082,0.008960573476702509,0.0017921146953405018,Shoulder,Wednesday,June
2024-06-26 22:00:00,42,389,7,1,439,51,512,5,1,569,27.1,89,3,6.4,1008,False,22,93,901,12,2,2024-06-26,False,False,False,0.8938492063492064,0.09226190476190477,0.011904761904761904,0.001984126984126984,Shoulder,Wednesday,June
2024-06-26 23:00:00,69,308,7,1,385,96,240,12,2,350,27.1,87,3,7.9,735,False,23,165,548,19,3,2024-06-26,False,False,False,0.745578231292517,0.22448979591836735,0.02585034013605442,0.004081632653061225,Shoulder,Wednesday,June
2024-06-27 00:00:00,29,317,11,0,357,37,284,3,0,324,26.8,87,3,8.7,681,False,0,66,601,14,0,2024-06-27,False,False,False,0.882525697503671,0.09691629955947137,0.020558002936857563,0.0,Off-Peak,Thursday,June
2024-06-27 01:00:00,31,200,5,0,236,25,290,3,0,318,26.3,89,2,7.4,554,False,1,56,490,8,0,2024-06-27,False,False,False,0.8844765342960289,0.10108303249097472,0.01444043321299639,0.0,Off-Peak,Thursday,June
2024-06-27 02:00:00,33,194,8,0,235,19,238,3,0,260,26.0,90,3,8.5,495,False,2,52,432,11,0,2024-06-27,False,False,False,0.8727272727272727,0.10505050505050505,0.022222222222222223,0.0,Off-Peak,Thursday,June
2024-06-27 03:00:00,18,170,3,0,191,9,127,4,0,140,25.6,90,3,10.0,331,False,3,27,297,7,0,2024-06-27,False,False,False,0.8972809667673716,0.08157099697885196,0.021148036253776436,0.0,Off-Peak,Thursday,June
2024-06-27 04:00:00,17,169,4,0,190,12,126,2,0,140,25.1,92,3,11.0,330,False,4,29,295,6,0,2024-06-27,False,False,False,0.8939393939393939,0.08787878787878788,0.01818181818181818,0.0,Off-Peak,Thursday,June
2024-06-27 05:00:00,15,155,8,0,178,10,116,2,0,128,24.6,93,3,11.0,306,False,5,25,271,10,0,2024-06-27,False,False,False,0.8856209150326797,0.08169934640522876,0.032679738562091505,0.0,Shoulder,Thursday,June
2024-06-27 06:00:00,52,329,7,0,388,52,457,6,1,516,24.3,92,3,10.7,904,False,6,104,786,13,1,2024-06-27,False,False,False,0.8694690265486725,0.11504424778761062,0.014380530973451327,0.0011061946902654867,Shoulder,Thursday,June
2024-06-27 07:00:00,65,546,7,0,618,58,744,5,0,807,24.2,92,3,10.7,1425,False,7,123,1290,12,0,2024-06-27,False,False,True,0.9052631578947369,0.0863157894736842,0.008421052631578947,0.0,Peak,Thursday,June
2024-06-27 08:00:00,54,769,8,0,831,50,620,5,0,675,24.8,91,3,9.8,1506,False,8,104,1389,13,0,2024-06-27,False,False,True,0.9223107569721115,0.06905710491367861,0.008632138114209827,0.0,Peak,Thursday,June
2024-06-27 09:00:00,52,573,2,0,627,29,371,3,0,403,26.4,84,2,8.4,1030,False,9,81,944,5,0,2024-06-27,False,False,False,0.916504854368932,0.07864077669902912,0.0048543689320388345,0.0,Shoulder,Thursday,June
2024-06-27 10:00:00,62,649,9,0,720,37,458,2,0,497,28.5,77,1,8.7,1217,False,10,99,1107,11,0,2024-06-27,False,False,False,0.9096138044371405,0.08134757600657354,0.009038619556285949,0.0,Shoulder,Thursday,June
2024-06-27 11:00:00,59,621,2,0,682,59,433,5,0,497,30.2,69,1,5.5,1179,False,11,118,1054,7,0,2024-06-27,False,False,False,0.8939779474130619,0.10008481764206956,0.005937234944868533,0.0,Peak,Thursday,June
2024-06-27 12:00:00,34,356,5,1,396,36,462,4,1,503,31.3,64,2,5.3,899,False,12,70,818,9,2,2024-06-27,False,False,False,0.9098998887652948,0.0778642936596218,0.010011123470522803,0.002224694104560623,Peak,Thursday,June
2024-06-27 13:00:00,31,523,5,2,561,24,715,3,1,743,31.9,63,51,3.8,1304,False,13,55,1238,8,3,2024-06-27,False,False,False,0.9493865030674846,0.04217791411042945,0.006134969325153374,0.0023006134969325155,Peak,Thursday,June
2024-06-27 14:00:00,69,715,10,1,795,27,873,3,1,904,29.3,73,63,2.8,1699,False,14,96,1588,13,2,2024-06-27,False,False,True,0.9346674514420247,0.05650382577987051,0.007651559741024131,0.0011771630370806356,Peak,Thursday,June
2024-06-27 15:00:00,18,749,2,1,770,37,469,4,1,511,29.3,74,53,4.1,1281,False,15,55,1218,6,2,2024-06-27,False,False,False,0.9508196721311475,0.0429352068696331,0.00468384074941452,0.00156128024980484,Peak,Thursday,June
2024-06-27 16:00:00,74,660,5,1,740,34,513,2,1,550,29.6,73,51,6.4,1290,False,16,108,1173,7,2,2024-06-27,False,False,False,0.9093023255813953,0.08372093023255814,0.005426356589147287,0.0015503875968992248,Peak,Thursday,June
2024-06-27 17:00:00,74,590,10,1,675,40,643,2,1,686,29.2,75,3,6.6,1361,False,17,114,1233,12,2,2024-06-27,False,False,False,0.9059515062454078,0.08376193975018369,0.00881704628949302,0.0014695077149155032,Peak,Thursday,June
2024-06-27 18:00:00,55,529,9,1,594,47,562,5,1,615,29.0,77,3,10.2,1209,False,18,102,1091,14,2,2024-06-27,False,False,False,0.902398676592225,0.08436724565756824,0.011579818031430935,0.0016542597187758478,Peak,Thursday,June
2024-06-27 19:00:00,56,561,9,1,627,66,817,7,1,891,28.2,81,3,8.4,1518,False,19,122,1378,16,2,2024-06-27,False,False,True,0.9077733860342556,0.08036890645586298,0.010540184453227932,0.0013175230566534915,Peak,Thursday,June
2024-06-27 20:00:00,20,309,3,1,333,23,438,3,1,465,27.6,84,3,8.7,798,False,20,43,747,6,2,2024-06-27,False,False,False,0.9360902255639098,0.05388471177944862,0.007518796992481203,0.002506265664160401,Shoulder,Thursday,June
2024-06-27 21:00:00,37,270,6,1,314,26,340,3,1,370,27.0,90,3,5.6,684,False,21,63,610,9,2,2024-06-27,False,False,False,0.8918128654970761,0.09210526315789473,0.013157894736842105,0.0029239766081871343,Shoulder,Thursday,June
2024-06-27 22:00:00,58,374,11,1,444,37,310,6,1,354,26.4,94,3,4.4,798,False,22,95,684,17,2,2024-06-27,False,False,False,0.8571428571428571,0.11904761904761904,0.021303258145363407,0.002506265664160401,Shoulder,Thursday,June
2024-06-27 23:00:00,41,400,9,1,451,75,322,10,1,408,26.2,94,3,4.6,859,False,23,116,722,19,2,2024-06-27,False,False,False,0.840512223515716,0.1350407450523865,0.02211874272409779,0.002328288707799767,Shoulder,Thursday,June
2024-06-28 00:00:00,44,379,6,0,429,37,383,3,0,423,26.1,93,3,3.6,852,False,0,81,762,9,0,2024-06-28,False,False,False,0.8943661971830986,0.09507042253521127,0.01056338028169014,0.0,Off-Peak,Friday,June
2024-06-28 01:00:00,39,293,5,0,337,24,373,2,0,399,26.0,93,3,3.4,736,False,1,63,666,7,0,2024-06-28,False,False,False,0.904891304347826,0.08559782608695653,0.009510869565217392,0.0,Off-Peak,Friday,June
2024-06-28 02:00:00,38,282,5,0,325,18,260,5,0,283,25.6,95,3,3.5,608,False,2,56,542,10,0,2024-06-28,False,False,False,0.8914473684210527,0.09210526315789473,0.01644736842105263,0.0,Off-Peak,Friday,June
2024-06-28 03:00:00,29,254,10,0,293,19,192,3,0,214,25.6,95,3,4.7,507,False,3,48,446,13,0,2024-06-28,False,False,False,0.8796844181459567,0.09467455621301775,0.02564102564102564,0.0,Off-Peak,Friday,June
2024-06-28 04:00:00,27,236,5,0,268,15,164,2,0,181,25.5,95,3,3.1,449,False,4,42,400,7,0,2024-06-28,False,False,False,0.89086859688196,0.0935412026726058,0.015590200445434299,0.0,Off-Peak,Friday,June
2024-06-28 05:00:00,22,213,6,0,241,11,176,5,0,192,25.7,93,3,5.4,433,False,5,33,389,11,0,2024-06-28,False,False,False,0.8983833718244804,0.07621247113163972,0.025404157043879907,0.0,Shoulder,Friday,June
2024-06-28 06:00:00,42,421,6,0,469,36,111,5,0,152,25.5,94,3,3.9,621,False,6,78,532,11,0,2024-06-28,False,False,False,0.856682769726248,0.12560386473429952,0.017713365539452495,0.0,Shoulder,Friday,June
2024-06-28 07:00:00,66,675,3,0,744,63,393,4,1,461,25.6,93,3,5.8,1205,False,7,129,1068,7,1,2024-06-28,False,False,False,0.8863070539419087,0.10705394190871369,0.005809128630705394,0.0008298755186721991,Peak,Friday,June
2024-06-28 08:00:00,77,792,10,1,880,37,561,3,1,602,25.9,92,2,6.6,1482,False,8,114,1353,13,2,2024-06-28,False,False,True,0.9129554655870445,0.07692307692307693,0.008771929824561403,0.001349527665317139,Peak,Friday,June
2024-06-28 09:00:00,58,563,8,1,630,52,742,4,1,799,27.0,89,2,2.3,1429,False,9,110,1305,12,2,2024-06-28,False,False,True,0.9132260321903429,0.07697690692792163,0.008397480755773267,0.0013995801259622112,Shoulder,Friday,June
2024-06-28 10:00:00,39,373,5,1,418,40,674,4,1,719,28.2,82,3,3.6,1137,False,10,79,1047,9,2,2024-06-28,False,False,False,0.920844327176781,0.06948109058927,0.0079155672823219,0.001759014951627089,Shoulder,Friday,June
2024-06-28 11:00:00,25,398,4,1,428,35,547,3,1,586,29.2,78,51,4.4,1014,False,11,60,945,7,2,2024-06-28,False,False,False,0.9319526627218935,0.05917159763313609,0.006903353057199211,0.0019723865877712033,Peak,Friday,June
2024-06-28 12:00:00,67,661,8,1,737,50,398,4,1,453,30.0,75,51,6.8,1190,False,12,117,1059,12,2,2024-06-28,False,False,False,0.8899159663865546,0.09831932773109243,0.010084033613445379,0.0016806722689075631,Peak,Friday,June
2024-06-28 13:00:00,78,765,10,1,854,68,442,2,1,513,30.3,74,51,8.9,1367,False,13,146,1207,12,2,2024-06-28,False,False,False,0.8829553767373811,0.10680321872713973,0.008778346744696415,0.001463057790782736,Peak,Friday,June
2024-06-28 14:00:00,35,622,5,1,663,57,612,4,1,674,29.5,75,65,11.9,1337,False,14,92,1234,9,2,2024-06-28,False,False,False,0.9229618548990277,0.068810770381451,0.006731488406881077,0.0014958863126402393,Peak,Friday,June
2024-06-28 15:00:00,62,598,8,1,669,48,509,4,1,562,28.5,79,63,6.8,1231,False,15,110,1107,12,2,2024-06-28,False,False,False,0.8992688870836718,0.08935824532900082,0.00974817221770918,0.0016246953696181965,Peak,Friday,June
2024-06-28 16:00:00,30,451,7,1,489,69,728,5,1,803,28.4,78,51,3.5,1292,False,16,99,1179,12,2,2024-06-28,False,False,False,0.9125386996904025,0.07662538699690402,0.009287925696594427,0.0015479876160990713,Peak,Friday,June
2024-06-28 17:00:00,39,427,5,1,472,77,687,2,1,767,28.2,79,51,3.1,1239,False,17,116,1114,7,2,2024-06-28,False,False,False,0.8991121872477804,0.09362389023405973,0.005649717514124294,0.0016142050040355124,Peak,Friday,June
2024-06-28 18:00:00,42,361,7,1,411,62,479,3,1,545,28.0,82,51,5.4,956,False,18,104,840,10,2,2024-06-28,False,False,False,0.8786610878661087,0.1087866108786611,0.010460251046025104,0.0020920502092050207,Peak,Friday,June
2024-06-28 19:00:00,35,326,6,1,368,42,445,4,1,492,27.3,87,3,4.3,860,False,19,77,771,10,2,2024-06-28,False,False,False,0.8965116279069767,0.08953488372093023,0.011627906976744186,0.002325581395348837,Peak,Friday,June
2024-06-28 20:00:00,88,858,15,2,963,56,327,3,1,387,26.5,93,3,5.0,1350,False,20,144,1185,18,3,2024-06-28,False,False,False,0.8777777777777778,0.10666666666666667,0.013333333333333334,0.0022222222222222222,Shoulder,Friday,June
2024-06-28 21:00:00,43,421,8,1,473,46,600,7,1,654,25.6,97,2,3.1,1127,False,21,89,1021,15,2,2024-06-28,False,False,False,0.9059449866903283,0.07897071872227152,0.013309671694764862,0.001774622892635315,Shoulder,Friday,June
2024-06-28 22:00:00,66,355,11,1,433,44,799,9,1,853,25.4,97,53,5.2,1286,False,22,110,1154,20,2,2024-06-28,False,False,False,0.8973561430793157,0.08553654743390357,0.015552099533437015,0.0015552099533437014,Shoulder,Friday,June
2024-06-28 23:00:00,36,339,7,1,383,32,461,8,1,502,25.4,97,51,1.6,885,False,23,68,800,15,2,2024-06-28,False,False,False,0.903954802259887,0.0768361581920904,0.01694915254237288,0.0022598870056497176,Shoulder,Friday,June
2024-06-29 00:00:00,48,434,8,0,490,52,390,2,0,444,25.2,99,51,0.5,934,True,0,100,824,10,0,2024-06-29,False,False,False,0.8822269807280514,0.10706638115631692,0.010706638115631691,0.0,Off-Peak,Saturday,June
2024-06-29 01:00:00,32,381,5,0,418,25,371,5,0,401,25.0,99,2,5.0,819,True,1,57,752,10,0,2024-06-29,False,False,False,0.9181929181929182,0.0695970695970696,0.01221001221001221,0.0,Off-Peak,Saturday,June
2024-06-29 02:00:00,35,360,6,0,401,16,314,6,0,336,24.9,96,3,4.9,737,True,2,51,674,12,0,2024-06-29,False,False,False,0.9145183175033921,0.06919945725915876,0.016282225237449117,0.0,Off-Peak,Saturday,June
2024-06-29 03:00:00,20,239,10,0,269,17,226,6,0,249,24.7,95,2,5.5,518,True,3,37,465,16,0,2024-06-29,False,False,False,0.8976833976833977,0.07142857142857142,0.03088803088803089,0.0,Off-Peak,Saturday,June
2024-06-29 04:00:00,30,174,7,0,211,14,200,4,0,218,24.5,95,2,5.1,429,True,4,44,374,11,0,2024-06-29,False,False,False,0.8717948717948718,0.10256410256410256,0.02564102564102564,0.0,Off-Peak,Saturday,June
2024-06-29 05:00:00,20,242,4,0,266,34,193,4,0,231,24.1,96,51,4.7,497,True,5,54,435,8,0,2024-06-29,False,False,False,0.8752515090543259,0.10865191146881288,0.01609657947686117,0.0,Shoulder,Saturday,June
2024-06-29 06:00:00,15,581,10,0,606,59,327,7,0,393,24.1,95,53,7.0,999,True,6,74,908,17,0,2024-06-29,False,False,False,0.908908908908909,0.07407407407407407,0.01701701701701702,0.0,Shoulder,Saturday,June
2024-06-29 07:00:00,32,394,5,0,431,56,406,7,0,469,24.0,97,51,2.2,900,True,7,88,800,12,0,2024-06-29,False,False,False,0.8888888888888888,0.09777777777777778,0.013333333333333334,0.0,Peak,Saturday,June
2024-06-29 08:00:00,35,422,7,0,464,49,703,7,0,759,24.7,95,3,2.3,1223,True,8,84,1125,14,0,2024-06-29,False,False,False,0.919869174161897,0.0686835650040883,0.011447260834014717,0.0,Peak,Saturday,June
2024-06-29 09:00:00,13,140,3,0,156,21,617,2,0,640,26.8,89,3,3.9,796,True,9,34,757,5,0,2024-06-29,False,False,False,0.9510050251256281,0.04271356783919598,0.00628140703517588,0.0,Shoulder,Saturday,June
2024-06-29 10:00:00,47,579,9,1,636,41,431,5,0,477,27.7,82,51,5.7,1113,True,10,88,1010,14,1,2024-06-29,False,False,False,0.9074573225516622,0.07906558849955077,0.012578616352201259,0.0008984725965858042,Shoulder,Saturday,June
2024-06-29 11:00:00,22,265,4,0,291,36,515,5,0,556,28.9,78,3,5.4,847,True,11,58,780,9,0,2024-06-29,False,False,False,0.9208972845336482,0.06847697756788666,0.010625737898465172,0.0,Peak,Saturday,June
2024-06-29 12:00:00,50,613,9,1,673,36,529,5,1,571,29.8,71,51,8.9,1244,True,12,86,1142,14,2,2024-06-29,False,False,False,0.9180064308681672,0.06913183279742766,0.011254019292604502,0.001607717041800643,Peak,Saturday,June
2024-06-29 13:00:00,43,534,8,1,586,28,491,5,1,525,30.3,68,51,10.3,1111,True,13,71,1025,13,2,2024-06-29,False,False,False,0.9225922592259226,0.0639063906390639,0.011701170117011701,0.0018001800180018,Peak,Saturday,June
2024-06-29 14:00:00,50,607,8,1,666,41,579,6,1,627,30.1,67,1,9.8,1293,True,14,91,1186,14,2,2024-06-29,False,False,False,0.917246713070379,0.07037896365042537,0.01082753286929621,0.0015467904098994587,Peak,Saturday,June
2024-06-29 15:00:00,55,673,9,1,738,42,586,6,1,635,30.1,66,1,9.0,1373,True,15,97,1259,15,2,2024-06-29,False,False,False,0.9169701383831027,0.07064821558630735,0.010924981791697014,0.0014566642388929353,Peak,Saturday,June
2024-06-29 16:00:00,73,875,12,1,961,28,812,4,1,845,30.0,69,3,9.0,1806,True,16,101,1687,16,2,2024-06-29,False,False,True,0.9341085271317829,0.055924695459579184,0.008859357696566999,0.0011074197120708748,Peak,Saturday,June
2024-06-29 17:00:00,65,782,12,1,860,28,843,4,1,876,29.7,73,3,9.1,1736,True,17,93,1625,16,2,2024-06-29,False,False,True,0.9360599078341014,0.05357142857142857,0.009216589861751152,0.001152073732718894,Peak,Saturday,June
2024-06-29 18:00:00,70,881,6,1,958,36,453,6,1,496,29.0,76,3,8.4,1454,True,18,106,1334,12,2,2024-06-29,False,False,True,0.9174690508940853,0.07290233837689133,0.008253094910591471,0.001375515818431912,Peak,Saturday,June
2024-06-29 19:00:00,47,503,5,1,556,48,638,6,1,693,28.3,80,3,6.0,1249,True,19,95,1141,11,2,2024-06-29,False,False,False,0.9135308246597278,0.07606084867894315,0.008807045636509208,0.0016012810248198558,Peak,Saturday,June
2024-06-29 20:00:00,40,587,10,1,638,43,655,5,1,704,27.7,83,3,5.4,1342,True,20,83,1242,15,2,2024-06-29,False,False,False,0.9254843517138599,0.06184798807749627,0.011177347242921014,0.0014903129657228018,Shoulder,Saturday,June
2024-06-29 21:00:00,64,798,4,1,867,30,579,4,2,615,27.4,83,3,5.4,1482,True,21,94,1377,8,3,2024-06-29,False,False,True,0.9291497975708503,0.06342780026990553,0.005398110661268556,0.0020242914979757085,Shoulder,Saturday,June
2024-06-29 22:00:00,73,879,17,1,970,47,718,3,1,769,27.1,86,3,4.4,1739,True,22,120,1597,20,2,2024-06-29,False,False,True,0.9183438757906843,0.06900517538815411,0.011500862564692352,0.0011500862564692352,Shoulder,Saturday,June
2024-06-29 23:00:00,49,526,10,1,586,68,893,14,1,976,27.1,86,3,6.2,1562,True,23,117,1419,24,2,2024-06-29,False,False,True,0.9084507042253521,0.07490396927016646,0.015364916773367477,0.0012804097311139564,Shoulder,Saturday,June
2024-06-30 00:00:00,18,227,3,0,248,17,162,3,0,182,26.5,89,3,3.9,430,True,0,35,389,6,0,2024-06-30,False,True,False,0.9046511627906977,0.08139534883720931,0.013953488372093023,0.0,Off-Peak,Sunday,June
2024-06-30 01:00:00,21,243,2,0,266,16,234,5,0,255,26.2,89,3,4.4,521,True,1,37,477,7,0,2024-06-30,False,True,False,0.9155470249520153,0.0710172744721689,0.013435700575815739,0.0,Off-Peak,Sunday,June
2024-06-30 02:00:00,24,241,2,0,267,13,247,9,0,269,25.7,90,2,4.0,536,True,2,37,488,11,0,2024-06-30,False,True,False,0.9104477611940298,0.06902985074626866,0.020522388059701493,0.0,Off-Peak,Sunday,June
2024-06-30 03:00:00,23,264,2,0,289,21,219,3,0,243,25.3,91,1,3.6,532,True,3,44,483,5,0,2024-06-30,False,True,False,0.9078947368421053,0.08270676691729323,0.009398496240601503,0.0,Off-Peak,Sunday,June
2024-06-30 04:00:00,27,359,1,0,387,33,364,9,0,406,25.3,91,1,3.1,793,True,4,60,723,10,0,2024-06-30,False,True,False,0.9117276166456494,0.07566204287515763,0.012610340479192938,0.0,Off-Peak,Sunday,June
2024-06-30 05:00:00,29,345,3,0,377,31,430,6,0,467,24.8,92,63,2.2,844,True,5,60,775,9,0,2024-06-30,False,True,False,0.9182464454976303,0.07109004739336493,0.01066350710900474,0.0,Shoulder,Sunday,June
2024-06-30 06:00:00,29,379,2,0,410,36,470,6,0,512,24.1,95,63,6.5,922,True,6,65,849,8,0,2024-06-30,False,True,False,0.920824295010846,0.07049891540130152,0.008676789587852495,0.0,Shoulder,Sunday,June
2024-06-30 07:00:00,34,306,2,0,342,34,458,6,0,498,24.4,95,51,4.5,840,True,7,68,764,8,0,2024-06-30,False,True,False,0.9095238095238095,0.08095238095238096,0.009523809523809525,0.0,Peak,Sunday,June
2024-06-30 08:00:00,20,575,3,0,598,34,500,10,0,544,24.3,96,63,7.7,1142,True,8,54,1075,13,0,2024-06-30,False,True,False,0.9413309982486865,0.047285464098073555,0.01138353765323993,0.0,Peak,Sunday,June
2024-06-30 09:00:00,34,729,3,0,766,38,485,7,0,530,26.9,86,3,5.9,1296,True,9,72,1214,10,0,2024-06-30,False,True,False,0.9367283950617284,0.05555555555555555,0.007716049382716049,0.0,Shoulder,Sunday,June
2024-06-30 10:00:00,35,491,3,0,529,66,584,9,0,659,27.7,80,3,9.4,1188,True,10,101,1075,12,0,2024-06-30,False,True,False,0.9048821548821548,0.08501683501683502,0.010101010101010102,0.0,Shoulder,Sunday,June
2024-06-30 11:00:00,20,461,2,0,483,37,497,10,0,544,28.0,78,3,9.7,1027,True,11,57,958,12,0,2024-06-30,False,True,False,0.9328140214216164,0.055501460564751706,0.011684518013631937,0.0,Peak,Sunday,June
2024-06-30 12:00:00,52,608,2,0,662,33,582,5,0,620,28.4,75,3,11.3,1282,True,12,85,1190,7,0,2024-06-30,False,True,False,0.9282371294851794,0.06630265210608424,0.00546021840873635,0.0,Peak,Sunday,June
2024-06-30 13:00:00,27,453,3,1,484,38,507,7,1,553,28.5,75,3,11.0,1037,True,13,65,960,10,2,2024-06-30,False,True,False,0.9257473481195757,0.0626808100289296,0.009643201542912247,0.0019286403085824494,Peak,Sunday,June
2024-06-30 14:00:00,44,895,3,1,943,61,496,9,1,567,28.4,76,3,12.7,1510,True,14,105,1391,12,2,2024-06-30,False,True,True,0.9211920529801324,0.0695364238410596,0.007947019867549669,0.0013245033112582781,Peak,Sunday,June
2024-06-30 15:00:00,56,855,3,1,915,61,827,6,1,895,28.0,77,3,13.0,1810,True,15,117,1682,9,2,2024-06-30,False,True,True,0.9292817679558011,0.06464088397790055,0.004972375690607734,0.0011049723756906078,Peak,Sunday,June
2024-06-30 16:00:00,44,900,3,2,949,57,786,7,1,851,27.6,77,3,14.5,1800,True,16,101,1686,10,3,2024-06-30,False,True,True,0.9366666666666666,0.05611111111111111,0.005555555555555556,0.0016666666666666668,Peak,Sunday,June
2024-06-30 17:00:00,69,702,3,1,775,40,853,9,1,903,27.7,75,3,12.6,1678,True,17,109,1555,12,2,2024-06-30,False,True,True,0.9266984505363528,0.06495828367103695,0.007151370679380214,0.0011918951132300357,Peak,Sunday,June
2024-06-30 18:00:00,47,747,5,1,800,39,746,8,1,794,27.5,74,3,11.8,1594,True,18,86,1493,13,2,2024-06-30,False,True,True,0.9366373902132998,0.053952321204516936,0.008155583437892095,0.0012547051442910915,Peak,Sunday,June
2024-06-30 19:00:00,57,264,2,1,324,45,876,6,1,928,26.8,77,3,10.7,1252,True,19,102,1140,8,2,2024-06-30,False,True,False,0.9105431309904153,0.08146964856230032,0.006389776357827476,0.001597444089456869,Peak,Sunday,June
2024-06-30 20:00:00,63,350,5,1,419,45,778,3,1,827,26.2,78,3,6.6,1246,True,20,108,1128,8,2,2024-06-30,False,True,False,0.9052969502407705,0.08667736757624397,0.006420545746388443,0.0016051364365971107,Shoulder,Sunday,June
2024-06-30 21:00:00,54,583,3,1,641,39,465,8,1,513,26.1,84,3,4.6,1154,True,21,93,1048,11,2,2024-06-30,False,True,False,0.9081455805892548,0.0805892547660312,0.009532062391681109,0.0017331022530329288,Shoulder,Sunday,June
2024-06-30 22:00:00,60,793,3,1,857,59,429,7,1,496,26.1,84,3,4.7,1353,True,22,119,1222,10,2,2024-06-30,False,True,False,0.9031781226903178,0.08795269770879527,0.007390983000739098,0.0014781966001478197,Shoulder,Sunday,June
2024-06-30 23:00:00,70,675,4,1,750,64,450,10,2,526,25.8,87,3,5.5,1276,True,23,134,1125,14,3,2024-06-30,False,True,False,0.8816614420062696,0.10501567398119123,0.0109717868338558,0.0023510971786833857,Shoulder,Sunday,June
2024-07-01 00:00:00,13,150,3,0,166,46,134,4,1,185,25.2,90,3,8.3,351,False,0,59,284,7,1,2024-07-01,False,False,False,0.8091168091168092,0.16809116809116809,0.019943019943019943,0.002849002849002849,Off-Peak,Monday,July
2024-07-01 01:00:00,21,12,2,0,35,21,32,5,1,59,25.1,88,3,8.7,94,False,1,42,44,7,1,2024-07-01,False,False,False,0.46808510638297873,0.44680851063829785,0.07446808510638298,0.010638297872340425,Off-Peak,Monday,July
2024-07-01 02:00:00,21,5,3,0,29,20,27,3,1,51,24.9,89,3,7.6,80,False,2,41,32,6,1,2024-07-01,False,False,False,0.4,0.5125,0.075,0.0125,Off-Peak,Monday,July
2024-07-01 03:00:00,0,34,2,0,36,3,19,4,1,27,24.6,91,3,6.8,63,False,3,3,53,6,1,2024-07-01,False,False,False,0.8412698412698413,0.047619047619047616,0.09523809523809523,0.015873015873015872,Off-Peak,Monday,July
2024-07-01 04:00:00,12,41,4,0,57,9,5,3,0,17,24.3,93,3,7.5,74,False,4,21,46,7,0,2024-07-01,False,False,False,0.6216216216216216,0.28378378378378377,0.0945945945945946,0.0,Off-Peak,Monday,July
2024-07-01 05:00:00,40,340,8,1,389,96,327,8,1,432,24.3,93,3,6.3,821,False,5,136,667,16,2,2024-07-01,False,False,False,0.8124238733252132,0.1656516443361754,0.0194884287454324,0.00243605359317905,Shoulder,Monday,July
2024-07-01 06:00:00,43,381,7,1,432,92,324,9,1,426,24.2,94,3,4.8,858,False,6,135,705,16,2,2024-07-01,False,False,False,0.8216783216783217,0.15734265734265734,0.018648018648018648,0.002331002331002331,Shoulder,Monday,July
2024-07-01 07:00:00,40,422,7,0,469,121,398,12,2,533,24.0,94,3,7.2,1002,False,7,161,820,19,2,2024-07-01,False,False,False,0.8183632734530938,0.16067864271457086,0.018962075848303395,0.001996007984031936,Peak,Monday,July
2024-07-01 08:00:00,59,429,9,1,498,123,436,11,1,571,24.3,92,3,6.2,1069,False,8,182,865,20,2,2024-07-01,False,False,False,0.8091674462114126,0.17025257249766138,0.018709073900841908,0.0018709073900841909,Peak,Monday,July
2024-07-01 09:00:00,41,341,8,0,390,95,350,11,1,457,26.3,88,3,4.8,847,False,9,136,691,19,1,2024-07-01,False,False,False,0.8158205430932703,0.16056670602125148,0.02243211334120425,0.0011806375442739079,Shoulder,Monday,July
2024-07-01 10:00:00,37,358,6,1,402,95,337,10,1,443,27.1,85,3,4.1,845,False,10,132,695,16,2,2024-07-01,False,False,False,0.8224852071005917,0.15621301775147928,0.01893491124260355,0.002366863905325444,Shoulder,Monday,July
2024-07-01 11:00:00,62,389,9,1,461,117,401,12,2,532,28.1,81,3,5.5,993,False,11,179,790,21,3,2024-07-01,False,False,False,0.7955689828801611,0.18026183282980865,0.021148036253776436,0.0030211480362537764,Peak,Monday,July
2024-07-01 12:00:00,44,452,9,1,506,144,433,12,2,591,28.9,76,3,7.2,1097,False,12,188,885,21,3,2024-07-01,False,False,False,0.8067456700091158,0.17137648131267091,0.019143117593436645,0.0027347310847766638,Peak,Monday,July
2024-07-01 13:00:00,58,442,7,1,508,124,436,11,1,572,30.1,67,3,6.3,1080,False,13,182,878,18,2,2024-07-01,False,False,False,0.812962962962963,0.1685185185185185,0.016666666666666666,0.001851851851851852,Peak,Monday,July
2024-07-01 14:00:00,43,343,8,1,395,108,335,9,1,453,30.8,62,3,2.2,848,False,14,151,678,17,2,2024-07-01,False,False,False,0.7995283018867925,0.17806603773584906,0.020047169811320754,0.0023584905660377358,Peak,Monday,July
2024-07-01 15:00:00,40,368,7,1,416,93,335,8,1,437,31.2,60,3,1.1,853,False,15,133,703,15,2,2024-07-01,False,False,False,0.8241500586166471,0.1559202813599062,0.017584994138335287,0.0023446658851113715,Peak,Monday,July
2024-07-01 16:00:00,48,337,7,1,393,99,307,8,1,415,31.4,60,3,0.4,808,False,16,147,644,15,2,2024-07-01,False,False,False,0.7970297029702971,0.18193069306930693,0.018564356435643563,0.0024752475247524753,Peak,Monday,July
2024-07-01 17:00:00,57,426,8,1,492,128,402,10,1,541,31.4,58,3,2.5,1033,False,17,185,828,18,2,2024-07-01,False,False,False,0.8015488867376573,0.17909002904162633,0.017424975798644726,0.001936108422071636,Peak,Monday,July
2024-07-01 18:00:00,43,443,7,1,494,101,385,12,1,499,29.9,70,3,8.4,993,False,18,144,828,19,2,2024-07-01,False,False,False,0.8338368580060423,0.14501510574018128,0.019133937562940583,0.002014098690835851,Peak,Monday,July
2024-07-01 19:00:00,50,450,8,1,509,124,398,13,2,537,28.5,78,3,10.9,1046,False,19,174,848,21,3,2024-07-01,False,False,False,0.8107074569789675,0.16634799235181644,0.020076481835564052,0.0028680688336520078,Peak,Monday,July
2024-07-01 20:00:00,33,307,6,1,347,87,274,7,1,369,27.9,81,3,10.1,716,False,20,120,581,13,2,2024-07-01,False,False,False,0.8114525139664804,0.16759776536312848,0.018156424581005588,0.002793296089385475,Shoulder,Monday,July
2024-07-01 21:00:00,42,284,5,0,331,86,265,9,1,361,27.2,81,1,7.4,692,False,21,128,549,14,1,2024-07-01,False,False,False,0.7933526011560693,0.18497109826589594,0.02023121387283237,0.001445086705202312,Shoulder,Monday,July
2024-07-01 22:00:00,41,273,5,1,320,75,254,8,1,338,26.7,86,3,8.7,658,False,22,116,527,13,2,2024-07-01,False,False,False,0.8009118541033434,0.1762917933130699,0.019756838905775075,0.00303951367781155,Shoulder,Monday,July
2024-07-01 23:00:00,33,273,6,0,312,81,313,9,1,404,25.7,93,3,4.5,716,False,23,114,586,15,1,2024-07-01,False,False,False,0.8184357541899442,0.15921787709497207,0.02094972067039106,0.0013966480446927375,Shoulder,Monday,July
2024-07-02 00:00:00,35,220,4,0,259,58,128,3,1,190,24.8,96,3,6.1,449,False,0,93,348,7,1,2024-07-02,False,False,False,0.7750556792873051,0.2071269487750557,0.015590200445434299,0.0022271714922048997,Off-Peak,Tuesday,July
2024-07-02 01:00:00,5,21,4,0,30,19,39,3,1,62,24.2,98,3,5.1,92,False,1,24,60,7,1,2024-07-02,False,False,False,0.6521739130434783,0.2608695652173913,0.07608695652173914,0.010869565217391304,Off-Peak,Tuesday,July
2024-07-02 02:00:00,24,49,4,0,77,23,47,4,0,74,24.0,98,3,2.9,151,False,2,47,96,8,0,2024-07-02,False,False,False,0.6357615894039735,0.31125827814569534,0.052980132450331126,0.0,Off-Peak,Tuesday,July
2024-07-02 03:00:00,22,8,3,0,33,2,13,4,0,19,24.0,96,3,4.0,52,False,3,24,21,7,0,2024-07-02,False,False,False,0.40384615384615385,0.46153846153846156,0.1346153846153846,0.0,Off-Peak,Tuesday,July
2024-07-02 04:00:00,12,39,3,0,54,7,19,4,0,30,24.1,95,3,4.1,84,False,4,19,58,7,0,2024-07-02,False,False,False,0.6904761904761905,0.2261904761904762,0.08333333333333333,0.0,Off-Peak,Tuesday,July
2024-07-02 05:00:00,79,505,9,1,594,127,288,10,1,426,24.1,95,3,5.1,1020,False,5,206,793,19,2,2024-07-02,False,False,False,0.7774509803921569,0.2019607843137255,0.018627450980392157,0.00196078431372549,Shoulder,Tuesday,July
2024-07-02 06:00:00,57,480,9,0,546,116,293,9,1,419,24.2,95,3,4.8,965,False,6,173,773,18,1,2024-07-02,False,False,False,0.8010362694300518,0.17927461139896372,0.01865284974093264,0.0010362694300518134,Shoulder,Tuesday,July
2024-07-02 07:00:00,65,592,10,1,668,137,337,12,1,487,24.1,96,3,2.2,1155,False,7,202,929,22,2,2024-07-02,False,False,False,0.8043290043290043,0.1748917748917749,0.01904761904761905,0.0017316017316017316,Peak,Tuesday,July
2024-07-02 08:00:00,74,677,9,0,760,169,373,12,1,555,24.8,93,3,1.9,1315,False,8,243,1050,21,1,2024-07-02,False,False,False,0.7984790874524715,0.18479087452471482,0.01596958174904943,0.0007604562737642585,Peak,Tuesday,July
2024-07-02 09:00:00,70,513,7,1,591,112,293,11,1,417,26.1,94,51,6.6,1008,False,9,182,806,18,2,2024-07-02,False,False,False,0.7996031746031746,0.18055555555555555,0.017857142857142856,0.001984126984126984,Shoulder,Tuesday,July
2024-07-02 10:00:00,54,528,8,1,591,112,320,7,1,440,27.5,86,51,6.8,1031,False,10,166,848,15,2,2024-07-02,False,False,False,0.8225024248302619,0.16100872938894278,0.014548981571290009,0.0019398642095053346,Shoulder,Tuesday,July
2024-07-02 11:00:00,87,598,10,1,696,157,378,9,1,545,29.0,78,1,6.6,1241,False,11,244,976,19,2,2024-07-02,False,False,False,0.7864625302175665,0.19661563255439163,0.015310233682514102,0.0016116035455278,Peak,Tuesday,July
2024-07-02 12:00:00,78,658,10,0,746,162,383,9,1,555,29.8,75,2,7.6,1301,False,12,240,1041,19,1,2024-07-02,False,False,False,0.8001537279016141,0.18447348193697155,0.014604150653343582,0.0007686395080707148,Peak,Tuesday,July
2024-07-02 13:00:00,65,615,12,1,693,126,385,9,1,521,30.3,72,3,9.0,1214,False,13,191,1000,21,2,2024-07-02,False,False,False,0.8237232289950577,0.15733113673805602,0.01729818780889621,0.0016474464579901153,Peak,Tuesday,July
2024-07-02 14:00:00,58,481,7,1,547,125,325,10,1,461,30.4,72,3,9.4,1008,False,14,183,806,17,2,2024-07-02,False,False,False,0.7996031746031746,0.18154761904761904,0.016865079365079364,0.001984126984126984,Peak,Tuesday,July
2024-07-02 15:00:00,37,499,7,1,544,125,300,10,1,436,30.3,71,2,10.6,980,False,15,162,799,17,2,2024-07-02,False,False,False,0.8153061224489796,0.1653061224489796,0.017346938775510204,0.0020408163265306124,Peak,Tuesday,July
2024-07-02 16:00:00,71,522,7,1,601,136,289,8,1,434,30.1,72,0,10.1,1035,False,16,207,811,15,2,2024-07-02,False,False,False,0.7835748792270532,0.2,0.014492753623188406,0.001932367149758454,Peak,Tuesday,July
2024-07-02 17:00:00,80,660,9,1,750,168,395,11,1,575,29.8,72,1,8.4,1325,False,17,248,1055,20,2,2024-07-02,False,False,False,0.7962264150943397,0.18716981132075472,0.01509433962264151,0.0015094339622641509,Peak,Tuesday,July
2024-07-02 18:00:00,80,677,11,1,769,146,377,13,1,537,29.3,72,2,6.5,1306,False,18,226,1054,24,2,2024-07-02,False,False,False,0.8070444104134763,0.17304747320061256,0.018376722817764167,0.0015313935681470138,Peak,Tuesday,July
2024-07-02 19:00:00,76,628,9,1,714,143,381,11,1,536,28.2,78,2,4.8,1250,False,19,219,1009,20,2,2024-07-02,False,False,False,0.8072,0.1752,0.016,0.0016,Peak,Tuesday,July
2024-07-02 20:00:00,47,449,7,0,503,107,282,8,3,400,27.0,82,2,5.1,903,False,20,154,731,15,3,2024-07-02,False,False,False,0.8095238095238095,0.17054263565891473,0.016611295681063124,0.0033222591362126247,Shoulder,Tuesday,July
2024-07-02 21:00:00,55,452,7,0,514,97,247,9,1,354,27.1,85,3,4.1,868,False,21,152,699,16,1,2024-07-02,False,False,False,0.8052995391705069,0.17511520737327188,0.018433179723502304,0.001152073732718894,Shoulder,Tuesday,July
2024-07-02 22:00:00,58,408,6,0,472,92,252,7,1,352,26.9,88,3,3.3,824,False,22,150,660,13,1,2024-07-02,False,False,False,0.8009708737864077,0.1820388349514563,0.015776699029126214,0.0012135922330097086,Shoulder,Tuesday,July
2024-07-02 23:00:00,60,415,7,1,483,108,257,7,1,373,26.6,89,3,1.6,856,False,23,168,672,14,2,2024-07-02,False,False,False,0.7850467289719626,0.19626168224299065,0.016355140186915886,0.002336448598130841,Shoulder,Tuesday,July
2024-07-03 00:00:00,29,199,3,0,231,45,154,4,0,203,26.4,88,3,4.7,434,False,0,74,353,7,0,2024-07-03,False,False,False,0.8133640552995391,0.17050691244239632,0.016129032258064516,0.0,Off-Peak,Wednesday,July
2024-07-03 01:00:00,1,26,2,0,29,14,33,4,0,51,25.7,93,3,4.6,80,False,1,15,59,6,0,2024-07-03,False,False,False,0.7375,0.1875,0.075,0.0,Off-Peak,Wednesday,July
2024-07-03 02:00:00,21,48,2,1,72,13,14,3,0,30,26.2,87,3,2.1,102,False,2,34,62,5,1,2024-07-03,False,False,False,0.6078431372549019,0.3333333333333333,0.049019607843137254,0.00980392156862745,Off-Peak,Wednesday,July
2024-07-03 03:00:00,2,31,2,0,35,17,17,4,0,38,25.2,93,3,4.0,73,False,3,19,48,6,0,2024-07-03,False,False,False,0.6575342465753424,0.2602739726027397,0.0821917808219178,0.0,Off-Peak,Wednesday,July
2024-07-03 04:00:00,9,49,2,0,60,20,24,4,1,49,25.8,90,3,3.1,109,False,4,29,73,6,1,2024-07-03,False,False,False,0.6697247706422018,0.26605504587155965,0.05504587155963303,0.009174311926605505,Off-Peak,Wednesday,July
2024-07-03 05:00:00,92,497,6,1,596,97,352,9,1,459,24.7,95,3,1.8,1055,False,5,189,849,15,2,2024-07-03,False,False,False,0.804739336492891,0.1791469194312796,0.014218009478672985,0.0018957345971563982,Shoulder,Wednesday,July
2024-07-03 06:00:00,97,498,5,0,600,114,358,9,1,482,23.9,99,3,3.2,1082,False,6,211,856,14,1,2024-07-03,False,False,False,0.7911275415896488,0.19500924214417745,0.012939001848428836,0.0009242144177449168,Shoulder,Wednesday,July
2024-07-03 07:00:00,95,658,7,0,760,141,392,10,2,545,23.6,99,3,1.4,1305,False,7,236,1050,17,2,2024-07-03,False,False,False,0.8045977011494253,0.18084291187739462,0.013026819923371647,0.0015325670498084292,Peak,Wednesday,July
2024-07-03 08:00:00,96,624,7,1,728,116,394,11,1,522,23.7,97,3,3.5,1250,False,8,212,1018,18,2,2024-07-03,False,False,False,0.8144,0.1696,0.0144,0.0016,Peak,Wednesday,July
2024-07-03 09:00:00,67,498,6,0,571,112,343,9,1,465,27.7,88,51,0.8,1036,False,9,179,841,15,1,2024-07-03,False,False,False,0.8117760617760618,0.17277992277992277,0.01447876447876448,0.0009652509652509653,Shoulder,Wednesday,July
2024-07-03 10:00:00,98,505,4,0,607,98,326,9,1,434,28.8,81,51,6.1,1041,False,10,196,831,13,1,2024-07-03,False,False,False,0.7982708933717579,0.1882804995196926,0.012487992315081652,0.0009606147934678194,Shoulder,Wednesday,July
2024-07-03 11:00:00,104,621,6,1,732,148,433,10,3,594,29.5,74,51,11.0,1326,False,11,252,1054,16,4,2024-07-03,False,False,False,0.7948717948717948,0.19004524886877827,0.012066365007541479,0.0030165912518853697,Peak,Wednesday,July
2024-07-03 12:00:00,97,633,7,1,738,131,456,10,1,598,30.2,69,3,10.1,1336,False,12,228,1089,17,2,2024-07-03,False,False,False,0.8151197604790419,0.17065868263473055,0.012724550898203593,0.0014970059880239522,Peak,Wednesday,July
2024-07-03 13:00:00,96,634,8,1,739,135,432,11,1,579,30.9,64,3,9.5,1318,False,13,231,1066,19,2,2024-07-03,False,False,False,0.8088012139605463,0.17526555386949924,0.014415781487101669,0.0015174506828528073,Peak,Wednesday,July
2024-07-03 14:00:00,104,495,4,0,603,100,322,7,1,430,31.1,61,2,10.5,1033,False,14,204,817,11,1,2024-07-03,False,False,False,0.7909002904162633,0.19748305905130686,0.010648596321393998,0.000968054211035818,Peak,Wednesday,July
2024-07-03 15:00:00,80,527,4,1,612,109,329,9,1,448,30.9,64,2,11.0,1060,False,15,189,856,13,2,2024-07-03,False,False,False,0.8075471698113208,0.17830188679245282,0.012264150943396227,0.0018867924528301887,Peak,Wednesday,July
2024-07-03 16:00:00,83,516,6,0,605,113,339,8,1,461,30.7,67,1,10.7,1066,False,16,196,855,14,1,2024-07-03,False,False,False,0.8020637898686679,0.18386491557223264,0.013133208255159476,0.0009380863039399625,Peak,Wednesday,July
2024-07-03 17:00:00,129,623,6,1,759,143,430,7,2,582,30.5,70,1,10.0,1341,False,17,272,1053,13,3,2024-07-03,False,False,False,0.785234899328859,0.20283370618941088,0.009694258016405667,0.0022371364653243847,Peak,Wednesday,July
2024-07-03 18:00:00,108,636,8,1,753,125,402,11,1,539,30.0,73,3,10.1,1292,False,18,233,1038,19,2,2024-07-03,False,False,False,0.8034055727554179,0.1803405572755418,0.014705882352941176,0.0015479876160990713,Peak,Wednesday,July
2024-07-03 19:00:00,97,627,8,1,733,142,396,9,2,549,29.2,77,3,8.1,1282,False,19,239,1023,17,3,2024-07-03,False,False,False,0.7979719188767551,0.18642745709828393,0.01326053042121685,0.00234009360374415,Peak,Wednesday,July
2024-07-03 20:00:00,68,417,4,0,489,72,283,6,1,362,28.5,80,3,10.2,851,False,20,140,700,10,1,2024-07-03,False,False,False,0.8225616921269095,0.1645123384253819,0.011750881316098707,0.0011750881316098707,Shoulder,Wednesday,July
2024-07-03 21:00:00,84,429,5,0,518,76,290,6,1,373,28.0,80,3,8.9,891,False,21,160,719,11,1,2024-07-03,False,False,False,0.8069584736251403,0.17957351290684623,0.012345679012345678,0.001122334455667789,Shoulder,Wednesday,July
2024-07-03 22:00:00,71,441,4,0,516,62,288,8,1,359,27.6,83,3,9.4,875,False,22,133,729,12,1,2024-07-03,False,False,False,0.8331428571428572,0.152,0.013714285714285714,0.001142857142857143,Shoulder,Wednesday,July
2024-07-03 23:00:00,52,413,5,0,470,80,271,5,1,357,27.0,83,3,10.5,827,False,23,132,684,10,1,2024-07-03,False,False,False,0.8270858524788391,0.1596130592503023,0.012091898428053204,0.0012091898428053204,Shoulder,Wednesday,July
2024-07-04 00:00:00,56,186,4,0,246,66,157,4,0,227,26.6,85,51,12.8,473,False,0,122,343,8,0,2024-07-04,False,False,False,0.7251585623678647,0.25792811839323465,0.016913319238900635,0.0,Off-Peak,Thursday,July
2024-07-04 01:00:00,23,14,4,0,41,13,38,3,0,54,26.1,89,61,15.9,95,False,1,36,52,7,0,2024-07-04,False,False,False,0.5473684210526316,0.37894736842105264,0.07368421052631578,0.0,Off-Peak,Thursday,July
2024-07-04 02:00:00,4,19,4,0,27,24,23,3,0,50,25.1,92,53,15.1,77,False,2,28,42,7,0,2024-07-04,False,False,False,0.5454545454545454,0.36363636363636365,0.09090909090909091,0.0,Off-Peak,Thursday,July
2024-07-04 03:00:00,6,39,4,0,49,0,15,3,0,18,25.2,94,53,12.0,67,False,3,6,54,7,0,2024-07-04,False,False,False,0.8059701492537313,0.08955223880597014,0.1044776119402985,0.0,Off-Peak,Thursday,July
2024-07-04 04:00:00,23,23,4,0,50,3,35,3,1,42,25.3,94,51,17.6,92,False,4,26,58,7,1,2024-07-04,False,False,False,0.6304347826086957,0.2826086956521739,0.07608695652173914,0.010869565217391304,Off-Peak,Thursday,July
2024-07-04 05:00:00,94,438,9,1,542,161,351,9,1,522,25.5,93,51,14.7,1064,False,5,255,789,18,2,2024-07-04,False,False,False,0.7415413533834586,0.23966165413533835,0.016917293233082706,0.0018796992481203006,Shoulder,Thursday,July
2024-07-04 06:00:00,105,449,11,1,566,142,375,9,1,527,25.7,93,3,8.7,1093,False,6,247,824,20,2,2024-07-04,False,False,False,0.7538883806038427,0.22598353156450138,0.018298261665141813,0.0018298261665141812,Shoulder,Thursday,July
2024-07-04 07:00:00,132,520,14,0,666,166,473,11,2,652,24.8,93,63,11.8,1318,False,7,298,993,25,2,2024-07-04,False,False,False,0.7534142640364189,0.22610015174506828,0.01896813353566009,0.0015174506828528073,Peak,Thursday,July
2024-07-04 08:00:00,130,511,11,1,653,187,462,9,1,659,25.7,90,51,5.9,1312,False,8,317,973,20,2,2024-07-04,False,False,False,0.7416158536585366,0.24161585365853658,0.01524390243902439,0.001524390243902439,Peak,Thursday,July
2024-07-04 09:00:00,110,419,11,1,541,159,318,6,1,484,27.8,80,53,4.8,1025,False,9,269,737,17,2,2024-07-04,False,False,False,0.7190243902439024,0.2624390243902439,0.016585365853658537,0.001951219512195122,Shoulder,Thursday,July
2024-07-04 10:00:00,101,429,9,1,540,162,351,7,1,521,28.4,77,53,6.2,1061,False,10,263,780,16,2,2024-07-04,False,False,False,0.7351555136663525,0.2478793590951932,0.015080113100848256,0.001885014137606032,Shoulder,Thursday,July
2024-07-04 11:00:00,148,489,10,0,647,163,466,8,1,638,29.1,73,51,8.9,1285,False,11,311,955,18,1,2024-07-04,False,False,False,0.7431906614785992,0.24202334630350195,0.014007782101167316,0.0007782101167315176,Peak,Thursday,July
2024-07-04 12:00:00,128,541,12,1,682,191,463,9,1,664,29.4,72,3,6.6,1346,False,12,319,1004,21,2,2024-07-04,False,False,False,0.7459138187221397,0.23699851411589895,0.015601783060921248,0.0014858841010401188,Peak,Thursday,July
2024-07-04 13:00:00,119,541,13,1,674,197,473,8,2,680,29.8,71,3,7.6,1354,False,13,316,1014,21,3,2024-07-04,False,False,False,0.7488921713441654,0.23338257016248154,0.0155096011816839,0.0022156573116691287,Peak,Thursday,July
2024-07-04 14:00:00,108,415,10,1,534,138,343,8,1,490,30.0,68,3,9.7,1024,False,14,246,758,18,2,2024-07-04,False,False,False,0.740234375,0.240234375,0.017578125,0.001953125,Peak,Thursday,July
2024-07-04 15:00:00,89,442,10,1,542,140,395,9,1,545,30.3,64,3,9.6,1087,False,15,229,837,19,2,2024-07-04,False,False,False,0.7700091996320148,0.21067157313707452,0.017479300827966882,0.0018399264029438822,Peak,Thursday,July
2024-07-04 16:00:00,96,415,10,1,522,150,402,9,1,562,30.2,68,3,8.8,1084,False,16,246,817,19,2,2024-07-04,False,False,False,0.753690036900369,0.22693726937269373,0.017527675276752766,0.0018450184501845018,Peak,Thursday,July
2024-07-04 17:00:00,109,512,14,1,636,188,466,10,1,665,29.6,71,3,6.9,1301,False,17,297,978,24,2,2024-07-04,False,False,False,0.7517294388931591,0.2282859338970023,0.018447348193697154,0.0015372790161414297,Peak,Thursday,July
2024-07-04 18:00:00,133,516,11,1,661,182,472,8,1,663,29.5,69,2,1.1,1324,False,18,315,988,19,2,2024-07-04,False,False,False,0.7462235649546828,0.23791540785498488,0.014350453172205438,0.0015105740181268882,Peak,Thursday,July
2024-07-04 19:00:00,136,539,10,1,686,166,462,10,2,640,29.2,70,2,1.3,1326,False,19,302,1001,20,3,2024-07-04,False,False,False,0.7549019607843137,0.2277526395173454,0.015082956259426848,0.0022624434389140274,Peak,Thursday,July
2024-07-04 20:00:00,84,337,8,1,430,126,282,7,1,416,27.2,83,1,3.9,846,False,20,210,619,15,2,2024-07-04,False,False,False,0.7316784869976359,0.24822695035460993,0.01773049645390071,0.002364066193853428,Shoulder,Thursday,July
2024-07-04 21:00:00,90,367,6,0,463,117,315,6,1,439,26.9,80,3,3.7,902,False,21,207,682,12,1,2024-07-04,False,False,False,0.7560975609756098,0.229490022172949,0.013303769401330377,0.0011086474501108647,Shoulder,Thursday,July
2024-07-04 22:00:00,86,374,8,1,469,126,310,6,1,443,26.2,83,1,3.1,912,False,22,212,684,14,2,2024-07-04,False,False,False,0.75,0.2324561403508772,0.015350877192982455,0.0021929824561403508,Shoulder,Thursday,July
2024-07-04 23:00:00,81,335,8,0,424,117,310,6,1,434,25.6,87,3,2.8,858,False,23,198,645,14,1,2024-07-04,False,False,False,0.7517482517482518,0.23076923076923078,0.016317016317016316,0.0011655011655011655,Shoulder,Thursday,July
2024-07-05 00:00:00,36,151,2,0,189,56,148,4,0,208,25.3,85,3,1.5,397,False,0,92,299,6,0,2024-07-05,False,False,False,0.7531486146095718,0.23173803526448364,0.015113350125944584,0.0,Off-Peak,Friday,July
2024-07-05 01:00:00,4,17,4,0,25,1,12,4,1,18,24.8,87,3,2.2,43,False,1,5,29,8,1,2024-07-05,False,False,False,0.6744186046511628,0.11627906976744186,0.18604651162790697,0.023255813953488372,Off-Peak,Friday,July
2024-07-05 02:00:00,22,39,2,0,63,24,29,2,1,56,24.4,89,3,1.8,119,False,2,46,68,4,1,2024-07-05,False,False,False,0.5714285714285714,0.3865546218487395,0.03361344537815126,0.008403361344537815,Off-Peak,Friday,July
2024-07-05 03:00:00,12,1,5,0,18,0,15,1,0,16,24.5,88,3,2.4,34,False,3,12,16,6,0,2024-07-05,False,False,False,0.47058823529411764,0.35294117647058826,0.17647058823529413,0.0,Off-Peak,Friday,July
2024-07-05 04:00:00,1,47,3,0,51,3,23,1,0,27,25.3,87,3,3.8,78,False,4,4,70,4,0,2024-07-05,False,False,False,0.8974358974358975,0.05128205128205128,0.05128205128205128,0.0,Off-Peak,Friday,July
2024-07-05 05:00:00,103,504,8,1,616,188,423,9,0,620,25.2,88,3,2.8,1236,False,5,291,927,17,1,2024-07-05,False,False,False,0.75,0.2354368932038835,0.013754045307443365,0.0008090614886731392,Shoulder,Friday,July
2024-07-05 06:00:00,134,461,7,1,603,174,414,5,3,596,24.7,89,3,2.0,1199,False,6,308,875,12,4,2024-07-05,False,False,False,0.7297748123436196,0.25688073394495414,0.010008340283569641,0.003336113427856547,Shoulder,Friday,July
2024-07-05 07:00:00,161,633,9,1,804,244,525,7,0,776,24.4,87,3,2.9,1580,False,7,405,1158,16,1,2024-07-05,False,False,True,0.7329113924050633,0.2563291139240506,0.010126582278481013,0.0006329113924050633,Peak,Friday,July
2024-07-05 08:00:00,130,684,13,0,827,231,598,13,2,844,24.9,91,53,10.6,1671,False,8,361,1282,26,2,2024-07-05,False,False,True,0.7672052663076002,0.21603830041891084,0.015559545182525433,0.0011968880909634949,Peak,Friday,July
2024-07-05 09:00:00,108,478,10,0,596,191,381,8,2,582,27.7,80,51,9.4,1178,False,9,299,859,18,2,2024-07-05,False,False,False,0.7292020373514432,0.2538200339558574,0.015280135823429542,0.001697792869269949,Shoulder,Friday,July
2024-07-05 10:00:00,105,469,9,0,583,180,391,4,1,576,29.0,76,2,6.6,1159,False,10,285,860,13,1,2024-07-05,False,False,False,0.7420189818809318,0.2459016393442623,0.011216566005176877,0.0008628127696289905,Shoulder,Friday,July
2024-07-05 11:00:00,154,635,13,1,803,246,477,12,2,737,30.0,72,1,6.5,1540,False,11,400,1112,25,3,2024-07-05,False,False,True,0.7220779220779221,0.2597402597402597,0.016233766233766232,0.001948051948051948,Peak,Friday,July
2024-07-05 12:00:00,131,654,12,0,797,242,524,9,1,776,30.7,67,1,6.6,1573,False,12,373,1178,21,1,2024-07-05,False,False,True,0.7488874761602035,0.23712650985378259,0.013350286077558804,0.0006357279084551812,Peak,Friday,July
2024-07-05 13:00:00,129,632,16,0,777,271,530,10,1,812,31.2,64,3,6.3,1589,False,13,400,1162,26,1,2024-07-05,False,False,True,0.7312775330396476,0.2517306482064191,0.016362492133417242,0.0006293266205160479,Peak,Friday,July
2024-07-05 14:00:00,101,505,14,3,623,181,399,6,2,588,31.5,63,3,9.4,1211,False,14,282,904,20,5,2024-07-05,False,False,False,0.7464905037159373,0.23286540049545829,0.016515276630883566,0.004128819157720892,Peak,Friday,July
2024-07-05 15:00:00,113,451,12,0,576,202,376,9,1,588,31.1,65,3,10.2,1164,False,15,315,827,21,1,2024-07-05,False,False,False,0.7104810996563574,0.2706185567010309,0.01804123711340206,0.000859106529209622,Peak,Friday,July
2024-07-05 16:00:00,100,487,11,2,600,191,390,7,1,589,30.9,66,1,8.2,1189,False,16,291,877,18,3,2024-07-05,False,False,False,0.7375946173254836,0.2447434819175778,0.015138772077375946,0.002523128679562658,Peak,Friday,July
2024-07-05 17:00:00,149,620,11,2,782,249,489,5,0,743,30.9,63,1,9.7,1525,False,17,398,1109,16,2,2024-07-05,False,False,True,0.7272131147540983,0.26098360655737707,0.010491803278688525,0.0013114754098360656,Peak,Friday,July
2024-07-05 18:00:00,167,613,17,0,797,267,514,16,4,801,29.9,67,3,7.0,1598,False,18,434,1127,33,4,2024-07-05,False,False,True,0.7052565707133918,0.2715894868585732,0.02065081351689612,0.0025031289111389237,Peak,Friday,July
2024-07-05 19:00:00,141,654,13,3,811,240,543,10,2,795,29.0,74,3,4.7,1606,False,19,381,1197,23,5,2024-07-05,False,False,True,0.7453300124533001,0.23723536737235368,0.014321295143212951,0.00311332503113325,Peak,Friday,July
2024-07-05 20:00:00,71,322,7,0,400,116,270,7,0,393,28.2,77,3,6.3,793,False,20,187,592,14,0,2024-07-05,False,False,False,0.7465321563682219,0.23581336696090793,0.017654476670870115,0.0,Shoulder,Friday,July
2024-07-05 21:00:00,85,328,3,2,418,113,244,6,1,364,27.5,76,3,8.5,782,False,21,198,572,9,3,2024-07-05,False,False,False,0.731457800511509,0.2531969309462916,0.011508951406649617,0.0038363171355498722,Shoulder,Friday,July
2024-07-05 22:00:00,79,301,7,0,387,143,256,4,0,403,26.9,80,2,10.4,790,False,22,222,557,11,0,2024-07-05,False,False,False,0.7050632911392405,0.2810126582278481,0.013924050632911392,0.0,Shoulder,Friday,July
2024-07-05 23:00:00,78,337,8,2,425,113,278,6,0,397,26.7,79,2,6.6,822,False,23,191,615,14,2,2024-07-05,False,False,False,0.7481751824817519,0.23236009732360097,0.0170316301703163,0.0024330900243309003,Shoulder,Friday,July
2024-07-06 00:00:00,26,226,2,0,254,53,115,0,1,169,26.4,79,2,7.4,423,True,0,79,341,2,1,2024-07-06,False,False,False,0.806146572104019,0.1867612293144208,0.004728132387706856,0.002364066193853428,Off-Peak,Saturday,July
2024-07-06 01:00:00,5,11,2,0,18,25,39,6,1,71,26.1,81,1,10.7,89,True,1,30,50,8,1,2024-07-06,False,False,False,0.5617977528089888,0.33707865168539325,0.0898876404494382,0.011235955056179775,Off-Peak,Saturday,July
2024-07-06 02:00:00,7,43,4,0,54,0,19,2,2,23,25.8,82,3,9.9,77,True,2,7,62,6,2,2024-07-06,False,False,False,0.8051948051948052,0.09090909090909091,0.07792207792207792,0.025974025974025976,Off-Peak,Saturday,July
2024-07-06 03:00:00,9,43,5,0,57,15,13,3,0,31,25.3,85,3,7.9,88,True,3,24,56,8,0,2024-07-06,False,False,False,0.6363636363636364,0.2727272727272727,0.09090909090909091,0.0,Off-Peak,Saturday,July
2024-07-06 04:00:00,12,7,6,0,25,9,18,5,0,32,25.3,86,3,7.6,57,True,4,21,25,11,0,2024-07-06,False,False,False,0.43859649122807015,0.3684210526315789,0.19298245614035087,0.0,Off-Peak,Saturday,July
2024-07-06 05:00:00,95,662,7,0,764,210,375,7,1,593,24.7,89,2,4.4,1357,True,5,305,1037,14,1,2024-07-06,False,False,False,0.7641857037582903,0.2247605011053795,0.010316875460574797,0.0007369196757553427,Shoulder,Saturday,July
2024-07-06 06:00:00,103,687,8,0,798,185,399,5,2,591,24.2,94,3,5.1,1389,True,6,288,1086,13,2,2024-07-06,False,False,True,0.7818574514038877,0.20734341252699784,0.009359251259899209,0.0014398848092152627,Shoulder,Saturday,July
2024-07-06 07:00:00,107,888,13,0,1008,259,555,10,0,824,24.0,94,3,3.3,1832,True,7,366,1443,23,0,2024-07-06,False,False,True,0.7876637554585153,0.19978165938864628,0.012554585152838428,0.0,Peak,Saturday,July
2024-07-06 08:00:00,108,873,11,0,992,260,511,9,1,781,25.0,91,3,3.3,1773,True,8,368,1384,20,1,2024-07-06,False,False,True,0.7805978567399887,0.20755781161872533,0.011280315848843767,0.0005640157924421884,Peak,Saturday,July
2024-07-06 09:00:00,101,654,7,0,762,194,399,4,0,597,26.9,85,3,4.4,1359,True,9,295,1053,11,0,2024-07-06,False,False,False,0.7748344370860927,0.21707137601177337,0.008094186902133923,0.0,Shoulder,Saturday,July
2024-07-06 10:00:00,86,649,9,5,749,178,417,5,1,601,28.0,82,3,5.5,1350,True,10,264,1066,14,6,2024-07-06,False,False,False,0.7896296296296297,0.19555555555555557,0.01037037037037037,0.0044444444444444444,Shoulder,Saturday,July
2024-07-06 11:00:00,103,912,20,0,1035,270,542,10,0,822,29.1,72,3,6.1,1857,True,11,373,1454,30,0,2024-07-06,False,False,True,0.7829833064081853,0.20086160473882606,0.01615508885298869,0.0,Peak,Saturday,July
2024-07-06 12:00:00,114,860,15,1,990,265,525,12,3,805,29.2,69,3,5.9,1795,True,12,379,1385,27,4,2024-07-06,False,False,True,0.7715877437325905,0.21114206128133706,0.015041782729805013,0.0022284122562674096,Peak,Saturday,July
2024-07-06 13:00:00,105,897,14,1,1017,244,516,7,1,768,29.3,67,3,7.6,1785,True,13,349,1413,21,2,2024-07-06,False,False,True,0.7915966386554621,0.19551820728291316,0.011764705882352941,0.0011204481792717086,Peak,Saturday,July
2024-07-06 14:00:00,89,639,4,0,732,188,422,8,0,618,29.8,64,3,6.1,1350,True,14,277,1061,12,0,2024-07-06,False,False,False,0.7859259259259259,0.2051851851851852,0.008888888888888889,0.0,Peak,Saturday,July
2024-07-06 15:00:00,76,656,9,0,741,185,380,8,0,573,30.4,62,3,9.0,1314,True,15,261,1036,17,0,2024-07-06,False,False,False,0.7884322678843226,0.19863013698630136,0.01293759512937595,0.0,Peak,Saturday,July
2024-07-06 16:00:00,92,633,7,0,732,193,360,5,1,559,30.7,63,2,8.4,1291,True,16,285,993,12,1,2024-07-06,False,False,False,0.7691711851278079,0.22075910147172734,0.009295120061967466,0.000774593338497289,Peak,Saturday,July
2024-07-06 17:00:00,118,916,13,3,1050,256,591,13,2,862,30.4,66,2,8.5,1912,True,17,374,1507,26,5,2024-07-06,False,False,True,0.7881799163179917,0.19560669456066945,0.013598326359832637,0.002615062761506276,Peak,Saturday,July
2024-07-06 18:00:00,107,897,15,1,1020,241,526,15,2,784,29.5,71,2,10.2,1804,True,18,348,1423,30,3,2024-07-06,False,False,True,0.7888026607538803,0.19290465631929046,0.01662971175166297,0.0016629711751662971,Peak,Saturday,July
2024-07-06 19:00:00,96,967,8,2,1073,275,558,14,0,847,28.7,76,3,6.6,1920,True,19,371,1525,22,2,2024-07-06,False,False,True,0.7942708333333334,0.19322916666666667,0.011458333333333333,0.0010416666666666667,Peak,Saturday,July
2024-07-06 20:00:00,52,437,6,1,496,144,266,10,2,422,28.0,80,3,4.3,918,True,20,196,703,16,3,2024-07-06,False,False,False,0.7657952069716776,0.21350762527233116,0.017429193899782137,0.0032679738562091504,Shoulder,Saturday,July
2024-07-06 21:00:00,54,443,5,2,504,129,295,4,0,428,26.1,91,51,6.8,932,True,21,183,738,9,2,2024-07-06,False,False,False,0.7918454935622318,0.1963519313304721,0.009656652360515022,0.002145922746781116,Shoulder,Saturday,July
2024-07-06 22:00:00,55,420,10,1,486,137,274,4,1,416,26.1,89,51,4.4,902,True,22,192,694,14,2,2024-07-06,False,False,False,0.7694013303769401,0.21286031042128603,0.015521064301552107,0.0022172949002217295,Shoulder,Saturday,July
2024-07-06 23:00:00,65,462,3,1,531,135,283,5,2,425,25.2,93,3,9.8,956,True,23,200,745,8,3,2024-07-06,False,False,False,0.7792887029288703,0.20920502092050208,0.008368200836820083,0.0031380753138075313,Shoulder,Saturday,July
2024-07-07 00:00:00,25,232,3,1,261,69,221,1,2,293,24.8,94,51,3.9,554,True,0,94,453,4,3,2024-07-07,True,True,False,0.8176895306859205,0.16967509025270758,0.007220216606498195,0.005415162454873646,Off-Peak,Sunday,July
2024-07-07 01:00:00,24,29,4,0,57,18,10,2,0,30,23.7,98,65,14.0,87,True,1,42,39,6,0,2024-07-07,True,True,False,0.4482758620689655,0.4827586206896552,0.06896551724137931,0.0,Off-Peak,Sunday,July
2024-07-07 02:00:00,25,0,2,0,27,15,3,0,1,19,24.0,96,51,6.5,46,True,2,40,3,2,1,2024-07-07,True,True,False,0.06521739130434782,0.8695652173913043,0.043478260869565216,0.021739130434782608,Off-Peak,Sunday,July
2024-07-07 03:00:00,24,46,2,0,72,10,32,4,1,47,23.9,95,51,7.3,119,True,3,34,78,6,1,2024-07-07,True,True,False,0.6554621848739496,0.2857142857142857,0.05042016806722689,0.008403361344537815,Off-Peak,Sunday,July
2024-07-07 04:00:00,22,50,0,2,74,15,9,1,0,25,23.7,96,51,4.9,99,True,4,37,59,1,2,2024-07-07,True,True,False,0.5959595959595959,0.37373737373737376,0.010101010101010102,0.020202020202020204,Off-Peak,Sunday,July
2024-07-07 05:00:00,96,668,14,1,779,207,569,5,2,783,23.8,96,3,1.8,1562,True,5,303,1237,19,3,2024-07-07,True,True,True,0.791933418693982,0.1939820742637644,0.012163892445582587,0.0019206145966709346,Shoulder,Sunday,July
2024-07-07 06:00:00,106,646,15,0,767,225,586,4,1,816,23.3,97,3,1.6,1583,True,6,331,1232,19,1,2024-07-07,True,True,True,0.7782691092861656,0.20909665192672142,0.012002526847757423,0.0006317119393556538,Shoulder,Sunday,July
2024-07-07 07:00:00,122,869,11,0,1002,292,799,8,4,1103,23.3,97,3,3.2,2105,True,7,414,1668,19,4,2024-07-07,True,True,True,0.7923990498812351,0.19667458432304039,0.009026128266033254,0.0019002375296912114,Peak,Sunday,July
2024-07-07 08:00:00,121,814,9,4,948,292,775,10,3,1080,23.9,96,3,5.5,2028,True,8,413,1589,19,7,2024-07-07,True,True,True,0.7835305719921104,0.20364891518737674,0.009368836291913214,0.0034516765285996054,Peak,Sunday,July
2024-07-07 09:00:00,107,690,14,0,811,203,573,7,2,785,25.6,89,3,9.4,1596,True,9,310,1263,21,2,2024-07-07,True,True,True,0.7913533834586466,0.19423558897243107,0.013157894736842105,0.0012531328320802004,Shoulder,Sunday,July
2024-07-07 10:00:00,94,636,8,1,739,199,554,6,1,760,26.4,85,3,8.4,1499,True,10,293,1190,14,2,2024-07-07,True,True,True,0.7938625750500333,0.1954636424282855,0.009339559706470981,0.00133422281521014,Shoulder,Sunday,July
2024-07-07 11:00:00,125,897,26,1,1049,280,760,11,2,1053,27.4,81,3,6.0,2102,True,11,405,1657,37,3,2024-07-07,True,True,True,0.7882968601332064,0.19267364414843008,0.017602283539486202,0.0014272121788772598,Peak,Sunday,July
2024-07-07 12:00:00,151,886,12,0,1049,286,768,7,5,1066,28.9,70,3,5.4,2115,True,12,437,1654,19,5,2024-07-07,True,True,True,0.782033096926714,0.2066193853427896,0.008983451536643027,0.002364066193853428,Peak,Sunday,July
2024-07-07 13:00:00,138,937,16,2,1093,268,719,10,3,1000,29.7,65,3,6.0,2093,True,13,406,1656,26,5,2024-07-07,True,True,True,0.7912087912087912,0.1939799331103679,0.012422360248447204,0.0023889154323936935,Peak,Sunday,July
2024-07-07 14:00:00,103,685,15,1,804,234,582,8,3,827,30.2,63,3,7.4,1631,True,14,337,1267,23,4,2024-07-07,True,True,True,0.776824034334764,0.20662170447578174,0.014101778050275904,0.002452483139178418,Peak,Sunday,July
2024-07-07 15:00:00,101,666,17,0,784,217,626,6,1,850,30.1,65,3,9.1,1634,True,15,318,1292,23,1,2024-07-07,True,True,True,0.7906976744186046,0.19461444308445533,0.014075887392900856,0.0006119951040391676,Peak,Sunday,July
2024-07-07 16:00:00,109,686,15,1,811,206,584,7,1,798,29.9,67,3,10.1,1609,True,16,315,1270,22,2,2024-07-07,True,True,True,0.7893101305158483,0.19577377252952144,0.013673088875077687,0.001243008079552517,Peak,Sunday,July
2024-07-07 17:00:00,129,877,11,0,1017,281,746,6,0,1033,29.5,68,3,9.2,2050,True,17,410,1623,17,0,2024-07-07,True,True,True,0.7917073170731708,0.2,0.008292682926829269,0.0,Peak,Sunday,July
2024-07-07 18:00:00,129,923,14,1,1067,303,764,7,0,1074,28.9,69,3,7.5,2141,True,18,432,1687,21,1,2024-07-07,True,True,True,0.7879495562821112,0.20177487155534796,0.009808500700607193,0.00046707146193367583,Peak,Sunday,July
2024-07-07 19:00:00,156,883,12,2,1053,303,769,10,1,1083,28.1,74,3,4.7,2136,True,19,459,1652,22,3,2024-07-07,True,True,True,0.7734082397003745,0.2148876404494382,0.010299625468164793,0.0014044943820224719,Peak,Sunday,July
2024-07-07 20:00:00,57,434,3,1,495,138,373,13,1,525,27.4,77,3,4.0,1020,True,20,195,807,16,2,2024-07-07,True,True,False,0.7911764705882353,0.19117647058823528,0.01568627450980392,0.00196078431372549,Shoulder,Sunday,July
2024-07-07 21:00:00,71,441,5,0,517,144,391,5,0,540,27.7,76,3,12.2,1057,True,21,215,832,10,0,2024-07-07,True,True,False,0.7871333964049196,0.20340586565752128,0.00946073793755913,0.0,Shoulder,Sunday,July
2024-07-07 22:00:00,61,432,6,0,499,140,368,3,0,511,26.6,79,51,14.4,1010,True,22,201,800,9,0,2024-07-07,True,True,False,0.7920792079207921,0.19900990099009902,0.00891089108910891,0.0,Shoulder,Sunday,July
2024-07-07 23:00:00,69,445,5,1,520,142,382,3,2,529,25.8,82,3,11.9,1049,True,23,211,827,8,3,2024-07-07,True,True,False,0.7883698760724499,0.2011439466158246,0.0076263107721639654,0.002859866539561487,Shoulder,Sunday,July
2024-07-08 00:00:00,40,160,2,0,202,36,96,2,0,134,25.3,87,55,9.0,336,False,0,76,256,4,0,2024-07-08,True,True,False,0.7619047619047619,0.2261904761904762,0.011904761904761904,0.0,Off-Peak,Monday,July
2024-07-08 01:00:00,10,3,2,0,15,4,34,1,0,39,24.9,92,61,7.1,54,False,1,14,37,3,0,2024-07-08,True,True,False,0.6851851851851852,0.25925925925925924,0.05555555555555555,0.0,Off-Peak,Monday,July
2024-07-08 02:00:00,5,17,1,0,23,24,0,5,0,29,24.7,93,51,4.3,52,False,2,29,17,6,0,2024-07-08,True,True,False,0.3269230769230769,0.5576923076923077,0.11538461538461539,0.0,Off-Peak,Monday,July
2024-07-08 03:00:00,13,29,4,0,46,12,5,1,0,18,24.4,93,55,11.5,64,False,3,25,34,5,0,2024-07-08,True,True,False,0.53125,0.390625,0.078125,0.0,Off-Peak,Monday,July
2024-07-08 04:00:00,10,7,5,0,22,20,10,5,2,37,24.1,95,61,8.7,59,False,4,30,17,10,2,2024-07-08,True,True,False,0.288135593220339,0.5084745762711864,0.1694915254237288,0.03389830508474576,Off-Peak,Monday,July
2024-07-08 05:00:00,128,484,13,0,625,108,279,4,2,393,24.1,95,63,1.9,1018,False,5,236,763,17,2,2024-07-08,True,True,False,0.74950884086444,0.2318271119842829,0.01669941060903733,0.0019646365422396855,Shoulder,Monday,July
2024-07-08 06:00:00,107,516,15,0,638,116,295,10,3,424,24.3,95,51,4.1,1062,False,6,223,811,25,3,2024-07-08,True,True,False,0.763653483992467,0.20998116760828625,0.023540489642184557,0.002824858757062147,Shoulder,Monday,July
2024-07-08 07:00:00,169,658,16,2,845,153,386,13,3,555,24.1,96,51,3.2,1400,False,7,322,1044,29,5,2024-07-08,True,True,True,0.7457142857142857,0.23,0.020714285714285713,0.0035714285714285713,Peak,Monday,July
2024-07-08 08:00:00,167,635,22,1,825,181,372,12,4,569,24.8,95,3,3.7,1394,False,8,348,1007,34,5,2024-07-08,True,True,True,0.7223816355810617,0.24964131994261118,0.024390243902439025,0.003586800573888092,Peak,Monday,July
2024-07-08 09:00:00,126,463,12,1,602,128,267,7,1,403,25.8,88,53,10.5,1005,False,9,254,730,19,2,2024-07-08,True,True,False,0.7263681592039801,0.2527363184079602,0.01890547263681592,0.001990049751243781,Shoulder,Monday,July
2024-07-08 10:00:00,111,487,7,1,606,107,273,8,1,389,25.8,86,61,11.2,995,False,10,218,760,15,2,2024-07-08,True,True,False,0.7638190954773869,0.21909547738693466,0.01507537688442211,0.0020100502512562816,Shoulder,Monday,July
2024-07-08 11:00:00,162,692,10,1,865,152,374,18,1,545,26.3,86,51,11.0,1410,False,11,314,1066,28,2,2024-07-08,True,True,True,0.7560283687943262,0.2226950354609929,0.019858156028368795,0.0014184397163120568,Peak,Monday,July
2024-07-08 12:00:00,131,716,14,1,862,158,354,16,1,529,27.5,81,51,13.9,1391,False,12,289,1070,30,2,2024-07-08,True,True,True,0.7692307692307693,0.20776419841840402,0.021567217828900073,0.0014378145219266715,Peak,Monday,July
2024-07-08 13:00:00,143,651,11,0,805,159,376,20,0,555,28.0,78,51,13.0,1360,False,13,302,1027,31,0,2024-07-08,True,True,False,0.7551470588235294,0.22205882352941175,0.022794117647058822,0.0,Peak,Monday,July
2024-07-08 14:00:00,110,460,13,0,583,113,288,8,1,410,28.0,78,3,11.3,993,False,14,223,748,21,1,2024-07-08,True,True,False,0.7532729103726082,0.22457200402819738,0.021148036253776436,0.0010070493454179255,Peak,Monday,July
2024-07-08 15:00:00,129,477,8,1,615,122,299,7,2,430,28.7,75,3,10.3,1045,False,15,251,776,15,3,2024-07-08,True,True,False,0.7425837320574162,0.24019138755980862,0.014354066985645933,0.0028708133971291866,Peak,Monday,July
2024-07-08 16:00:00,89,475,6,1,571,116,253,7,2,378,28.3,76,51,9.7,949,False,16,205,728,13,3,2024-07-08,True,True,False,0.7671232876712328,0.2160168598524763,0.0136986301369863,0.003161222339304531,Peak,Monday,July
2024-07-08 17:00:00,161,653,16,1,831,142,357,14,2,515,28.0,78,3,8.4,1346,False,17,303,1010,30,3,2024-07-08,True,True,False,0.75037147102526,0.22511144130757801,0.022288261515601784,0.002228826151560178,Peak,Monday,July
2024-07-08 18:00:00,167,653,11,0,831,144,368,20,0,532,27.7,80,3,6.1,1363,False,18,311,1021,31,0,2024-07-08,True,True,False,0.7490829053558328,0.22817314746881878,0.022743947175348497,0.0,Peak,Monday,July
2024-07-08 19:00:00,153,685,12,1,851,148,349,10,1,508,27.2,82,3,3.3,1359,False,19,301,1034,22,2,2024-07-08,True,True,False,0.7608535688005886,0.22148638704930096,0.016188373804267846,0.0014716703458425313,Peak,Monday,July
2024-07-08 20:00:00,74,322,10,0,406,67,170,6,1,244,25.8,90,3,4.5,650,False,20,141,492,16,1,2024-07-08,True,True,False,0.7569230769230769,0.2169230769230769,0.024615384615384615,0.0015384615384615385,Shoulder,Monday,July
2024-07-08 21:00:00,82,349,8,0,439,77,197,3,0,277,24.9,94,65,15.2,716,False,21,159,546,11,0,2024-07-08,True,True,False,0.7625698324022346,0.22206703910614525,0.015363128491620111,0.0,Shoulder,Monday,July
2024-07-08 22:00:00,85,292,6,0,383,81,209,4,1,295,24.9,93,63,6.7,678,False,22,166,501,10,1,2024-07-08,True,True,False,0.7389380530973452,0.2448377581120944,0.014749262536873156,0.0014749262536873156,Shoulder,Monday,July
2024-07-08 23:00:00,76,348,3,1,428,76,188,4,1,269,24.4,94,3,7.2,697,False,23,152,536,7,2,2024-07-08,True,True,False,0.7690100430416069,0.21807747489239598,0.010043041606886656,0.0028694404591104736,Shoulder,Monday,July
2024-07-09 00:00:00,32,170,4,0,206,57,86,4,0,147,24.3,92,3,8.7,353,False,0,89,256,8,0,2024-07-09,False,False,False,0.7252124645892352,0.2521246458923513,0.0226628895184136,0.0,Off-Peak,Tuesday,July
2024-07-09 01:00:00,18,21,6,0,45,18,11,3,1,33,24.3,91,3,5.0,78,False,1,36,32,9,1,2024-07-09,False,False,False,0.41025641025641024,0.46153846153846156,0.11538461538461539,0.01282051282051282,Off-Peak,Tuesday,July
2024-07-09 02:00:00,21,11,4,0,36,5,50,3,0,58,24.0,94,3,4.0,94,False,2,26,61,7,0,2024-07-09,False,False,False,0.648936170212766,0.2765957446808511,0.07446808510638298,0.0,Off-Peak,Tuesday,July
2024-07-09 03:00:00,22,22,0,1,45,11,4,3,1,19,23.6,97,3,3.3,64,False,3,33,26,3,2,2024-07-09,False,False,False,0.40625,0.515625,0.046875,0.03125,Off-Peak,Tuesday,July
2024-07-09 04:00:00,21,21,3,1,46,7,20,2,0,29,23.8,96,3,4.0,75,False,4,28,41,5,1,2024-07-09,False,False,False,0.5466666666666666,0.37333333333333335,0.06666666666666667,0.013333333333333334,Off-Peak,Tuesday,July
2024-07-09 05:00:00,82,426,7,2,517,191,288,4,1,484,23.6,96,3,3.2,1001,False,5,273,714,11,3,2024-07-09,False,False,False,0.7132867132867133,0.2727272727272727,0.01098901098901099,0.002997002997002997,Shoulder,Tuesday,July
2024-07-09 06:00:00,90,402,11,0,503,161,252,6,1,420,23.9,95,3,2.8,923,False,6,251,654,17,1,2024-07-09,False,False,False,0.7085590465872156,0.27193932827735645,0.018418201516793065,0.0010834236186348862,Shoulder,Tuesday,July
2024-07-09 07:00:00,153,630,8,0,791,246,346,9,3,604,24.3,91,3,1.8,1395,False,7,399,976,17,3,2024-07-09,False,False,True,0.6996415770609319,0.2860215053763441,0.012186379928315413,0.002150537634408602,Peak,Tuesday,July
2024-07-09 08:00:00,136,664,8,2,810,220,334,8,1,563,24.6,92,3,2.7,1373,False,8,356,998,16,3,2024-07-09,False,False,False,0.7268754552075747,0.25928623452294247,0.011653313911143482,0.0021849963583394027,Peak,Tuesday,July
2024-07-09 09:00:00,74,390,3,0,467,210,247,6,2,465,24.5,95,51,6.1,932,False,9,284,637,9,2,2024-07-09,False,False,False,0.6834763948497854,0.30472103004291845,0.009656652360515022,0.002145922746781116,Shoulder,Tuesday,July
2024-07-09 10:00:00,75,394,4,0,473,179,262,9,1,451,25.8,89,51,5.8,924,False,10,254,656,13,1,2024-07-09,False,False,False,0.70995670995671,0.2748917748917749,0.01406926406926407,0.0010822510822510823,Shoulder,Tuesday,July
2024-07-09 11:00:00,162,633,9,0,804,233,325,9,2,569,27.8,83,51,4.6,1373,False,11,395,958,18,2,2024-07-09,False,False,False,0.697742170429716,0.2876911871813547,0.013109978150036417,0.0014566642388929353,Peak,Tuesday,July
2024-07-09 12:00:00,151,643,10,1,805,239,337,13,2,591,27.9,82,51,10.1,1396,False,12,390,980,23,3,2024-07-09,False,False,True,0.7020057306590258,0.2793696275071633,0.0164756446991404,0.002148997134670487,Peak,Tuesday,July
2024-07-09 13:00:00,112,624,18,0,754,227,299,8,2,536,29.1,75,3,9.7,1290,False,13,339,923,26,2,2024-07-09,False,False,False,0.7155038759689922,0.2627906976744186,0.020155038759689922,0.0015503875968992248,Peak,Tuesday,July
2024-07-09 14:00:00,100,381,7,0,488,158,271,6,0,435,29.3,74,51,12.6,923,False,14,258,652,13,0,2024-07-09,False,False,False,0.7063921993499458,0.27952329360780065,0.014084507042253521,0.0,Peak,Tuesday,July
2024-07-09 15:00:00,96,393,6,0,495,179,276,11,1,467,29.7,72,51,10.1,962,False,15,275,669,17,1,2024-07-09,False,False,False,0.6954261954261954,0.28586278586278585,0.017671517671517672,0.0010395010395010396,Peak,Tuesday,July
2024-07-09 16:00:00,79,374,8,0,461,175,243,10,1,429,29.6,73,2,9.5,890,False,16,254,617,18,1,2024-07-09,False,False,False,0.6932584269662921,0.2853932584269663,0.020224719101123594,0.0011235955056179776,Peak,Tuesday,July
2024-07-09 17:00:00,143,686,13,1,843,234,370,7,0,611,29.3,75,3,11.8,1454,False,17,377,1056,20,1,2024-07-09,False,False,True,0.7262723521320495,0.2592847317744154,0.013755158184319119,0.000687757909215956,Peak,Tuesday,July
2024-07-09 18:00:00,135,645,12,0,792,236,358,12,2,608,28.7,78,3,11.6,1400,False,18,371,1003,24,2,2024-07-09,False,False,True,0.7164285714285714,0.265,0.017142857142857144,0.0014285714285714286,Peak,Tuesday,July
2024-07-09 19:00:00,127,602,12,1,742,259,370,11,0,640,28.2,80,1,7.2,1382,False,19,386,972,23,1,2024-07-09,False,False,True,0.703328509406657,0.2793053545586107,0.016642547033285094,0.000723589001447178,Peak,Tuesday,July
2024-07-09 20:00:00,66,335,2,0,403,111,168,5,1,285,27.4,84,2,6.4,688,False,20,177,503,7,1,2024-07-09,False,False,False,0.7311046511627907,0.25726744186046513,0.010174418604651164,0.0014534883720930232,Shoulder,Tuesday,July
2024-07-09 21:00:00,73,334,9,0,416,129,154,5,1,289,26.2,92,3,5.6,705,False,21,202,488,14,1,2024-07-09,False,False,False,0.6921985815602837,0.2865248226950355,0.019858156028368795,0.0014184397163120568,Shoulder,Tuesday,July
2024-07-09 22:00:00,73,296,2,0,371,135,161,8,0,304,26.0,93,3,8.8,675,False,22,208,457,10,0,2024-07-09,False,False,False,0.677037037037037,0.30814814814814817,0.014814814814814815,0.0,Shoulder,Tuesday,July
2024-07-09 23:00:00,67,325,3,0,395,126,168,4,1,299,25.7,94,3,6.2,694,False,23,193,493,7,1,2024-07-09,False,False,False,0.7103746397694525,0.2780979827089337,0.010086455331412104,0.001440922190201729,Shoulder,Tuesday,July
2024-07-10 00:00:00,34,179,3,0,216,41,89,4,0,134,25.0,96,3,4.1,350,False,0,75,268,7,0,2024-07-10,False,False,False,0.7657142857142857,0.21428571428571427,0.02,0.0,Off-Peak,Wednesday,July
2024-07-10 01:00:00,7,43,1,0,51,1,6,3,1,11,25.2,96,3,3.5,62,False,1,8,49,4,1,2024-07-10,False,False,False,0.7903225806451613,0.12903225806451613,0.06451612903225806,0.016129032258064516,Off-Peak,Wednesday,July
2024-07-10 02:00:00,7,10,2,2,21,9,19,2,2,32,25.0,96,3,7.9,53,False,2,16,29,4,4,2024-07-10,False,False,False,0.5471698113207547,0.3018867924528302,0.07547169811320754,0.07547169811320754,Off-Peak,Wednesday,July
2024-07-10 03:00:00,13,50,1,0,64,16,27,3,0,46,25.0,95,2,8.2,110,False,3,29,77,4,0,2024-07-10,False,False,False,0.7,0.2636363636363636,0.03636363636363636,0.0,Off-Peak,Wednesday,July
2024-07-10 04:00:00,6,8,0,0,14,8,29,2,1,40,24.5,96,51,3.6,54,False,4,14,37,2,1,2024-07-10,False,False,False,0.6851851851851852,0.25925925925925924,0.037037037037037035,0.018518518518518517,Off-Peak,Wednesday,July
2024-07-10 05:00:00,102,525,4,0,631,100,255,12,0,367,24.2,97,51,2.1,998,False,5,202,780,16,0,2024-07-10,False,False,False,0.781563126252505,0.20240480961923848,0.01603206412825651,0.0,Shoulder,Wednesday,July
2024-07-10 06:00:00,114,514,3,0,631,124,284,8,2,418,24.5,95,51,5.8,1049,False,6,238,798,11,2,2024-07-10,False,False,False,0.7607244995233555,0.22688274547187798,0.010486177311725452,0.0019065776930409914,Shoulder,Wednesday,July
2024-07-10 07:00:00,132,675,6,0,813,151,372,18,0,541,25.1,93,51,2.9,1354,False,7,283,1047,24,0,2024-07-10,False,False,False,0.7732644017725259,0.20901033973412111,0.01772525849335303,0.0,Peak,Wednesday,July
2024-07-10 08:00:00,128,726,1,0,855,146,355,19,1,521,25.4,94,3,6.2,1376,False,8,274,1081,20,1,2024-07-10,False,False,True,0.7856104651162791,0.19912790697674418,0.014534883720930232,0.0007267441860465116,Peak,Wednesday,July
2024-07-10 09:00:00,100,514,4,1,619,146,269,10,0,425,26.5,86,3,8.0,1044,False,9,246,783,14,1,2024-07-10,False,False,False,0.75,0.23563218390804597,0.013409961685823755,0.0009578544061302681,Shoulder,Wednesday,July
2024-07-10 10:00:00,100,551,3,0,654,117,274,8,1,400,26.5,84,51,13.8,1054,False,10,217,825,11,1,2024-07-10,False,False,False,0.7827324478178368,0.20588235294117646,0.010436432637571158,0.0009487666034155598,Shoulder,Wednesday,July
2024-07-10 11:00:00,137,728,2,1,868,148,374,15,1,538,26.8,82,51,11.3,1406,False,11,285,1102,17,2,2024-07-10,False,False,True,0.7837837837837838,0.20270270270270271,0.01209103840682788,0.001422475106685633,Peak,Wednesday,July
2024-07-10 12:00:00,131,730,8,1,870,143,379,12,2,536,26.1,85,63,10.1,1406,False,12,274,1109,20,3,2024-07-10,False,False,True,0.7887624466571835,0.19487908961593173,0.01422475106685633,0.0021337126600284497,Peak,Wednesday,July
2024-07-10 13:00:00,109,784,4,0,897,145,370,23,1,539,27.9,78,3,9.2,1436,False,13,254,1154,27,1,2024-07-10,False,False,True,0.8036211699164345,0.17688022284122562,0.018802228412256268,0.0006963788300835655,Peak,Wednesday,July
2024-07-10 14:00:00,104,546,5,0,655,110,286,9,1,406,29.3,69,3,8.5,1061,False,14,214,832,14,1,2024-07-10,False,False,False,0.7841658812441094,0.20169651272384542,0.013195098963242224,0.000942507068803016,Peak,Wednesday,July
2024-07-10 15:00:00,87,563,7,0,657,114,275,18,5,412,29.7,67,3,9.5,1069,False,15,201,838,25,5,2024-07-10,False,False,False,0.7839101964452759,0.1880261927034612,0.023386342376052385,0.004677268475210477,Peak,Wednesday,July
2024-07-10 16:00:00,80,517,3,0,600,118,287,12,1,418,29.7,65,2,10.4,1018,False,16,198,804,15,1,2024-07-10,False,False,False,0.7897838899803536,0.1944990176817289,0.014734774066797643,0.0009823182711198428,Peak,Wednesday,July
2024-07-10 17:00:00,128,680,6,1,815,155,379,18,0,552,29.4,66,2,9.7,1367,False,17,283,1059,24,1,2024-07-10,False,False,False,0.7746891002194587,0.20702267739575714,0.01755669348939283,0.000731528895391368,Peak,Wednesday,July
2024-07-10 18:00:00,115,722,4,0,841,174,343,19,0,536,28.8,69,3,7.4,1377,False,18,289,1065,23,0,2024-07-10,False,False,True,0.7734204793028322,0.20987654320987653,0.01670297748729121,0.0,Peak,Wednesday,July
2024-07-10 19:00:00,132,711,1,1,845,135,393,15,1,544,28.0,76,3,4.6,1389,False,19,267,1104,16,2,2024-07-10,False,False,True,0.7948164146868251,0.19222462203023757,0.011519078473722102,0.0014398848092152627,Peak,Wednesday,July
2024-07-10 20:00:00,70,352,1,0,423,76,157,12,0,245,26.8,82,3,4.7,668,False,20,146,509,13,0,2024-07-10,False,False,False,0.7619760479041916,0.218562874251497,0.019461077844311378,0.0,Shoulder,Wednesday,July
2024-07-10 21:00:00,67,355,3,0,425,77,155,12,3,247,25.9,93,3,3.9,672,False,21,144,510,15,3,2024-07-10,False,False,False,0.7589285714285714,0.21428571428571427,0.022321428571428572,0.004464285714285714,Shoulder,Wednesday,July
2024-07-10 22:00:00,75,358,4,1,438,68,184,9,0,261,25.6,94,3,6.2,699,False,22,143,542,13,1,2024-07-10,False,False,False,0.7753934191702432,0.20457796852646637,0.01859799713876967,0.001430615164520744,Shoulder,Wednesday,July
2024-07-10 23:00:00,75,360,1,0,436,67,186,12,0,265,25.6,93,3,5.9,701,False,23,142,546,13,0,2024-07-10,False,False,False,0.7788873038516405,0.20256776034236804,0.018544935805991442,0.0,Shoulder,Wednesday,July
2024-07-11 00:00:00,18,54,0,0,72,20,42,0,0,62,25.7,93,3,5.9,134,False,0,38,96,0,0,2024-07-11,False,False,False,0.7164179104477612,0.2835820895522388,0.0,0.0,Off-Peak,Thursday,July
2024-07-11 01:00:00,21,57,0,0,78,10,38,1,0,49,26.3,90,3,4.4,127,False,1,31,95,1,0,2024-07-11,False,False,False,0.7480314960629921,0.2440944881889764,0.007874015748031496,0.0,Off-Peak,Thursday,July
2024-07-11 02:00:00,14,54,0,0,68,13,16,1,0,30,25.7,93,3,4.8,98,False,2,27,70,1,0,2024-07-11,False,False,False,0.7142857142857143,0.2755102040816326,0.01020408163265306,0.0,Off-Peak,Thursday,July
2024-07-11 03:00:00,29,54,0,0,83,13,25,0,0,38,25.3,95,3,4.6,121,False,3,42,79,0,0,2024-07-11,False,False,False,0.6528925619834711,0.34710743801652894,0.0,0.0,Off-Peak,Thursday,July
2024-07-11 04:00:00,30,53,0,0,83,19,39,1,0,59,25.1,96,3,3.7,142,False,4,49,92,1,0,2024-07-11,False,False,False,0.647887323943662,0.34507042253521125,0.007042253521126761,0.0,Off-Peak,Thursday,July
2024-07-11 05:00:00,85,418,2,0,505,148,218,11,2,379,25.4,95,1,4.7,884,False,5,233,636,13,2,2024-07-11,False,False,False,0.7194570135746606,0.26357466063348417,0.014705882352941176,0.0022624434389140274,Shoulder,Thursday,July
2024-07-11 06:00:00,88,442,4,0,534,147,223,11,1,382,25.8,91,1,10.1,916,False,6,235,665,15,1,2024-07-11,False,False,False,0.7259825327510917,0.25655021834061137,0.016375545851528384,0.001091703056768559,Shoulder,Thursday,July
2024-07-11 07:00:00,117,820,5,1,943,191,309,14,1,515,26.4,86,3,7.6,1458,False,7,308,1129,19,2,2024-07-11,False,False,True,0.7743484224965707,0.2112482853223594,0.013031550068587106,0.0013717421124828531,Peak,Thursday,July
2024-07-11 08:00:00,164,821,7,0,992,205,322,13,1,541,26.7,86,3,11.9,1533,False,8,369,1143,20,1,2024-07-11,False,False,True,0.7455968688845401,0.24070450097847357,0.01304631441617743,0.0006523157208088715,Peak,Thursday,July
2024-07-11 09:00:00,81,384,4,0,469,142,219,8,2,371,27.7,77,2,5.9,840,False,9,223,603,12,2,2024-07-11,False,False,False,0.7178571428571429,0.2654761904761905,0.014285714285714285,0.002380952380952381,Shoulder,Thursday,July
2024-07-11 10:00:00,105,432,5,0,542,147,218,11,0,376,28.5,75,3,7.4,918,False,10,252,650,16,0,2024-07-11,False,False,False,0.7080610021786492,0.27450980392156865,0.017429193899782137,0.0,Shoulder,Thursday,July
2024-07-11 11:00:00,139,807,3,0,949,191,336,13,1,541,29.1,75,3,10.9,1490,False,11,330,1143,16,1,2024-07-11,False,False,True,0.7671140939597315,0.2214765100671141,0.010738255033557046,0.0006711409395973154,Peak,Thursday,July
2024-07-11 12:00:00,134,848,11,0,993,201,339,12,1,553,29.3,75,3,12.4,1546,False,12,335,1187,23,1,2024-07-11,False,False,True,0.7677878395860285,0.2166882276843467,0.014877102199223804,0.000646830530401035,Peak,Thursday,July
2024-07-11 13:00:00,118,861,9,1,989,207,334,13,1,555,29.8,72,3,10.9,1544,False,13,325,1195,22,2,2024-07-11,False,False,True,0.7739637305699482,0.2104922279792746,0.014248704663212436,0.0012953367875647669,Peak,Thursday,July
2024-07-11 14:00:00,107,409,2,1,519,144,221,7,2,374,30.1,70,3,11.2,893,False,14,251,630,9,3,2024-07-11,False,False,False,0.7054871220604704,0.2810750279955207,0.010078387458006719,0.0033594624860022394,Peak,Thursday,July
2024-07-11 15:00:00,101,411,7,0,519,144,221,8,1,374,30.2,70,3,11.5,893,False,15,245,632,15,1,2024-07-11,False,False,False,0.7077267637178052,0.27435610302351626,0.0167973124300112,0.0011198208286674132,Peak,Thursday,July
2024-07-11 16:00:00,96,393,7,0,496,148,219,11,3,381,29.9,72,3,11.0,877,False,16,244,612,18,3,2024-07-11,False,False,False,0.6978335233751425,0.2782212086659065,0.020524515393386546,0.0034207525655644243,Peak,Thursday,July
2024-07-11 17:00:00,120,819,4,0,943,194,343,13,2,552,29.5,74,1,9.6,1495,False,17,314,1162,17,2,2024-07-11,False,False,True,0.777257525083612,0.21003344481605352,0.01137123745819398,0.0013377926421404682,Peak,Thursday,July
2024-07-11 18:00:00,151,854,7,1,1013,189,340,12,1,542,29.5,73,1,9.0,1555,False,18,340,1194,19,2,2024-07-11,False,False,True,0.7678456591639872,0.21864951768488747,0.012218649517684888,0.0012861736334405145,Peak,Thursday,July
2024-07-11 19:00:00,148,851,11,1,1011,185,340,12,1,538,28.8,76,2,7.3,1549,False,19,333,1191,23,2,2024-07-11,False,False,True,0.7688831504196255,0.21497740477727567,0.014848289218850872,0.0012911555842479018,Peak,Thursday,July
2024-07-11 20:00:00,89,355,5,0,449,148,223,9,1,381,28.4,75,3,10.8,830,False,20,237,578,14,1,2024-07-11,False,False,False,0.6963855421686747,0.2855421686746988,0.016867469879518072,0.0012048192771084338,Shoulder,Thursday,July
2024-07-11 21:00:00,68,344,2,0,414,144,220,9,0,373,28.5,76,3,8.4,787,False,21,212,564,11,0,2024-07-11,False,False,False,0.7166454891994918,0.26937738246505716,0.01397712833545108,0.0,Shoulder,Thursday,July
2024-07-11 22:00:00,76,351,5,1,433,144,220,7,1,372,28.0,80,51,6.0,805,False,22,220,571,12,2,2024-07-11,False,False,False,0.7093167701863354,0.2732919254658385,0.014906832298136646,0.002484472049689441,Shoulder,Thursday,July
2024-07-11 23:00:00,65,341,3,1,410,148,223,10,2,383,27.4,86,51,4.2,793,False,23,213,564,13,3,2024-07-11,False,False,False,0.7112232030264817,0.2686002522068096,0.01639344262295082,0.0037831021437578815,Shoulder,Thursday,July
2024-07-12 00:00:00,38,158,5,0,201,39,102,2,0,143,27.3,87,51,5.8,344,False,0,77,260,7,0,2024-07-12,False,False,False,0.7558139534883721,0.2238372093023256,0.020348837209302327,0.0,Off-Peak,Friday,July
2024-07-12 01:00:00,25,51,1,0,77,32,108,1,0,141,26.9,90,51,8.0,218,False,1,57,159,2,0,2024-07-12,False,False,False,0.7293577981651376,0.26146788990825687,0.009174311926605505,0.0,Off-Peak,Friday,July
2024-07-12 02:00:00,24,50,1,0,75,35,94,2,0,131,26.5,91,51,9.5,206,False,2,59,144,3,0,2024-07-12,False,False,False,0.6990291262135923,0.28640776699029125,0.014563106796116505,0.0,Off-Peak,Friday,July
2024-07-12 03:00:00,26,51,5,0,82,33,81,2,0,116,26.1,92,3,8.2,198,False,3,59,132,7,0,2024-07-12,False,False,False,0.6666666666666666,0.29797979797979796,0.03535353535353535,0.0,Off-Peak,Friday,July
2024-07-12 04:00:00,24,49,4,1,78,33,95,2,0,130,26.0,93,3,7.0,208,False,4,57,144,6,1,2024-07-12,False,False,False,0.6923076923076923,0.27403846153846156,0.028846153846153848,0.004807692307692308,Off-Peak,Friday,July
2024-07-12 05:00:00,111,465,4,0,580,131,266,9,1,407,25.8,93,3,4.3,987,False,5,242,731,13,1,2024-07-12,False,False,False,0.7406281661600811,0.24518743667679838,0.013171225937183385,0.0010131712259371835,Shoulder,Friday,July
2024-07-12 06:00:00,102,465,8,0,575,105,301,8,0,414,25.3,95,51,8.1,989,False,6,207,766,16,0,2024-07-12,False,False,False,0.7745197168857432,0.20930232558139536,0.016177957532861477,0.0,Shoulder,Friday,July
2024-07-12 07:00:00,146,646,15,1,808,141,374,15,2,532,23.0,98,65,7.9,1340,False,7,287,1020,30,3,2024-07-12,False,False,False,0.7611940298507462,0.21417910447761193,0.022388059701492536,0.002238805970149254,Peak,Friday,July
2024-07-12 08:00:00,132,631,11,3,777,145,358,11,2,516,23.7,96,53,5.8,1293,False,8,277,989,22,5,2024-07-12,False,False,False,0.7648878576952823,0.21423047177107502,0.017014694508894045,0.0038669760247486465,Peak,Friday,July
2024-07-12 09:00:00,86,453,10,0,549,121,279,11,1,412,24.3,95,63,7.2,961,False,9,207,732,21,1,2024-07-12,False,False,False,0.7617065556711758,0.2154006243496358,0.021852237252861603,0.001040582726326743,Shoulder,Friday,July
2024-07-12 10:00:00,85,454,7,0,546,123,324,7,3,457,25.9,91,61,4.0,1003,False,10,208,778,14,3,2024-07-12,False,False,False,0.7756729810568295,0.2073778664007976,0.013958125623130608,0.0029910269192422734,Shoulder,Friday,July
2024-07-12 11:00:00,131,613,15,2,761,162,361,13,1,537,27.1,84,51,3.4,1298,False,11,293,974,28,3,2024-07-12,False,False,False,0.7503852080123267,0.22573189522342066,0.02157164869029276,0.0023112480739599386,Peak,Friday,July
2024-07-12 12:00:00,148,638,9,0,795,158,375,18,0,551,27.7,80,51,2.0,1346,False,12,306,1013,27,0,2024-07-12,False,False,False,0.7526002971768202,0.22734026745913818,0.020059435364041606,0.0,Peak,Friday,July
2024-07-12 13:00:00,127,651,13,1,792,151,380,17,1,549,28.0,80,51,5.3,1341,False,13,278,1031,30,2,2024-07-12,False,False,False,0.7688292319164802,0.20730797912005966,0.02237136465324385,0.0014914243102162564,Peak,Friday,July
2024-07-12 14:00:00,110,444,8,0,562,120,307,6,1,434,28.8,78,3,4.1,996,False,14,230,751,14,1,2024-07-12,False,False,False,0.7540160642570282,0.23092369477911648,0.014056224899598393,0.001004016064257028,Peak,Friday,July
2024-07-12 15:00:00,114,480,12,0,606,117,293,8,3,421,29.7,75,51,1.9,1027,False,15,231,773,20,3,2024-07-12,False,False,False,0.7526777020447907,0.2249269717624148,0.019474196689386564,0.0029211295034079843,Peak,Friday,July
2024-07-12 16:00:00,97,482,5,1,585,120,290,8,2,420,30.2,72,51,4.0,1005,False,16,217,772,13,3,2024-07-12,False,False,False,0.7681592039800995,0.21592039800995025,0.012935323383084577,0.0029850746268656717,Peak,Friday,July
2024-07-12 17:00:00,155,657,14,0,826,165,416,11,1,593,29.8,72,3,6.9,1419,False,17,320,1073,25,1,2024-07-12,False,False,True,0.7561663143058492,0.2255109231853418,0.017618040873854827,0.0007047216349541931,Peak,Friday,July
2024-07-12 18:00:00,152,615,8,1,776,165,402,17,0,584,28.1,79,51,9.4,1360,False,18,317,1017,25,1,2024-07-12,False,False,False,0.7477941176470588,0.23308823529411765,0.01838235294117647,0.0007352941176470588,Peak,Friday,July
2024-07-12 19:00:00,167,652,10,1,830,158,398,9,1,566,27.5,81,3,4.6,1396,False,19,325,1050,19,2,2024-07-12,False,False,True,0.7521489971346705,0.2328080229226361,0.013610315186246419,0.0014326647564469914,Peak,Friday,July
2024-07-12 20:00:00,71,308,5,0,384,77,198,9,1,285,27.2,82,3,5.7,669,False,20,148,506,14,1,2024-07-12,False,False,False,0.7563527653213752,0.22122571001494767,0.02092675635276532,0.0014947683109118087,Shoulder,Friday,July
2024-07-12 21:00:00,78,306,9,0,393,78,188,4,0,270,26.8,84,3,5.5,663,False,21,156,494,13,0,2024-07-12,False,False,False,0.7450980392156863,0.23529411764705882,0.0196078431372549,0.0,Shoulder,Friday,July
2024-07-12 22:00:00,75,287,2,0,364,93,208,8,1,310,26.4,89,3,5.6,674,False,22,168,495,10,1,2024-07-12,False,False,False,0.7344213649851632,0.24925816023738873,0.01483679525222552,0.001483679525222552,Shoulder,Friday,July
2024-07-12 23:00:00,68,340,11,1,420,72,203,2,2,279,26.0,91,3,4.5,699,False,23,140,543,13,3,2024-07-12,False,False,False,0.776824034334764,0.20028612303290416,0.01859799713876967,0.004291845493562232,Shoulder,Friday,July
2024-07-13 00:00:00,37,163,3,1,204,66,109,3,0,178,25.8,91,3,6.3,382,True,0,103,272,6,1,2024-07-13,False,True,False,0.7120418848167539,0.2696335078534031,0.015706806282722512,0.002617801047120419,Off-Peak,Saturday,July
2024-07-13 01:00:00,24,54,4,0,82,25,57,4,0,86,25.5,92,51,6.6,168,True,1,49,111,8,0,2024-07-13,False,True,False,0.6607142857142857,0.2916666666666667,0.047619047619047616,0.0,Off-Peak,Saturday,July
2024-07-13 02:00:00,24,50,4,0,78,24,51,3,1,79,25.3,93,51,4.3,157,True,2,48,101,7,1,2024-07-13,False,True,False,0.643312101910828,0.3057324840764331,0.044585987261146494,0.006369426751592357,Off-Peak,Saturday,July
2024-07-13 03:00:00,24,52,2,0,78,25,49,2,0,76,25.2,95,51,7.0,154,True,3,49,101,4,0,2024-07-13,False,True,False,0.6558441558441559,0.3181818181818182,0.025974025974025976,0.0,Off-Peak,Saturday,July
2024-07-13 04:00:00,24,49,1,0,74,24,49,2,0,75,25.4,96,53,6.8,149,True,4,48,98,3,0,2024-07-13,False,True,False,0.6577181208053692,0.3221476510067114,0.020134228187919462,0.0,Off-Peak,Saturday,July
2024-07-13 05:00:00,127,501,4,0,632,183,361,4,2,550,25.5,96,53,6.6,1182,True,5,310,862,8,2,2024-07-13,False,True,False,0.7292724196277496,0.2622673434856176,0.00676818950930626,0.001692047377326565,Shoulder,Saturday,July
2024-07-13 06:00:00,126,483,12,0,621,202,400,10,1,613,25.5,95,51,8.5,1234,True,6,328,883,22,1,2024-07-13,False,True,False,0.7155591572123177,0.26580226904376014,0.017828200972447326,0.0008103727714748784,Shoulder,Saturday,July
2024-07-13 07:00:00,158,647,14,1,820,266,508,13,0,787,25.5,95,51,7.9,1607,True,7,424,1155,27,1,2024-07-13,False,True,True,0.7187305538270068,0.26384567517112634,0.016801493466085875,0.0006222775357809583,Peak,Saturday,July
2024-07-13 08:00:00,139,631,17,0,787,273,495,2,0,770,25.8,94,51,7.9,1557,True,8,412,1126,19,0,2024-07-13,False,True,True,0.7231856133590238,0.26461143224149003,0.012202954399486191,0.0,Peak,Saturday,July
2024-07-13 09:00:00,128,486,10,0,624,215,335,9,2,561,26.4,91,51,7.0,1185,True,9,343,821,19,2,2024-07-13,False,True,False,0.6928270042194092,0.28945147679324895,0.016033755274261603,0.0016877637130801688,Shoulder,Saturday,July
2024-07-13 10:00:00,137,445,10,0,592,186,352,11,1,550,27.6,86,2,8.7,1142,True,10,323,797,21,1,2024-07-13,False,True,False,0.6978984238178634,0.28283712784588444,0.01838879159369527,0.0008756567425569177,Shoulder,Saturday,July
2024-07-13 11:00:00,179,638,10,0,827,244,458,11,2,715,29.0,77,2,8.7,1542,True,11,423,1096,21,2,2024-07-13,False,True,True,0.7107652399481194,0.27431906614785995,0.013618677042801557,0.0012970168612191958,Peak,Saturday,July
2024-07-13 12:00:00,146,602,7,1,756,265,499,16,1,781,29.9,71,51,12.5,1537,True,12,411,1101,23,2,2024-07-13,False,True,True,0.7163305139882888,0.2674040338321405,0.014964216005204945,0.0013012361743656475,Peak,Saturday,July
2024-07-13 13:00:00,127,644,8,3,782,247,484,11,2,744,30.1,70,1,14.1,1526,True,13,374,1128,19,5,2024-07-13,False,True,True,0.7391874180865007,0.24508519003931847,0.012450851900393184,0.00327653997378768,Peak,Saturday,July
2024-07-13 14:00:00,108,493,8,0,609,180,374,9,1,564,30.4,70,3,14.7,1173,True,14,288,867,17,1,2024-07-13,False,True,False,0.7391304347826086,0.24552429667519182,0.014492753623188406,0.0008525149190110827,Peak,Saturday,July
2024-07-13 15:00:00,136,514,7,0,657,183,386,8,0,577,30.5,70,1,13.6,1234,True,15,319,900,15,0,2024-07-13,False,True,False,0.7293354943273906,0.2585089141004862,0.012155591572123177,0.0,Peak,Saturday,July
2024-07-13 16:00:00,113,514,4,1,632,202,392,8,0,602,30.2,71,1,14.0,1234,True,16,315,906,12,1,2024-07-13,False,True,False,0.7341977309562399,0.2552674230145867,0.009724473257698542,0.0008103727714748784,Peak,Saturday,July
2024-07-13 17:00:00,166,689,14,1,870,261,437,12,2,712,29.9,71,3,12.9,1582,True,17,427,1126,26,3,2024-07-13,False,True,True,0.7117572692793932,0.26991150442477874,0.01643489254108723,0.0018963337547408343,Peak,Saturday,July
2024-07-13 18:00:00,141,685,14,2,842,224,479,16,2,721,29.4,74,2,11.0,1563,True,18,365,1164,30,4,2024-07-13,False,True,True,0.744721689059501,0.23352527191298783,0.019193857965451054,0.0025591810620601407,Peak,Saturday,July
2024-07-13 19:00:00,171,646,11,0,828,266,496,4,1,767,28.8,78,2,8.8,1595,True,19,437,1142,15,1,2024-07-13,False,True,True,0.715987460815047,0.27398119122257053,0.009404388714733543,0.0006269592476489029,Peak,Saturday,July
2024-07-13 20:00:00,90,324,9,0,423,127,243,5,0,375,28.4,79,1,10.2,798,True,20,217,567,14,0,2024-07-13,False,True,False,0.7105263157894737,0.2719298245614035,0.017543859649122806,0.0,Shoulder,Saturday,July
2024-07-13 21:00:00,93,350,5,0,448,131,227,4,0,362,28.0,80,3,5.2,810,True,21,224,577,9,0,2024-07-13,False,True,False,0.7123456790123457,0.2765432098765432,0.011111111111111112,0.0,Shoulder,Saturday,July
2024-07-13 22:00:00,76,321,5,0,402,123,248,3,0,374,27.8,82,3,7.0,776,True,22,199,569,8,0,2024-07-13,False,True,False,0.7332474226804123,0.25644329896907214,0.010309278350515464,0.0,Shoulder,Saturday,July
2024-07-13 23:00:00,62,309,3,0,374,112,257,3,1,373,27.5,83,3,8.0,747,True,23,174,566,6,1,2024-07-13,False,True,False,0.7576974564926372,0.23293172690763053,0.008032128514056224,0.0013386880856760374,Shoulder,Saturday,July
2024-07-14 00:00:00,30,177,4,1,212,33,157,4,0,194,27.1,84,3,7.7,406,True,0,63,334,8,1,2024-07-14,False,False,False,0.8226600985221675,0.15517241379310345,0.019704433497536946,0.0024630541871921183,Off-Peak,Sunday,July
2024-07-14 01:00:00,27,56,1,0,84,25,53,1,1,80,27.0,86,3,11.3,164,True,1,52,109,2,1,2024-07-14,False,False,False,0.6646341463414634,0.3170731707317073,0.012195121951219513,0.006097560975609756,Off-Peak,Sunday,July
2024-07-14 02:00:00,24,52,4,1,81,24,50,4,0,78,26.6,88,3,9.4,159,True,2,48,102,8,1,2024-07-14,False,False,False,0.6415094339622641,0.3018867924528302,0.050314465408805034,0.006289308176100629,Off-Peak,Sunday,July
2024-07-14 03:00:00,24,50,4,0,78,24,49,4,0,77,25.7,89,53,11.4,155,True,3,48,99,8,0,2024-07-14,False,False,False,0.6387096774193548,0.3096774193548387,0.05161290322580645,0.0,Off-Peak,Sunday,July
2024-07-14 04:00:00,24,49,3,0,76,24,49,3,0,76,24.6,94,61,6.6,152,True,4,48,98,6,0,2024-07-14,False,False,False,0.6447368421052632,0.3157894736842105,0.039473684210526314,0.0,Off-Peak,Sunday,July
2024-07-14 05:00:00,105,504,4,1,614,127,401,4,2,534,25.1,92,51,5.6,1148,True,5,232,905,8,3,2024-07-14,False,False,False,0.7883275261324042,0.20209059233449478,0.006968641114982578,0.002613240418118467,Shoulder,Sunday,July
2024-07-14 06:00:00,112,544,7,0,663,117,408,9,0,534,25.0,94,3,7.1,1197,True,6,229,952,16,0,2024-07-14,False,False,False,0.7953216374269005,0.19131161236424393,0.013366750208855471,0.0,Shoulder,Sunday,July
2024-07-14 07:00:00,170,626,15,0,811,151,533,19,0,703,25.2,94,51,7.4,1514,True,7,321,1159,34,0,2024-07-14,False,False,True,0.7655217965653897,0.2120211360634082,0.022457067371202115,0.0,Peak,Sunday,July
2024-07-14 08:00:00,165,618,11,0,794,191,556,9,2,758,25.4,94,3,7.0,1552,True,8,356,1174,20,2,2024-07-14,False,False,True,0.7564432989690721,0.22938144329896906,0.01288659793814433,0.001288659793814433,Peak,Sunday,July
2024-07-14 09:00:00,126,505,9,0,640,123,387,9,2,521,27.1,88,51,9.2,1161,True,9,249,892,18,2,2024-07-14,False,False,False,0.768303186907838,0.2144702842377261,0.015503875968992248,0.0017226528854435831,Shoulder,Sunday,July
2024-07-14 10:00:00,116,495,12,0,623,123,435,9,2,569,26.9,83,53,14.1,1192,True,10,239,930,21,2,2024-07-14,False,False,False,0.7802013422818792,0.200503355704698,0.01761744966442953,0.0016778523489932886,Shoulder,Sunday,July
2024-07-14 11:00:00,147,672,12,1,832,181,537,19,3,740,27.8,81,51,14.5,1572,True,11,328,1209,31,4,2024-07-14,False,False,True,0.7690839694656488,0.20865139949109415,0.019720101781170483,0.002544529262086514,Peak,Sunday,July
2024-07-14 12:00:00,162,679,15,0,856,169,511,19,2,701,27.9,82,53,11.5,1557,True,12,331,1190,34,2,2024-07-14,False,False,True,0.7642903018625562,0.21258831085420682,0.021836865767501604,0.0012845215157353885,Peak,Sunday,July
2024-07-14 13:00:00,153,666,13,0,832,167,540,8,2,717,28.7,77,3,14.1,1549,True,13,320,1206,21,2,2024-07-14,False,False,True,0.7785668173014848,0.2065848934796643,0.01355713363460297,0.0012911555842479018,Peak,Sunday,July
2024-07-14 14:00:00,103,497,10,0,610,135,386,13,1,535,29.0,76,3,11.9,1145,True,14,238,883,23,1,2024-07-14,False,False,False,0.77117903930131,0.20786026200873362,0.020087336244541485,0.0008733624454148472,Peak,Sunday,July
2024-07-14 15:00:00,104,505,9,1,619,133,407,12,1,553,29.0,77,3,12.4,1172,True,15,237,912,21,2,2024-07-14,False,False,False,0.7781569965870307,0.2022184300341297,0.017918088737201365,0.0017064846416382253,Peak,Sunday,July
2024-07-14 16:00:00,131,508,8,0,647,107,377,14,0,498,28.7,78,3,12.3,1145,True,16,238,885,22,0,2024-07-14,False,False,False,0.7729257641921398,0.20786026200873362,0.01921397379912664,0.0,Peak,Sunday,July
2024-07-14 17:00:00,157,691,22,1,871,168,533,15,1,717,28.6,77,3,11.0,1588,True,17,325,1224,37,2,2024-07-14,False,False,True,0.7707808564231738,0.20465994962216624,0.023299748110831235,0.0012594458438287153,Peak,Sunday,July
2024-07-14 18:00:00,168,622,17,3,810,173,520,14,2,709,28.1,79,3,9.0,1519,True,18,341,1142,31,5,2024-07-14,False,False,True,0.7518104015799868,0.22448979591836735,0.02040816326530612,0.0032916392363396972,Peak,Sunday,July
2024-07-14 19:00:00,141,645,24,1,811,174,502,12,0,688,27.5,82,3,6.7,1499,True,19,315,1147,36,1,2024-07-14,False,False,True,0.7651767845230153,0.21014009339559706,0.02401601067378252,0.00066711140760507,Peak,Sunday,July
2024-07-14 20:00:00,79,314,9,0,402,82,265,2,3,352,26.9,84,3,7.9,754,True,20,161,579,11,3,2024-07-14,False,False,False,0.7679045092838196,0.21352785145888595,0.014588859416445624,0.003978779840848806,Shoulder,Sunday,July
2024-07-14 21:00:00,102,326,4,0,432,89,254,6,0,349,26.5,86,3,6.6,781,True,21,191,580,10,0,2024-07-14,False,False,False,0.7426376440460948,0.24455825864276567,0.012804097311139564,0.0,Shoulder,Sunday,July
2024-07-14 22:00:00,78,333,9,1,421,90,278,6,1,375,26.5,87,3,6.9,796,True,22,168,611,15,2,2024-07-14,False,False,False,0.7675879396984925,0.21105527638190955,0.018844221105527637,0.002512562814070352,Shoulder,Sunday,July
2024-07-14 23:00:00,68,359,8,1,436,90,267,7,1,365,26.3,88,3,6.5,801,True,23,158,626,15,2,2024-07-14,False,False,False,0.7815230961298377,0.1972534332084894,0.018726591760299626,0.0024968789013732834,Shoulder,Sunday,July
2024-07-15 00:00:00,26,157,2,0,185,56,108,4,0,168,26.1,90,3,6.9,353,False,0,82,265,6,0,2024-07-15,False,False,False,0.7507082152974505,0.23229461756373937,0.0169971671388102,0.0,Off-Peak,Monday,July
2024-07-15 01:00:00,24,56,1,0,81,25,50,4,1,80,25.8,92,3,5.4,161,False,1,49,106,5,1,2024-07-15,False,False,False,0.6583850931677019,0.30434782608695654,0.031055900621118012,0.006211180124223602,Off-Peak,Monday,July
2024-07-15 02:00:00,24,50,2,0,76,25,51,4,0,80,25.6,93,3,5.2,156,False,2,49,101,6,0,2024-07-15,False,False,False,0.6474358974358975,0.3141025641025641,0.038461538461538464,0.0,Off-Peak,Monday,July
2024-07-15 03:00:00,24,51,2,0,77,24,49,2,0,75,25.4,94,3,5.1,152,False,3,48,100,4,0,2024-07-15,False,False,False,0.6578947368421053,0.3157894736842105,0.02631578947368421,0.0,Off-Peak,Monday,July
2024-07-15 04:00:00,24,49,0,1,74,24,49,2,1,76,25.1,94,3,4.0,150,False,4,48,98,2,2,2024-07-15,False,False,False,0.6533333333333333,0.32,0.013333333333333334,0.013333333333333334,Off-Peak,Monday,July
2024-07-15 05:00:00,93,463,4,0,560,117,312,4,3,436,24.8,95,2,3.8,996,False,5,210,775,8,3,2024-07-15,False,False,False,0.7781124497991968,0.21084337349397592,0.008032128514056224,0.0030120481927710845,Shoulder,Monday,July
2024-07-15 06:00:00,79,495,6,2,582,129,349,14,0,492,25.1,94,51,5.0,1074,False,6,208,844,20,2,2024-07-15,False,False,False,0.7858472998137802,0.19366852886405958,0.0186219739292365,0.00186219739292365,Shoulder,Monday,July
2024-07-15 07:00:00,124,659,8,0,791,185,410,15,3,613,24.6,96,51,6.2,1404,False,7,309,1069,23,3,2024-07-15,False,False,True,0.7613960113960114,0.22008547008547008,0.01638176638176638,0.002136752136752137,Peak,Monday,July
2024-07-15 08:00:00,118,607,8,1,734,138,381,12,2,533,25.8,93,51,5.4,1267,False,8,256,988,20,3,2024-07-15,False,False,False,0.7797947908445146,0.20205209155485399,0.01578531965272297,0.0023677979479084454,Peak,Monday,July
2024-07-15 09:00:00,91,475,3,0,569,129,318,10,1,458,27.2,86,51,7.9,1027,False,9,220,793,13,1,2024-07-15,False,False,False,0.7721518987341772,0.21421616358325218,0.012658227848101266,0.0009737098344693282,Shoulder,Monday,July
2024-07-15 10:00:00,75,527,5,0,607,119,301,10,1,431,28.2,78,51,13.2,1038,False,10,194,828,15,1,2024-07-15,False,False,False,0.7976878612716763,0.18689788053949905,0.014450867052023121,0.0009633911368015414,Shoulder,Monday,July
2024-07-15 11:00:00,118,684,7,1,810,166,385,19,3,573,29.0,74,51,13.0,1383,False,11,284,1069,26,4,2024-07-15,False,False,True,0.7729573391178597,0.20535068691250905,0.018799710773680405,0.0028922631959508315,Peak,Monday,July
2024-07-15 12:00:00,117,639,8,0,764,181,376,11,1,569,29.7,72,51,13.6,1333,False,12,298,1015,19,1,2024-07-15,False,False,False,0.7614403600900225,0.22355588897224307,0.014253563390847712,0.0007501875468867217,Peak,Monday,July
2024-07-15 13:00:00,138,630,6,0,774,173,406,17,1,597,30.2,69,3,14.8,1371,False,13,311,1036,23,1,2024-07-15,False,False,False,0.7556528081692195,0.22684172137126185,0.016776075857038657,0.0007293946024799417,Peak,Monday,July
2024-07-15 14:00:00,87,445,5,0,537,132,300,14,0,446,30.4,68,2,14.3,983,False,14,219,745,19,0,2024-07-15,False,False,False,0.757884028484232,0.22278738555442523,0.019328585961342827,0.0,Peak,Monday,July
2024-07-15 15:00:00,91,458,10,1,560,139,303,12,1,455,30.5,68,3,13.3,1015,False,15,230,761,22,2,2024-07-15,False,False,False,0.7497536945812808,0.22660098522167488,0.02167487684729064,0.0019704433497536944,Peak,Monday,July
2024-07-15 16:00:00,100,462,7,0,569,126,327,13,0,466,30.4,67,1,12.2,1035,False,16,226,789,20,0,2024-07-15,False,False,False,0.7623188405797101,0.21835748792270532,0.01932367149758454,0.0,Peak,Monday,July
2024-07-15 17:00:00,117,669,7,1,794,189,436,14,2,641,30.2,69,0,11.6,1435,False,17,306,1105,21,3,2024-07-15,False,False,True,0.7700348432055749,0.2132404181184669,0.014634146341463415,0.0020905923344947735,Peak,Monday,July
2024-07-15 18:00:00,109,602,12,1,724,179,421,10,3,613,29.6,72,3,9.7,1337,False,18,288,1023,22,4,2024-07-15,False,False,False,0.7651458489154824,0.21540762902019447,0.016454749439042633,0.0029917726252804786,Peak,Monday,July
2024-07-15 19:00:00,131,629,9,3,772,190,424,13,1,628,28.7,77,3,6.7,1400,False,19,321,1053,22,4,2024-07-15,False,False,True,0.7521428571428571,0.2292857142857143,0.015714285714285715,0.002857142857142857,Peak,Monday,July
2024-07-15 20:00:00,70,362,5,0,437,79,214,15,0,308,27.8,80,3,6.6,745,False,20,149,576,20,0,2024-07-15,False,False,False,0.7731543624161074,0.2,0.026845637583892617,0.0,Shoulder,Monday,July
2024-07-15 21:00:00,61,319,1,0,381,86,193,3,1,283,27.4,82,1,5.4,664,False,21,147,512,4,1,2024-07-15,False,False,False,0.7710843373493976,0.2213855421686747,0.006024096385542169,0.0015060240963855422,Shoulder,Monday,July
2024-07-15 22:00:00,58,334,2,1,395,96,198,6,0,300,27.1,86,2,6.4,695,False,22,154,532,8,1,2024-07-15,False,False,False,0.7654676258992805,0.22158273381294963,0.011510791366906475,0.0014388489208633094,Shoulder,Monday,July
2024-07-15 23:00:00,69,314,2,0,385,100,208,7,1,316,26.8,88,3,6.2,701,False,23,169,522,9,1,2024-07-15,False,False,False,0.7446504992867332,0.24108416547788872,0.012838801711840228,0.0014265335235378032,Shoulder,Monday,July
2024-07-16 00:00:00,30,168,3,0,201,40,86,5,0,131,26.6,89,3,6.0,332,False,0,70,254,8,0,2024-07-16,False,False,False,0.7650602409638554,0.21084337349397592,0.024096385542168676,0.0,Off-Peak,Tuesday,July
2024-07-16 01:00:00,25,51,1,0,77,25,49,4,1,79,26.4,89,3,6.3,156,False,1,50,100,5,1,2024-07-16,False,False,False,0.6410256410256411,0.32051282051282054,0.03205128205128205,0.00641025641025641,Off-Peak,Tuesday,July
2024-07-16 02:00:00,24,54,2,0,80,24,51,0,1,76,26.2,90,3,5.4,156,False,2,48,105,2,1,2024-07-16,False,False,False,0.6730769230769231,0.3076923076923077,0.01282051282051282,0.00641025641025641,Off-Peak,Tuesday,July
2024-07-16 03:00:00,24,50,5,1,80,24,49,3,0,76,26.3,89,3,5.2,156,False,3,48,99,8,1,2024-07-16,False,False,False,0.6346153846153846,0.3076923076923077,0.05128205128205128,0.00641025641025641,Off-Peak,Tuesday,July
2024-07-16 04:00:00,24,49,3,1,77,24,49,4,0,77,26.0,91,3,4.9,154,False,4,48,98,7,1,2024-07-16,False,False,False,0.6363636363636364,0.3116883116883117,0.045454545454545456,0.006493506493506494,Off-Peak,Tuesday,July
2024-07-16 05:00:00,114,463,4,2,583,128,245,4,1,378,26.4,88,3,7.7,961,False,5,242,708,8,3,2024-07-16,False,False,False,0.736732570239334,0.2518210197710718,0.008324661810613945,0.003121748178980229,Shoulder,Tuesday,July
2024-07-16 06:00:00,110,444,12,1,567,121,315,12,0,448,26.5,87,3,7.8,1015,False,6,231,759,24,1,2024-07-16,False,False,False,0.7477832512315271,0.22758620689655173,0.023645320197044337,0.0009852216748768472,Shoulder,Tuesday,July
2024-07-16 07:00:00,140,603,21,0,764,145,382,10,2,539,26.9,82,3,10.0,1303,False,7,285,985,31,2,2024-07-16,False,False,False,0.7559478127398311,0.21872601688411358,0.023791250959324637,0.0015349194167306216,Peak,Tuesday,July
2024-07-16 08:00:00,131,659,10,1,801,174,408,11,4,597,27.3,80,51,12.1,1398,False,8,305,1067,21,5,2024-07-16,False,False,True,0.7632331902718169,0.21816881258941345,0.015021459227467811,0.00357653791130186,Peak,Tuesday,July
2024-07-16 09:00:00,108,457,8,0,573,121,288,18,2,429,28.0,76,51,12.8,1002,False,9,229,745,26,2,2024-07-16,False,False,False,0.7435129740518962,0.22854291417165667,0.02594810379241517,0.001996007984031936,Shoulder,Tuesday,July
2024-07-16 10:00:00,120,462,8,1,591,118,285,12,0,415,28.1,75,51,15.5,1006,False,10,238,747,20,1,2024-07-16,False,False,False,0.742544731610338,0.23658051689860835,0.019880715705765408,0.0009940357852882703,Shoulder,Tuesday,July
2024-07-16 11:00:00,151,610,7,0,768,152,471,11,2,636,28.7,76,51,16.5,1404,False,11,303,1081,18,2,2024-07-16,False,False,True,0.76994301994302,0.21581196581196582,0.01282051282051282,0.0014245014245014246,Peak,Tuesday,July
2024-07-16 12:00:00,128,619,17,0,764,167,384,9,1,561,29.3,75,51,18.4,1325,False,12,295,1003,26,1,2024-07-16,False,False,False,0.7569811320754717,0.22264150943396227,0.019622641509433963,0.0007547169811320754,Peak,Tuesday,July
2024-07-16 13:00:00,138,654,17,0,809,150,404,14,0,568,29.9,72,51,17.6,1377,False,13,288,1058,31,0,2024-07-16,False,False,True,0.7683369644153958,0.20915032679738563,0.02251270878721859,0.0,Peak,Tuesday,July
2024-07-16 14:00:00,115,519,12,1,647,107,291,8,0,406,30.5,69,51,16.4,1053,False,14,222,810,20,1,2024-07-16,False,False,False,0.7692307692307693,0.21082621082621084,0.01899335232668566,0.000949667616334283,Peak,Tuesday,July
2024-07-16 15:00:00,91,523,16,0,630,115,320,11,2,448,30.6,68,2,15.5,1078,False,15,206,843,27,2,2024-07-16,False,False,False,0.7820037105751392,0.19109461966604824,0.02504638218923933,0.0018552875695732839,Peak,Tuesday,July
2024-07-16 16:00:00,93,466,10,1,570,116,290,10,2,418,30.4,69,1,14.7,988,False,16,209,756,20,3,2024-07-16,False,False,False,0.7651821862348178,0.21153846153846154,0.020242914979757085,0.003036437246963563,Peak,Tuesday,July
2024-07-16 17:00:00,141,647,17,1,806,147,393,14,2,556,30.2,70,3,13.8,1362,False,17,288,1040,31,3,2024-07-16,False,False,False,0.7635829662261381,0.21145374449339208,0.02276064610866373,0.0022026431718061676,Peak,Tuesday,July
2024-07-16 18:00:00,145,612,11,1,769,153,357,15,2,527,29.9,70,3,11.8,1296,False,18,298,969,26,3,2024-07-16,False,False,False,0.7476851851851852,0.22993827160493827,0.020061728395061727,0.0023148148148148147,Peak,Tuesday,July
2024-07-16 19:00:00,132,670,15,0,817,116,398,10,3,527,29.2,73,3,8.7,1344,False,19,248,1068,25,3,2024-07-16,False,False,False,0.7946428571428571,0.18452380952380953,0.018601190476190476,0.002232142857142857,Peak,Tuesday,July
2024-07-16 20:00:00,75,291,5,2,373,75,176,3,1,255,28.4,75,3,8.4,628,False,20,150,467,8,3,2024-07-16,False,False,False,0.7436305732484076,0.23885350318471338,0.012738853503184714,0.004777070063694267,Shoulder,Tuesday,July
2024-07-16 21:00:00,60,310,6,0,376,79,185,5,1,270,27.6,76,3,7.0,646,False,21,139,495,11,1,2024-07-16,False,False,False,0.7662538699690402,0.21517027863777088,0.017027863777089782,0.0015479876160990713,Shoulder,Tuesday,July
2024-07-16 22:00:00,56,326,5,1,388,70,202,8,0,280,27.2,79,3,6.5,668,False,22,126,528,13,1,2024-07-16,False,False,False,0.7904191616766467,0.18862275449101795,0.019461077844311378,0.0014970059880239522,Shoulder,Tuesday,July
2024-07-16 23:00:00,67,335,4,0,406,70,187,7,1,265,26.8,80,3,8.7,671,False,23,137,522,11,1,2024-07-16,False,False,False,0.7779433681073026,0.20417287630402384,0.01639344262295082,0.0014903129657228018,Shoulder,Tuesday,July
2024-07-17 00:00:00,33,157,3,0,193,37,94,2,1,134,26.5,82,3,9.5,327,False,0,70,251,5,1,2024-07-17,False,False,False,0.7675840978593272,0.21406727828746178,0.01529051987767584,0.0030581039755351682,Off-Peak,Wednesday,July
2024-07-17 01:00:00,26,55,1,0,82,25,50,4,0,79,26.3,82,3,9.4,161,False,1,51,105,5,0,2024-07-17,False,False,False,0.6521739130434783,0.3167701863354037,0.031055900621118012,0.0,Off-Peak,Wednesday,July
2024-07-17 02:00:00,24,52,1,0,77,24,50,4,0,78,26.2,83,3,9.7,155,False,2,48,102,5,0,2024-07-17,False,False,False,0.6580645161290323,0.3096774193548387,0.03225806451612903,0.0,Off-Peak,Wednesday,July
2024-07-17 03:00:00,25,51,3,0,79,25,49,3,0,77,26.0,85,3,8.6,156,False,3,50,100,6,0,2024-07-17,False,False,False,0.6410256410256411,0.32051282051282054,0.038461538461538464,0.0,Off-Peak,Wednesday,July
2024-07-17 04:00:00,24,49,2,0,75,24,49,1,0,74,25.8,87,3,6.5,149,False,4,48,98,3,0,2024-07-17,False,False,False,0.6577181208053692,0.3221476510067114,0.020134228187919462,0.0,Off-Peak,Wednesday,July
2024-07-17 05:00:00,102,445,4,2,553,110,238,2,1,351,25.7,88,3,5.7,904,False,5,212,683,6,3,2024-07-17,False,False,False,0.7555309734513275,0.2345132743362832,0.00663716814159292,0.00331858407079646,Shoulder,Wednesday,July
2024-07-17 06:00:00,85,458,12,0,555,116,241,9,2,368,25.5,89,3,4.7,923,False,6,201,699,21,2,2024-07-17,False,False,False,0.7573131094257854,0.21776814734561215,0.02275189599133261,0.0021668472372697724,Shoulder,Wednesday,July
2024-07-17 07:00:00,135,604,6,2,747,136,309,9,2,456,25.5,90,51,4.7,1203,False,7,271,913,15,4,2024-07-17,False,False,False,0.7589359933499584,0.22527015793848712,0.012468827930174564,0.0033250207813798837,Peak,Wednesday,July
2024-07-17 08:00:00,127,615,9,2,753,142,347,7,1,497,26.4,89,3,6.4,1250,False,8,269,962,16,3,2024-07-17,False,False,False,0.7696,0.2152,0.0128,0.0024,Peak,Wednesday,July
2024-07-17 09:00:00,87,423,5,1,516,98,239,3,0,340,28.6,75,51,9.7,856,False,9,185,662,8,1,2024-07-17,False,False,False,0.7733644859813084,0.2161214953271028,0.009345794392523364,0.0011682242990654205,Shoulder,Wednesday,July
2024-07-17 10:00:00,93,455,0,0,548,106,231,5,2,344,29.6,69,3,12.1,892,False,10,199,686,5,2,2024-07-17,False,False,False,0.7690582959641256,0.22309417040358745,0.005605381165919282,0.002242152466367713,Shoulder,Wednesday,July
2024-07-17 11:00:00,122,625,2,1,750,147,309,10,0,466,30.2,67,3,13.7,1216,False,11,269,934,12,1,2024-07-17,False,False,False,0.7680921052631579,0.22121710526315788,0.009868421052631578,0.0008223684210526315,Peak,Wednesday,July
2024-07-17 12:00:00,127,590,7,0,724,134,346,12,0,492,30.5,67,3,16.1,1216,False,12,261,936,19,0,2024-07-17,False,False,False,0.7697368421052632,0.21463815789473684,0.015625,0.0,Peak,Wednesday,July
2024-07-17 13:00:00,123,587,12,0,722,152,320,7,2,481,30.6,69,2,15.6,1203,False,13,275,907,19,2,2024-07-17,False,False,False,0.7539484621778886,0.228595178719867,0.015793848711554447,0.0016625103906899418,Peak,Wednesday,July
2024-07-17 14:00:00,103,460,4,1,568,96,261,7,1,365,30.8,68,3,14.5,933,False,14,199,721,11,2,2024-07-17,False,False,False,0.7727759914255091,0.2132904608788853,0.011789924973204717,0.0021436227224008574,Peak,Wednesday,July
2024-07-17 15:00:00,71,474,4,1,550,106,238,7,1,352,30.4,71,0,13.0,902,False,15,177,712,11,2,2024-07-17,False,False,False,0.7893569844789357,0.19623059866962306,0.012195121951219513,0.0022172949002217295,Peak,Wednesday,July
2024-07-17 16:00:00,84,489,4,1,578,114,244,13,2,373,30.7,70,1,11.5,951,False,16,198,733,17,3,2024-07-17,False,False,False,0.7707676130389064,0.2082018927444795,0.017875920084121977,0.0031545741324921135,Peak,Wednesday,July
2024-07-17 17:00:00,118,598,9,0,725,142,360,13,3,518,30.5,71,1,10.1,1243,False,17,260,958,22,3,2024-07-17,False,False,False,0.7707160096540627,0.20917135961383748,0.017699115044247787,0.002413515687851971,Peak,Wednesday,July
2024-07-17 18:00:00,140,580,6,1,727,126,313,10,1,450,30.0,72,2,10.5,1177,False,18,266,893,16,2,2024-07-17,False,False,False,0.7587085811384877,0.2259983007646559,0.013593882752761258,0.0016992353440951572,Peak,Wednesday,July
2024-07-17 19:00:00,126,622,6,0,754,127,318,5,2,452,29.3,76,2,9.2,1206,False,19,253,940,11,2,2024-07-17,False,False,False,0.7794361525704809,0.20978441127694858,0.00912106135986733,0.001658374792703151,Peak,Wednesday,July
2024-07-17 20:00:00,76,289,6,0,371,71,160,3,2,236,28.7,79,3,8.2,607,False,20,147,449,9,2,2024-07-17,False,False,False,0.7397034596375618,0.24217462932454695,0.014827018121911038,0.0032948929159802307,Shoulder,Wednesday,July
2024-07-17 21:00:00,73,326,3,1,403,54,158,3,2,217,28.5,76,3,10.0,620,False,21,127,484,6,3,2024-07-17,False,False,False,0.7806451612903226,0.20483870967741935,0.00967741935483871,0.004838709677419355,Shoulder,Wednesday,July
2024-07-17 22:00:00,58,307,8,1,374,72,163,5,1,241,28.2,78,3,7.9,615,False,22,130,470,13,2,2024-07-17,False,False,False,0.7642276422764228,0.21138211382113822,0.02113821138211382,0.0032520325203252032,Shoulder,Wednesday,July
2024-07-17 23:00:00,70,292,3,0,365,55,161,7,2,225,27.6,82,3,6.4,590,False,23,125,453,10,2,2024-07-17,False,False,False,0.7677966101694915,0.211864406779661,0.01694915254237288,0.003389830508474576,Shoulder,Wednesday,July
2024-07-18 00:00:00,38,140,4,0,182,45,97,2,2,146,27.0,85,3,6.5,328,False,0,83,237,6,2,2024-07-18,False,False,False,0.7225609756097561,0.2530487804878049,0.018292682926829267,0.006097560975609756,Off-Peak,Thursday,July
2024-07-18 01:00:00,26,52,4,0,82,26,53,4,0,83,26.6,85,3,8.6,165,False,1,52,105,8,0,2024-07-18,False,False,False,0.6363636363636364,0.3151515151515151,0.048484848484848485,0.0,Off-Peak,Thursday,July
2024-07-18 02:00:00,24,50,4,1,79,24,50,4,0,78,26.5,85,3,9.0,157,False,2,48,100,8,1,2024-07-18,False,False,False,0.6369426751592356,0.3057324840764331,0.050955414012738856,0.006369426751592357,Off-Peak,Thursday,July
2024-07-18 03:00:00,24,50,1,0,75,24,49,1,0,74,26.7,85,3,9.2,149,False,3,48,99,2,0,2024-07-18,False,False,False,0.6644295302013423,0.3221476510067114,0.013422818791946308,0.0,Off-Peak,Thursday,July
2024-07-18 04:00:00,21,49,4,1,75,24,49,2,0,75,26.8,87,3,9.1,150,False,4,45,98,6,1,2024-07-18,False,False,False,0.6533333333333333,0.3,0.04,0.006666666666666667,Off-Peak,Thursday,July
2024-07-18 05:00:00,101,447,4,0,552,146,300,4,1,451,26.6,89,3,7.2,1003,False,5,247,747,8,1,2024-07-18,False,False,False,0.744765702891326,0.24626121635094717,0.007976071784646061,0.0009970089730807576,Shoulder,Thursday,July
2024-07-18 06:00:00,94,402,6,2,504,148,276,6,2,432,26.7,88,3,8.6,936,False,6,242,678,12,4,2024-07-18,False,False,False,0.7243589743589743,0.25854700854700857,0.01282051282051282,0.004273504273504274,Shoulder,Thursday,July
2024-07-18 07:00:00,142,541,13,1,697,176,388,12,4,580,26.8,88,3,8.4,1277,False,7,318,929,25,5,2024-07-18,False,False,False,0.7274862960062647,0.2490211433046202,0.01957713390759593,0.003915426781519186,Peak,Thursday,July
2024-07-18 08:00:00,128,517,18,3,666,177,384,10,3,574,27.4,85,3,10.2,1240,False,8,305,901,28,6,2024-07-18,False,False,False,0.7266129032258064,0.24596774193548387,0.02258064516129032,0.004838709677419355,Peak,Thursday,July
2024-07-18 09:00:00,107,417,9,0,533,150,291,9,1,451,28.8,75,3,14.8,984,False,9,257,708,18,1,2024-07-18,False,False,False,0.7195121951219512,0.2611788617886179,0.018292682926829267,0.0010162601626016261,Shoulder,Thursday,July
2024-07-18 10:00:00,99,376,9,1,485,140,296,14,0,450,29.6,71,3,14.1,935,False,10,239,672,23,1,2024-07-18,False,False,False,0.718716577540107,0.2556149732620321,0.02459893048128342,0.0010695187165775401,Shoulder,Thursday,July
2024-07-18 11:00:00,120,601,13,2,736,168,404,13,1,586,30.1,69,3,15.6,1322,False,11,288,1005,26,3,2024-07-18,False,False,False,0.7602118003025718,0.2178517397881997,0.019667170953101363,0.0022692889561270802,Peak,Thursday,July
2024-07-18 12:00:00,127,538,15,0,680,189,377,15,1,582,30.3,70,3,17.5,1262,False,12,316,915,30,1,2024-07-18,False,False,False,0.7250396196513471,0.25039619651347067,0.02377179080824089,0.000792393026941363,Peak,Thursday,July
2024-07-18 13:00:00,130,596,15,0,741,176,406,6,2,590,30.6,71,51,17.6,1331,False,13,306,1002,21,2,2024-07-18,False,False,False,0.7528174305033809,0.2299023290758828,0.015777610818933134,0.0015026296018031556,Peak,Thursday,July
2024-07-18 14:00:00,93,435,14,0,542,143,303,7,0,453,30.8,70,3,17.0,995,False,14,236,738,21,0,2024-07-18,False,False,False,0.7417085427135678,0.2371859296482412,0.021105527638190954,0.0,Peak,Thursday,July
2024-07-18 15:00:00,82,453,9,0,544,116,276,8,2,402,30.7,70,3,15.6,946,False,15,198,729,17,2,2024-07-18,False,False,False,0.7706131078224101,0.20930232558139536,0.017970401691331923,0.0021141649048625794,Peak,Thursday,July
2024-07-18 16:00:00,85,417,10,0,512,139,260,5,2,406,30.6,70,3,14.5,918,False,16,224,677,15,2,2024-07-18,False,False,False,0.7374727668845316,0.2440087145969499,0.016339869281045753,0.002178649237472767,Peak,Thursday,July
2024-07-18 17:00:00,147,546,12,0,705,196,402,8,2,608,30.6,70,3,14.2,1313,False,17,343,948,20,2,2024-07-18,False,False,False,0.722010662604722,0.26123381568926124,0.015232292460015232,0.0015232292460015233,Peak,Thursday,July
2024-07-18 18:00:00,125,569,10,0,704,187,392,8,0,587,30.0,72,3,13.8,1291,False,18,312,961,18,0,2024-07-18,False,False,False,0.7443841982958946,0.24167312161115415,0.013942680092951201,0.0,Peak,Thursday,July
2024-07-18 19:00:00,140,605,15,1,761,193,418,8,2,621,29.3,75,3,12.9,1382,False,19,333,1023,23,3,2024-07-18,False,False,True,0.7402315484804631,0.24095513748191028,0.016642547033285094,0.002170767004341534,Peak,Thursday,July
2024-07-18 20:00:00,63,288,5,0,356,107,202,3,1,313,28.9,77,0,12.7,669,False,20,170,490,8,1,2024-07-18,False,False,False,0.7324364723467862,0.25411061285500747,0.01195814648729447,0.0014947683109118087,Shoulder,Thursday,July
2024-07-18 21:00:00,80,322,7,1,410,114,192,3,1,310,28.4,76,0,9.4,720,False,21,194,514,10,2,2024-07-18,False,False,False,0.7138888888888889,0.26944444444444443,0.013888888888888888,0.002777777777777778,Shoulder,Thursday,July
2024-07-18 22:00:00,54,289,14,1,358,98,193,6,0,297,27.9,78,0,10.8,655,False,22,152,482,20,1,2024-07-18,False,False,False,0.7358778625954199,0.23206106870229007,0.030534351145038167,0.0015267175572519084,Shoulder,Thursday,July
2024-07-18 23:00:00,64,259,4,1,328,86,180,3,3,272,27.5,80,0,10.8,600,False,23,150,439,7,4,2024-07-18,False,False,False,0.7316666666666667,0.25,0.011666666666666667,0.006666666666666667,Shoulder,Thursday,July
2024-07-19 00:00:00,40,164,3,1,208,64,112,1,0,177,27.2,81,0,10.8,385,False,0,104,276,4,1,2024-07-19,False,False,False,0.7168831168831169,0.2701298701298701,0.01038961038961039,0.0025974025974025974,Off-Peak,Friday,July
2024-07-19 01:00:00,26,50,4,0,80,24,50,1,0,75,27.1,83,0,10.1,155,False,1,50,100,5,0,2024-07-19,False,False,False,0.6451612903225806,0.3225806451612903,0.03225806451612903,0.0,Off-Peak,Friday,July
2024-07-19 02:00:00,24,52,4,1,81,26,51,0,0,77,27.0,84,0,10.6,158,False,2,50,103,4,1,2024-07-19,False,False,False,0.6518987341772152,0.31645569620253167,0.02531645569620253,0.006329113924050633,Off-Peak,Friday,July
2024-07-19 03:00:00,24,49,1,0,74,25,49,4,0,78,27.0,85,0,9.7,152,False,3,49,98,5,0,2024-07-19,False,False,False,0.6447368421052632,0.3223684210526316,0.03289473684210526,0.0,Off-Peak,Friday,July
2024-07-19 04:00:00,24,49,4,0,77,24,49,3,2,78,26.9,86,1,8.9,155,False,4,48,98,7,2,2024-07-19,False,False,False,0.632258064516129,0.3096774193548387,0.04516129032258064,0.012903225806451613,Off-Peak,Friday,July
2024-07-19 05:00:00,100,457,4,0,561,168,322,4,2,496,26.9,87,1,8.6,1057,False,5,268,779,8,2,2024-07-19,False,False,False,0.7369914853358562,0.2535477767265847,0.007568590350047304,0.001892147587511826,Shoulder,Friday,July
2024-07-19 06:00:00,91,417,7,0,515,189,345,7,1,542,26.9,86,1,10.0,1057,False,6,280,762,14,1,2024-07-19,False,False,False,0.7209082308420057,0.26490066225165565,0.013245033112582781,0.000946073793755913,Shoulder,Friday,July
2024-07-19 07:00:00,119,569,8,1,697,263,481,10,2,756,26.8,86,1,11.7,1453,False,7,382,1050,18,3,2024-07-19,False,False,True,0.7226428079834825,0.2629043358568479,0.012388162422573986,0.0020646937370956643,Peak,Friday,July
2024-07-19 08:00:00,143,597,11,2,753,239,509,12,5,765,27.2,84,51,12.3,1518,False,8,382,1106,23,7,2024-07-19,False,False,True,0.7285902503293807,0.2516469038208169,0.015151515151515152,0.00461133069828722,Peak,Friday,July
2024-07-19 09:00:00,109,419,14,0,542,186,340,6,1,533,27.8,83,51,10.3,1075,False,9,295,759,20,1,2024-07-19,False,False,False,0.706046511627907,0.2744186046511628,0.018604651162790697,0.0009302325581395349,Shoulder,Friday,July
2024-07-19 10:00:00,89,439,9,0,537,151,329,11,4,495,28.0,81,53,10.7,1032,False,10,240,768,20,4,2024-07-19,False,False,False,0.7441860465116279,0.23255813953488372,0.01937984496124031,0.003875968992248062,Shoulder,Friday,July
2024-07-19 11:00:00,135,570,13,0,718,253,446,12,1,712,28.0,81,51,13.3,1430,False,11,388,1016,25,1,2024-07-19,False,False,True,0.7104895104895105,0.27132867132867133,0.017482517482517484,0.0006993006993006993,Peak,Friday,July
2024-07-19 12:00:00,124,594,17,1,736,233,450,17,2,702,29.6,74,51,20.0,1438,False,12,357,1044,34,3,2024-07-19,False,False,True,0.7260083449235049,0.2482614742698192,0.02364394993045897,0.002086230876216968,Peak,Friday,July
2024-07-19 13:00:00,130,534,16,2,682,241,470,14,1,726,30.2,72,51,20.4,1408,False,13,371,1004,30,3,2024-07-19,False,False,True,0.7130681818181818,0.2634943181818182,0.02130681818181818,0.002130681818181818,Peak,Friday,July
2024-07-19 14:00:00,76,423,8,1,508,194,405,11,2,612,30.6,70,3,19.2,1120,False,14,270,828,19,3,2024-07-19,False,False,False,0.7392857142857143,0.24107142857142858,0.016964285714285713,0.0026785714285714286,Peak,Friday,July
2024-07-19 15:00:00,102,450,12,0,564,166,379,10,1,556,30.3,72,3,19.6,1120,False,15,268,829,22,1,2024-07-19,False,False,False,0.7401785714285715,0.2392857142857143,0.019642857142857142,0.0008928571428571428,Peak,Friday,July
2024-07-19 16:00:00,85,408,5,0,498,207,363,5,2,577,29.8,75,3,18.0,1075,False,16,292,771,10,2,2024-07-19,False,False,False,0.7172093023255814,0.27162790697674416,0.009302325581395349,0.0018604651162790699,Peak,Friday,July
2024-07-19 17:00:00,123,582,20,1,726,238,477,17,0,732,29.9,75,3,17.4,1458,False,17,361,1059,37,1,2024-07-19,False,False,True,0.7263374485596708,0.247599451303155,0.025377229080932786,0.0006858710562414266,Peak,Friday,July
2024-07-19 18:00:00,114,561,16,1,692,239,453,13,0,705,29.5,75,3,16.0,1397,False,18,353,1014,29,1,2024-07-19,False,False,True,0.7258410880458125,0.2526843235504653,0.020758768790264854,0.0007158196134574087,Peak,Friday,July
2024-07-19 19:00:00,139,579,10,0,728,250,443,16,0,709,29.1,77,3,14.4,1437,False,19,389,1022,26,0,2024-07-19,False,False,True,0.7112038970076549,0.2707028531663187,0.018093249826026444,0.0,Peak,Friday,July
2024-07-19 20:00:00,58,302,3,0,363,98,221,5,0,324,28.6,79,3,12.4,687,False,20,156,523,8,0,2024-07-19,False,False,False,0.7612809315866085,0.22707423580786026,0.011644832605531296,0.0,Shoulder,Friday,July
2024-07-19 21:00:00,63,324,3,2,392,129,219,5,0,353,28.1,80,3,7.7,745,False,21,192,543,8,2,2024-07-19,False,False,False,0.7288590604026846,0.25771812080536916,0.010738255033557046,0.0026845637583892616,Shoulder,Friday,July
2024-07-19 22:00:00,50,270,10,3,333,129,252,7,0,388,27.6,82,3,7.6,721,False,22,179,522,17,3,2024-07-19,False,False,False,0.723994452149792,0.24826629680998613,0.023578363384188627,0.004160887656033287,Shoulder,Friday,July
2024-07-19 23:00:00,58,282,10,1,351,130,239,7,2,378,27.5,82,3,9.0,729,False,23,188,521,17,3,2024-07-19,False,False,False,0.7146776406035665,0.2578875171467764,0.023319615912208505,0.00411522633744856,Shoulder,Friday,July
2024-07-20 00:00:00,35,136,3,1,175,66,92,2,0,160,27.4,82,3,9.9,335,True,0,101,228,5,1,2024-07-20,False,False,False,0.6805970149253732,0.30149253731343284,0.014925373134328358,0.0029850746268656717,Off-Peak,Saturday,July
2024-07-20 01:00:00,24,52,4,1,81,28,52,4,0,84,27.4,83,3,9.0,165,True,1,52,104,8,1,2024-07-20,False,False,False,0.6303030303030303,0.3151515151515151,0.048484848484848485,0.006060606060606061,Off-Peak,Saturday,July
2024-07-20 02:00:00,25,51,2,0,78,25,50,4,0,79,27.3,85,3,8.0,157,True,2,50,101,6,0,2024-07-20,False,False,False,0.643312101910828,0.3184713375796178,0.03821656050955414,0.0,Off-Peak,Saturday,July
2024-07-20 03:00:00,24,49,3,0,76,24,50,3,1,78,27.3,85,3,10.8,154,True,3,48,99,6,1,2024-07-20,False,False,False,0.6428571428571429,0.3116883116883117,0.03896103896103896,0.006493506493506494,Off-Peak,Saturday,July
2024-07-20 04:00:00,24,49,3,0,76,24,49,3,0,76,26.9,87,3,9.9,152,True,4,48,98,6,0,2024-07-20,False,False,False,0.6447368421052632,0.3157894736842105,0.039473684210526314,0.0,Off-Peak,Saturday,July
2024-07-20 05:00:00,88,489,4,1,582,216,314,4,1,535,26.8,87,3,8.4,1117,True,5,304,803,8,2,2024-07-20,False,False,False,0.7188898836168308,0.2721575649059982,0.007162041181736795,0.0017905102954341987,Shoulder,Saturday,July
2024-07-20 06:00:00,106,440,11,0,557,206,344,9,2,561,26.6,88,3,9.0,1118,True,6,312,784,20,2,2024-07-20,False,False,False,0.7012522361359571,0.27906976744186046,0.017889087656529516,0.0017889087656529517,Shoulder,Saturday,July
2024-07-20 07:00:00,159,597,15,0,771,263,461,6,1,731,26.2,89,3,9.0,1502,True,7,422,1058,21,1,2024-07-20,False,False,True,0.7043941411451398,0.2809587217043941,0.013981358189081226,0.0006657789613848203,Peak,Saturday,July
2024-07-20 08:00:00,161,567,13,1,742,241,441,10,4,696,26.8,88,2,8.8,1438,True,8,402,1008,23,5,2024-07-20,False,False,True,0.7009735744089013,0.2795549374130737,0.015994436717663423,0.0034770514603616135,Peak,Saturday,July
2024-07-20 09:00:00,114,460,3,3,580,175,352,7,1,535,28.2,80,3,10.0,1115,True,9,289,812,10,4,2024-07-20,False,False,False,0.7282511210762331,0.2591928251121076,0.008968609865470852,0.003587443946188341,Shoulder,Saturday,July
2024-07-20 10:00:00,111,454,11,0,576,185,353,5,1,544,29.4,74,51,15.2,1120,True,10,296,807,16,1,2024-07-20,False,False,False,0.7205357142857143,0.2642857142857143,0.014285714285714285,0.0008928571428571428,Shoulder,Saturday,July
2024-07-20 11:00:00,156,605,17,2,780,250,456,20,1,727,30.2,71,51,17.7,1507,True,11,406,1061,37,3,2024-07-20,False,False,True,0.7040477770404777,0.26940942269409424,0.0245520902455209,0.0019907100199071004,Peak,Saturday,July
2024-07-20 12:00:00,164,595,16,1,776,244,450,11,4,709,30.5,70,51,18.0,1485,True,12,408,1045,27,5,2024-07-20,False,False,True,0.7037037037037037,0.27474747474747474,0.01818181818181818,0.003367003367003367,Peak,Saturday,July
2024-07-20 13:00:00,155,598,13,0,766,257,425,12,2,696,30.1,74,3,17.5,1462,True,13,412,1023,25,2,2024-07-20,False,False,True,0.6997264021887825,0.2818057455540356,0.01709986320109439,0.0013679890560875513,Peak,Saturday,July
2024-07-20 14:00:00,107,452,9,1,569,213,304,8,2,527,30.6,71,3,16.3,1096,True,14,320,756,17,3,2024-07-20,False,False,False,0.6897810218978102,0.291970802919708,0.01551094890510949,0.002737226277372263,Peak,Saturday,July
2024-07-20 15:00:00,95,447,9,1,552,174,345,6,0,525,30.8,71,3,15.1,1077,True,15,269,792,15,1,2024-07-20,False,False,False,0.7353760445682451,0.24976787372330547,0.013927576601671309,0.0009285051067780873,Peak,Saturday,July
2024-07-20 16:00:00,109,417,14,0,540,190,309,7,1,507,30.7,71,3,14.0,1047,True,16,299,726,21,1,2024-07-20,False,False,False,0.6934097421203438,0.28557784145176696,0.02005730659025788,0.0009551098376313276,Peak,Saturday,July
2024-07-20 17:00:00,159,612,12,4,787,235,458,8,2,703,30.2,72,3,11.5,1490,True,17,394,1070,20,6,2024-07-20,False,False,True,0.7181208053691275,0.2644295302013423,0.013422818791946308,0.004026845637583893,Peak,Saturday,July
2024-07-20 18:00:00,140,585,16,2,743,251,451,7,2,711,30.0,73,3,9.8,1454,True,18,391,1036,23,4,2024-07-20,False,False,True,0.7125171939477304,0.2689133425034388,0.01581843191196699,0.002751031636863824,Peak,Saturday,July
2024-07-20 19:00:00,133,600,9,2,744,255,395,11,4,665,29.5,77,3,7.7,1409,True,19,388,995,20,6,2024-07-20,False,False,True,0.7061745919091554,0.2753726046841732,0.014194464158977998,0.0042583392476933995,Peak,Saturday,July
2024-07-20 20:00:00,74,298,4,0,376,133,211,7,0,351,29.2,79,3,8.9,727,True,20,207,509,11,0,2024-07-20,False,False,False,0.7001375515818432,0.28473177441540576,0.015130674002751032,0.0,Shoulder,Saturday,July
2024-07-20 21:00:00,63,301,9,0,373,158,171,7,0,336,28.2,80,1,8.3,709,True,21,221,472,16,0,2024-07-20,False,False,False,0.6657263751763046,0.31170662905500707,0.022566995768688293,0.0,Shoulder,Saturday,July
2024-07-20 22:00:00,70,327,10,1,408,123,217,6,0,346,27.8,81,2,7.3,754,True,22,193,544,16,1,2024-07-20,False,False,False,0.7214854111405835,0.25596816976127323,0.021220159151193633,0.001326259946949602,Shoulder,Saturday,July
2024-07-20 23:00:00,70,297,9,0,376,120,205,5,0,330,27.8,82,3,7.7,706,True,23,190,502,14,0,2024-07-20,False,False,False,0.7110481586402266,0.26912181303116145,0.019830028328611898,0.0,Shoulder,Saturday,July
2024-07-21 00:00:00,16,39,0,0,55,21,39,4,0,64,27.5,82,3,7.2,119,True,0,37,78,4,0,2024-07-21,False,False,False,0.6554621848739496,0.31092436974789917,0.03361344537815126,0.0,Off-Peak,Sunday,July
2024-07-21 01:00:00,15,34,1,0,50,22,48,4,0,74,26.9,85,3,7.2,124,True,1,37,82,5,0,2024-07-21,False,False,False,0.6612903225806451,0.29838709677419356,0.04032258064516129,0.0,Off-Peak,Sunday,July
2024-07-21 02:00:00,13,54,0,0,67,24,38,2,0,64,26.5,87,3,6.1,131,True,2,37,92,2,0,2024-07-21,False,False,False,0.7022900763358778,0.2824427480916031,0.015267175572519083,0.0,Off-Peak,Sunday,July
2024-07-21 03:00:00,18,28,5,0,51,22,40,3,1,66,26.7,89,3,7.5,117,True,3,40,68,8,1,2024-07-21,False,False,False,0.5811965811965812,0.3418803418803419,0.06837606837606838,0.008547008547008548,Off-Peak,Sunday,July
2024-07-21 04:00:00,17,27,0,0,44,22,22,4,1,49,27.3,88,3,8.9,93,True,4,39,49,4,1,2024-07-21,False,False,False,0.5268817204301075,0.41935483870967744,0.043010752688172046,0.010752688172043012,Off-Peak,Sunday,July
2024-07-21 05:00:00,89,453,13,1,556,206,314,7,2,529,27.4,87,3,9.4,1085,True,5,295,767,20,3,2024-07-21,False,False,False,0.7069124423963133,0.271889400921659,0.018433179723502304,0.0027649769585253456,Shoulder,Sunday,July
2024-07-21 06:00:00,80,559,9,1,649,190,333,9,1,533,27.3,86,3,10.7,1182,True,6,270,892,18,2,2024-07-21,False,False,False,0.754653130287648,0.22842639593908629,0.015228426395939087,0.001692047377326565,Shoulder,Sunday,July
2024-07-21 07:00:00,201,635,9,1,846,250,490,5,3,748,27.6,84,3,10.7,1594,True,7,451,1125,14,4,2024-07-21,False,False,True,0.705771643663739,0.28293601003764113,0.00878293601003764,0.002509410288582183,Peak,Sunday,July
2024-07-21 08:00:00,203,612,16,1,832,252,492,10,3,757,28.1,82,3,12.8,1589,True,8,455,1104,26,4,2024-07-21,False,False,True,0.6947765890497168,0.28634361233480177,0.016362492133417242,0.0025173064820641915,Peak,Sunday,July
2024-07-21 09:00:00,117,429,12,1,559,201,351,7,1,560,28.6,76,51,16.4,1119,True,9,318,780,19,2,2024-07-21,False,False,False,0.6970509383378016,0.28418230563002683,0.016979445933869526,0.0017873100983020554,Shoulder,Sunday,July
2024-07-21 10:00:00,93,428,9,1,531,164,342,10,1,517,29.1,75,53,17.8,1048,True,10,257,770,19,2,2024-07-21,False,False,False,0.7347328244274809,0.2452290076335878,0.01812977099236641,0.0019083969465648854,Shoulder,Sunday,July
2024-07-21 11:00:00,179,582,12,1,774,251,395,9,1,656,29.2,78,63,16.7,1430,True,11,430,977,21,2,2024-07-21,False,False,True,0.6832167832167833,0.3006993006993007,0.014685314685314685,0.0013986013986013986,Peak,Sunday,July
2024-07-21 12:00:00,191,623,13,1,828,238,406,7,2,653,29.7,72,51,19.6,1481,True,12,429,1029,20,3,2024-07-21,False,False,True,0.6948008102633356,0.28966914247130315,0.01350438892640108,0.002025658338960162,Peak,Sunday,July
2024-07-21 13:00:00,176,641,13,1,831,212,479,11,1,703,29.1,77,2,16.6,1534,True,13,388,1120,24,2,2024-07-21,False,False,True,0.7301173402868318,0.2529335071707953,0.01564537157757497,0.001303780964797914,Peak,Sunday,July
2024-07-21 14:00:00,98,404,13,1,516,166,320,9,1,496,30.9,70,51,17.9,1012,True,14,264,724,22,2,2024-07-21,False,False,False,0.7154150197628458,0.2608695652173913,0.021739130434782608,0.001976284584980237,Peak,Sunday,July
2024-07-21 15:00:00,111,578,10,1,700,205,317,6,2,530,30.8,70,3,17.7,1230,True,15,316,895,16,3,2024-07-21,False,False,False,0.7276422764227642,0.25691056910569104,0.013008130081300813,0.0024390243902439024,Peak,Sunday,July
2024-07-21 16:00:00,89,606,8,0,703,214,304,6,3,527,29.8,74,3,16.3,1230,True,16,303,910,14,3,2024-07-21,False,False,False,0.7398373983739838,0.24634146341463414,0.011382113821138212,0.0024390243902439024,Peak,Sunday,July
2024-07-21 17:00:00,185,615,8,1,809,229,449,9,2,689,30.2,72,3,15.3,1498,True,17,414,1064,17,3,2024-07-21,False,False,True,0.7102803738317757,0.27636849132176233,0.011348464619492658,0.0020026702269692926,Peak,Sunday,July
2024-07-21 18:00:00,179,628,10,1,818,234,458,6,2,700,29.9,72,3,14.6,1518,True,18,413,1086,16,3,2024-07-21,False,False,True,0.7154150197628458,0.272068511198946,0.010540184453227932,0.001976284584980237,Peak,Sunday,July
2024-07-21 19:00:00,206,626,9,1,842,260,437,6,2,705,29.4,76,3,12.2,1547,True,19,466,1063,15,3,2024-07-21,False,False,True,0.687136393018746,0.30122818358112474,0.009696186166774402,0.0019392372333548805,Peak,Sunday,July
2024-07-21 20:00:00,97,445,10,1,553,191,286,8,0,485,29.0,77,3,10.8,1038,True,20,288,731,18,1,2024-07-21,False,False,False,0.7042389210019268,0.2774566473988439,0.017341040462427744,0.0009633911368015414,Shoulder,Sunday,July
2024-07-21 21:00:00,113,587,8,1,709,225,386,9,1,621,28.5,79,3,11.0,1330,True,21,338,973,17,2,2024-07-21,False,False,False,0.7315789473684211,0.25413533834586466,0.012781954887218045,0.0015037593984962407,Shoulder,Sunday,July
2024-07-21 22:00:00,111,433,13,1,558,201,345,7,0,553,28.3,79,3,8.7,1111,True,22,312,778,20,1,2024-07-21,False,False,False,0.7002700270027002,0.2808280828082808,0.018001800180018002,0.0009000900090009,Shoulder,Sunday,July
2024-07-21 23:00:00,90,430,11,2,533,218,335,9,0,562,27.7,82,3,8.8,1095,True,23,308,765,20,2,2024-07-21,False,False,False,0.6986301369863014,0.28127853881278536,0.0182648401826484,0.0018264840182648401,Shoulder,Sunday,July
2024-07-22 00:00:00,51,200,0,0,251,64,158,0,0,222,27.2,83,3,9.0,473,False,0,115,358,0,0,2024-07-22,False,True,False,0.7568710359408034,0.24312896405919662,0.0,0.0,Off-Peak,Monday,July
2024-07-22 01:00:00,23,51,3,1,78,24,50,3,1,78,27.0,84,3,9.0,156,False,1,47,101,6,2,2024-07-22,False,True,False,0.6474358974358975,0.30128205128205127,0.038461538461538464,0.01282051282051282,Off-Peak,Monday,July
2024-07-22 02:00:00,26,53,5,0,84,25,52,5,0,82,26.7,86,3,8.0,166,False,2,51,105,10,0,2024-07-22,False,True,False,0.6325301204819277,0.3072289156626506,0.060240963855421686,0.0,Off-Peak,Monday,July
2024-07-22 03:00:00,23,51,3,1,78,24,50,3,1,78,26.4,87,3,8.1,156,False,3,47,101,6,2,2024-07-22,False,True,False,0.6474358974358975,0.30128205128205127,0.038461538461538464,0.01282051282051282,Off-Peak,Monday,July
2024-07-22 04:00:00,26,53,5,0,84,25,52,5,0,82,26.2,88,3,8.4,166,False,4,51,105,10,0,2024-07-22,False,True,False,0.6325301204819277,0.3072289156626506,0.060240963855421686,0.0,Off-Peak,Monday,July
2024-07-22 05:00:00,101,403,7,2,513,131,320,7,3,461,26.2,89,3,9.0,974,False,5,232,723,14,5,2024-07-22,False,True,False,0.742299794661191,0.23819301848049282,0.014373716632443531,0.00513347022587269,Shoulder,Monday,July
2024-07-22 06:00:00,102,401,9,0,512,129,318,9,1,457,26.3,89,3,8.3,969,False,6,231,719,18,1,2024-07-22,False,True,False,0.7420020639834881,0.23839009287925697,0.018575851393188854,0.0010319917440660474,Shoulder,Monday,July
2024-07-22 07:00:00,154,604,14,2,774,197,479,13,3,692,26.4,88,3,7.6,1466,False,7,351,1083,27,5,2024-07-22,False,True,True,0.7387448840381992,0.23942701227830832,0.018417462482946793,0.0034106412005457027,Peak,Monday,July
2024-07-22 08:00:00,154,602,13,0,769,193,475,12,1,681,26.9,87,3,9.1,1450,False,8,347,1077,25,1,2024-07-22,False,True,True,0.7427586206896551,0.2393103448275862,0.017241379310344827,0.000689655172413793,Peak,Monday,July
2024-07-22 09:00:00,101,403,7,2,513,131,318,7,2,458,28.1,85,3,9.2,971,False,9,232,721,14,4,2024-07-22,False,True,False,0.7425334706488157,0.23892893923789907,0.014418125643666324,0.004119464469618949,Shoulder,Monday,July
2024-07-22 10:00:00,102,401,9,0,512,129,316,9,1,455,29.5,77,51,11.7,967,False,10,231,717,18,1,2024-07-22,False,True,False,0.7414684591520165,0.23888314374353672,0.01861427094105481,0.001034126163391934,Shoulder,Monday,July
2024-07-22 11:00:00,156,604,15,2,777,197,479,14,3,693,30.6,72,51,13.5,1470,False,11,353,1083,29,5,2024-07-22,False,True,True,0.736734693877551,0.24013605442176872,0.019727891156462583,0.003401360544217687,Peak,Monday,July
2024-07-22 12:00:00,156,602,13,0,771,193,475,12,1,681,30.9,70,3,15.5,1452,False,12,349,1077,25,1,2024-07-22,False,True,True,0.7417355371900827,0.2403581267217631,0.01721763085399449,0.0006887052341597796,Peak,Monday,July
2024-07-22 13:00:00,154,603,14,1,772,196,477,13,2,688,31.1,70,51,17.1,1460,False,13,350,1080,27,3,2024-07-22,False,True,True,0.7397260273972602,0.23972602739726026,0.018493150684931507,0.002054794520547945,Peak,Monday,July
2024-07-22 14:00:00,101,402,7,0,510,130,318,7,0,455,31.4,69,51,17.8,965,False,14,231,720,14,0,2024-07-22,False,True,False,0.7461139896373057,0.23937823834196892,0.014507772020725389,0.0,Peak,Monday,July
2024-07-22 15:00:00,102,400,9,1,512,128,316,9,3,456,31.5,69,51,16.6,968,False,15,230,716,18,4,2024-07-22,False,True,False,0.7396694214876033,0.23760330578512398,0.01859504132231405,0.004132231404958678,Peak,Monday,July
2024-07-22 16:00:00,102,402,8,0,512,130,317,8,1,456,31.0,72,51,15.0,968,False,16,232,719,16,1,2024-07-22,False,True,False,0.7427685950413223,0.2396694214876033,0.01652892561983471,0.0010330578512396695,Peak,Monday,July
2024-07-22 17:00:00,154,604,14,1,773,196,479,13,3,691,30.8,72,2,14.6,1464,False,17,350,1083,27,4,2024-07-22,False,True,True,0.7397540983606558,0.2390710382513661,0.018442622950819672,0.00273224043715847,Peak,Monday,July
2024-07-22 18:00:00,153,602,12,0,767,193,475,11,1,680,30.2,74,1,13.3,1447,False,18,346,1077,23,1,2024-07-22,False,True,True,0.7442985487214927,0.23911541119557705,0.015894955079474776,0.000691085003455425,Peak,Monday,July
2024-07-22 19:00:00,154,603,13,1,771,195,477,12,2,686,29.7,76,0,9.8,1457,False,19,349,1080,25,3,2024-07-22,False,True,True,0.7412491420727523,0.23953328757721346,0.017158544955387784,0.002059025394646534,Peak,Monday,July
2024-07-22 20:00:00,101,402,7,0,510,130,318,7,0,455,29.0,80,0,9.8,965,False,20,231,720,14,0,2024-07-22,False,True,False,0.7461139896373057,0.23937823834196892,0.014507772020725389,0.0,Shoulder,Monday,July
2024-07-22 21:00:00,102,400,9,1,512,128,316,9,2,455,28.5,83,0,10.9,967,False,21,230,716,18,3,2024-07-22,False,True,False,0.7404343329886246,0.2378490175801448,0.01861427094105481,0.0031023784901758012,Shoulder,Monday,July
2024-07-22 22:00:00,102,401,8,0,511,129,317,8,1,455,28.0,84,0,8.8,966,False,22,231,718,16,1,2024-07-22,False,True,False,0.7432712215320911,0.2391304347826087,0.016563146997929608,0.0010351966873706005,Shoulder,Monday,July
2024-07-22 23:00:00,51,199,4,1,255,64,158,4,0,226,27.8,86,0,7.8,481,False,23,115,357,8,1,2024-07-22,False,True,False,0.7422037422037422,0.2390852390852391,0.016632016632016633,0.002079002079002079,Shoulder,Monday,July
2024-07-23 00:00:00,49,199,0,0,248,49,199,0,0,248,27.4,88,0,6.9,496,False,0,98,398,0,0,2024-07-23,False,False,False,0.8024193548387096,0.1975806451612903,0.0,0.0,Off-Peak,Tuesday,July
2024-07-23 01:00:00,23,51,3,0,77,23,51,3,1,78,27.1,89,0,8.3,155,False,1,46,102,6,1,2024-07-23,False,False,False,0.6580645161290323,0.2967741935483871,0.03870967741935484,0.0064516129032258064,Off-Peak,Tuesday,July
2024-07-23 02:00:00,25,53,5,0,83,25,53,5,0,83,26.8,89,3,7.3,166,False,2,50,106,10,0,2024-07-23,False,False,False,0.6385542168674698,0.30120481927710846,0.060240963855421686,0.0,Off-Peak,Tuesday,July
2024-07-23 03:00:00,23,51,3,0,77,23,51,3,1,78,26.4,91,3,7.0,155,False,3,46,102,6,1,2024-07-23,False,False,False,0.6580645161290323,0.2967741935483871,0.03870967741935484,0.0064516129032258064,Off-Peak,Tuesday,July
2024-07-23 04:00:00,25,53,5,0,83,25,53,5,0,83,26.1,92,3,6.0,166,False,4,50,106,10,0,2024-07-23,False,False,False,0.6385542168674698,0.30120481927710846,0.060240963855421686,0.0,Off-Peak,Tuesday,July
2024-07-23 05:00:00,101,403,6,1,511,101,403,6,2,512,25.9,92,3,5.7,1023,False,5,202,806,12,3,2024-07-23,False,False,False,0.7878787878787878,0.19745845552297164,0.011730205278592375,0.002932551319648094,Shoulder,Tuesday,July
2024-07-23 06:00:00,99,400,9,0,508,99,400,9,0,508,25.7,93,3,4.8,1016,False,6,198,800,18,0,2024-07-23,False,False,False,0.7874015748031497,0.19488188976377951,0.017716535433070866,0.0,Shoulder,Tuesday,July
2024-07-23 07:00:00,151,604,14,1,770,151,604,14,2,771,25.2,95,3,1.8,1541,False,7,302,1208,28,3,2024-07-23,False,False,True,0.7839065541855937,0.19597663854639844,0.018170019467878003,0.001946787800129786,Peak,Tuesday,July
2024-07-23 08:00:00,149,601,14,0,764,149,601,14,0,764,26.3,92,51,0.7,1528,False,8,298,1202,28,0,2024-07-23,False,False,True,0.7866492146596858,0.1950261780104712,0.01832460732984293,0.0,Peak,Tuesday,July
2024-07-23 09:00:00,98,400,6,1,505,98,400,6,1,505,28.3,86,51,6.4,1010,False,9,196,800,12,2,2024-07-23,False,False,False,0.7920792079207921,0.19405940594059407,0.011881188118811881,0.0019801980198019802,Shoulder,Tuesday,July
2024-07-23 10:00:00,100,400,9,0,509,100,400,9,0,509,29.2,82,51,8.8,1018,False,10,200,800,18,0,2024-07-23,False,False,False,0.7858546168958742,0.19646365422396855,0.01768172888015717,0.0,Shoulder,Tuesday,July
2024-07-23 11:00:00,151,604,16,1,772,151,604,16,2,773,30.2,76,51,11.5,1545,False,11,302,1208,32,3,2024-07-23,False,False,True,0.7818770226537217,0.19546925566343043,0.020711974110032363,0.001941747572815534,Peak,Tuesday,July
2024-07-23 12:00:00,149,601,14,0,764,149,601,14,0,764,30.9,73,1,12.1,1528,False,12,298,1202,28,0,2024-07-23,False,False,True,0.7866492146596858,0.1950261780104712,0.01832460732984293,0.0,Peak,Tuesday,July
2024-07-23 13:00:00,150,602,14,1,767,150,602,14,1,767,31.4,68,1,11.4,1534,False,13,300,1204,28,2,2024-07-23,False,False,True,0.7848761408083442,0.19556714471968709,0.018252933507170794,0.001303780964797914,Peak,Tuesday,July
2024-07-23 14:00:00,98,400,6,0,504,98,400,6,0,504,31.6,67,2,11.3,1008,False,14,196,800,12,0,2024-07-23,False,False,False,0.7936507936507936,0.19444444444444445,0.011904761904761904,0.0,Peak,Tuesday,July
2024-07-23 15:00:00,101,399,9,2,511,101,399,9,2,511,31.4,69,3,11.9,1022,False,15,202,798,18,4,2024-07-23,False,False,False,0.7808219178082192,0.19765166340508805,0.01761252446183953,0.003913894324853229,Peak,Tuesday,July
2024-07-23 16:00:00,99,402,8,0,509,99,402,8,0,509,31.1,71,3,11.7,1018,False,16,198,804,16,0,2024-07-23,False,False,False,0.7897838899803536,0.1944990176817289,0.015717092337917484,0.0,Peak,Tuesday,July
2024-07-23 17:00:00,151,604,13,1,769,151,604,13,2,770,30.7,72,1,9.0,1539,False,17,302,1208,26,3,2024-07-23,False,False,True,0.7849252761533463,0.19623131903833657,0.016894087069525665,0.001949317738791423,Peak,Tuesday,July
2024-07-23 18:00:00,149,601,14,0,764,149,601,14,0,764,30.5,71,2,9.0,1528,False,18,298,1202,28,0,2024-07-23,False,False,True,0.7866492146596858,0.1950261780104712,0.01832460732984293,0.0,Peak,Tuesday,July
2024-07-23 19:00:00,150,603,12,1,766,150,603,12,1,766,29.6,75,2,9.0,1532,False,19,300,1206,24,2,2024-07-23,False,False,True,0.7872062663185379,0.195822454308094,0.015665796344647518,0.0013054830287206266,Peak,Tuesday,July
2024-07-23 20:00:00,98,400,6,0,504,98,400,6,0,504,29.0,80,0,7.9,1008,False,20,196,800,12,0,2024-07-23,False,False,False,0.7936507936507936,0.19444444444444445,0.011904761904761904,0.0,Shoulder,Tuesday,July
2024-07-23 21:00:00,100,399,9,1,509,100,399,9,1,509,28.5,78,0,8.5,1018,False,21,200,798,18,2,2024-07-23,False,False,False,0.7838899803536346,0.19646365422396855,0.01768172888015717,0.0019646365422396855,Shoulder,Tuesday,July
2024-07-23 22:00:00,99,400,8,0,507,99,400,8,0,507,28.2,80,0,10.5,1014,False,22,198,800,16,0,2024-07-23,False,False,False,0.7889546351084813,0.1952662721893491,0.015779092702169626,0.0,Shoulder,Tuesday,July
2024-07-23 23:00:00,49,199,4,1,253,49,199,4,1,253,27.9,82,3,11.0,506,False,23,98,398,8,2,2024-07-23,False,False,False,0.7865612648221344,0.19367588932806323,0.015810276679841896,0.003952569169960474,Shoulder,Tuesday,July
2024-07-24 00:00:00,51,194,0,0,245,40,128,0,0,168,27.4,87,3,11.2,413,False,0,91,322,0,0,2024-07-24,False,False,False,0.7796610169491526,0.22033898305084745,0.0,0.0,Off-Peak,Wednesday,July
2024-07-24 01:00:00,23,51,3,0,77,23,50,2,1,76,27.0,90,3,9.4,153,False,1,46,101,5,1,2024-07-24,False,False,False,0.6601307189542484,0.3006535947712418,0.032679738562091505,0.006535947712418301,Off-Peak,Wednesday,July
2024-07-24 02:00:00,26,53,5,0,84,25,52,4,0,81,26.6,92,3,7.6,165,False,2,51,105,9,0,2024-07-24,False,False,False,0.6363636363636364,0.3090909090909091,0.05454545454545454,0.0,Off-Peak,Wednesday,July
2024-07-24 03:00:00,23,51,3,0,77,23,50,2,0,75,26.5,93,3,8.3,152,False,3,46,101,5,0,2024-07-24,False,False,False,0.6644736842105263,0.3026315789473684,0.03289473684210526,0.0,Off-Peak,Wednesday,July
2024-07-24 04:00:00,26,53,5,0,84,25,52,4,0,81,26.2,90,53,3.6,165,False,4,51,105,9,0,2024-07-24,False,False,False,0.6363636363636364,0.3090909090909091,0.05454545454545454,0.0,Off-Peak,Wednesday,July
2024-07-24 05:00:00,101,391,8,2,502,83,257,6,0,346,26.2,93,51,7.4,848,False,5,184,648,14,2,2024-07-24,False,False,False,0.7641509433962265,0.2169811320754717,0.01650943396226415,0.0023584905660377358,Shoulder,Wednesday,July
2024-07-24 06:00:00,103,389,10,0,502,82,255,8,3,348,26.3,93,3,9.4,850,False,6,185,644,18,3,2024-07-24,False,False,False,0.7576470588235295,0.21764705882352942,0.021176470588235293,0.0035294117647058825,Shoulder,Wednesday,July
2024-07-24 07:00:00,155,587,14,3,759,124,386,12,1,523,26.1,94,3,6.6,1282,False,7,279,973,26,4,2024-07-24,False,False,False,0.7589703588143526,0.21762870514820593,0.0202808112324493,0.0031201248049922,Peak,Wednesday,July
2024-07-24 08:00:00,154,585,14,1,754,122,384,10,2,518,27.0,91,3,7.6,1272,False,8,276,969,24,3,2024-07-24,False,False,False,0.7617924528301887,0.2169811320754717,0.018867924528301886,0.0023584905660377358,Peak,Wednesday,July
2024-07-24 09:00:00,101,389,8,0,498,81,257,6,0,344,28.6,84,51,10.8,842,False,9,182,646,14,0,2024-07-24,False,False,False,0.7672209026128266,0.2161520190023753,0.0166270783847981,0.0,Shoulder,Wednesday,July
2024-07-24 10:00:00,103,387,10,1,501,83,255,8,3,349,29.3,79,51,12.7,850,False,10,186,642,18,4,2024-07-24,False,False,False,0.7552941176470588,0.2188235294117647,0.021176470588235293,0.004705882352941176,Shoulder,Wednesday,July
2024-07-24 11:00:00,157,587,17,1,762,124,387,13,1,525,30.2,73,51,12.8,1287,False,11,281,974,30,2,2024-07-24,False,False,False,0.7567987567987567,0.21833721833721834,0.023310023310023312,0.001554001554001554,Peak,Wednesday,July
2024-07-24 12:00:00,154,585,14,1,754,122,384,11,3,520,30.9,68,3,12.1,1274,False,12,276,969,25,4,2024-07-24,False,False,False,0.7605965463108321,0.21664050235478807,0.019623233908948195,0.0031397174254317113,Peak,Wednesday,July
2024-07-24 13:00:00,156,586,15,1,758,123,387,12,0,522,31.6,65,3,11.4,1280,False,13,279,973,27,1,2024-07-24,False,False,False,0.76015625,0.21796875,0.02109375,0.00078125,Peak,Wednesday,July
2024-07-24 14:00:00,101,389,7,1,498,80,257,5,2,344,31.7,63,3,11.5,842,False,14,181,646,12,3,2024-07-24,False,False,False,0.7672209026128266,0.21496437054631828,0.014251781472684086,0.0035629453681710215,Peak,Wednesday,July
2024-07-24 15:00:00,103,387,8,2,500,81,255,6,0,342,31.8,61,3,10.6,842,False,15,184,642,14,2,2024-07-24,False,False,False,0.7624703087885986,0.21852731591448932,0.0166270783847981,0.0023752969121140144,Peak,Wednesday,July
2024-07-24 16:00:00,102,388,10,0,500,83,256,8,3,350,32.1,60,3,8.8,850,False,16,185,644,18,3,2024-07-24,False,False,False,0.7576470588235295,0.21764705882352942,0.021176470588235293,0.0035294117647058825,Peak,Wednesday,July
2024-07-24 17:00:00,154,587,15,1,757,124,386,12,1,523,31.6,64,1,9.6,1280,False,17,278,973,27,2,2024-07-24,False,False,False,0.76015625,0.2171875,0.02109375,0.0015625,Peak,Wednesday,July
2024-07-24 18:00:00,152,585,13,1,751,122,384,10,3,519,31.1,66,0,9.0,1270,False,18,274,969,23,4,2024-07-24,False,False,False,0.7629921259842519,0.215748031496063,0.01811023622047244,0.0031496062992125984,Peak,Wednesday,July
2024-07-24 19:00:00,154,586,14,2,756,123,384,11,0,518,30.0,73,0,8.2,1274,False,19,277,970,25,2,2024-07-24,False,False,False,0.7613814756671899,0.217425431711146,0.019623233908948195,0.0015698587127158557,Peak,Wednesday,July
2024-07-24 20:00:00,101,389,7,0,497,80,257,5,2,344,29.2,77,0,5.6,841,False,20,181,646,12,2,2024-07-24,False,False,False,0.7681331747919143,0.21521997621878716,0.014268727705112961,0.0023781212841854932,Shoulder,Wednesday,July
2024-07-24 21:00:00,103,387,9,1,500,81,255,7,0,343,27.7,81,0,4.3,843,False,21,184,642,16,1,2024-07-24,False,False,False,0.7615658362989324,0.21826809015421114,0.018979833926453145,0.0011862396204033216,Shoulder,Wednesday,July
2024-07-24 22:00:00,102,388,8,0,498,83,256,6,2,347,27.5,81,0,5.9,845,False,22,185,644,14,2,2024-07-24,False,False,False,0.762130177514793,0.21893491124260356,0.016568047337278107,0.002366863905325444,Shoulder,Wednesday,July
2024-07-24 23:00:00,51,194,4,1,250,40,128,3,0,171,27.0,81,0,5.9,421,False,23,91,322,7,1,2024-07-24,False,False,False,0.7648456057007126,0.2161520190023753,0.0166270783847981,0.0023752969121140144,Shoulder,Wednesday,July
2024-07-25 00:00:00,46,206,0,0,252,40,117,0,0,157,26.7,83,1,6.4,409,False,0,86,323,0,0,2024-07-25,False,False,False,0.7897310513447433,0.21026894865525672,0.0,0.0,Off-Peak,Thursday,July
2024-07-25 01:00:00,23,51,3,0,77,23,50,2,1,76,26.6,85,2,8.4,153,False,1,46,101,5,1,2024-07-25,False,False,False,0.6601307189542484,0.3006535947712418,0.032679738562091505,0.006535947712418301,Off-Peak,Thursday,July
2024-07-25 02:00:00,25,53,5,0,83,25,52,4,0,81,26.5,87,0,7.6,164,False,2,50,105,9,0,2024-07-25,False,False,False,0.6402439024390244,0.3048780487804878,0.054878048780487805,0.0,Off-Peak,Thursday,July
2024-07-25 03:00:00,23,51,3,1,78,23,50,2,1,76,26.3,89,3,7.1,154,False,3,46,101,5,2,2024-07-25,False,False,False,0.6558441558441559,0.2987012987012987,0.032467532467532464,0.012987012987012988,Off-Peak,Thursday,July
2024-07-25 04:00:00,25,53,5,0,83,25,52,4,0,81,26.0,91,3,6.5,164,False,4,50,105,9,0,2024-07-25,False,False,False,0.6402439024390244,0.3048780487804878,0.054878048780487805,0.0,Off-Peak,Thursday,July
2024-07-25 05:00:00,96,413,10,0,519,81,237,5,2,325,25.8,91,3,6.0,844,False,5,177,650,15,2,2024-07-25,False,False,False,0.7701421800947867,0.20971563981042654,0.017772511848341232,0.002369668246445498,Shoulder,Thursday,July
2024-07-25 06:00:00,94,411,8,0,513,83,234,8,0,325,26.2,91,3,9.3,838,False,6,177,645,16,0,2024-07-25,False,False,False,0.7696897374701671,0.21121718377088305,0.01909307875894988,0.0,Shoulder,Thursday,July
2024-07-25 07:00:00,144,622,14,2,782,124,356,12,1,493,26.2,91,3,8.4,1275,False,7,268,978,26,3,2024-07-25,False,False,False,0.7670588235294118,0.21019607843137256,0.0203921568627451,0.002352941176470588,Peak,Thursday,July
2024-07-25 08:00:00,142,620,13,0,775,122,353,11,2,488,26.5,87,51,5.9,1263,False,8,264,973,24,2,2024-07-25,False,False,False,0.770387965162312,0.20902612826603326,0.019002375296912115,0.001583531274742676,Peak,Thursday,July
2024-07-25 09:00:00,95,413,10,1,519,80,237,5,0,322,27.6,84,51,10.1,841,False,9,175,650,15,1,2024-07-25,False,False,False,0.7728894173602854,0.2080856123662307,0.0178359096313912,0.0011890606420927466,Shoulder,Thursday,July
2024-07-25 10:00:00,94,411,8,0,513,82,234,8,1,325,28.6,80,51,9.9,838,False,10,176,645,16,1,2024-07-25,False,False,False,0.7696897374701671,0.2100238663484487,0.01909307875894988,0.0011933174224343676,Shoulder,Thursday,July
2024-07-25 11:00:00,144,622,15,1,782,124,356,14,2,496,30.0,72,51,13.0,1278,False,11,268,978,29,3,2024-07-25,False,False,False,0.7652582159624414,0.20970266040688576,0.02269170579029734,0.002347417840375587,Peak,Thursday,July
2024-07-25 12:00:00,142,620,13,0,775,122,353,12,1,488,31.0,63,3,16.6,1263,False,12,264,973,25,1,2024-07-25,False,False,False,0.770387965162312,0.20902612826603326,0.01979414093428345,0.000791765637371338,Peak,Thursday,July
2024-07-25 13:00:00,143,621,14,1,779,123,353,12,2,490,31.3,62,3,16.4,1269,False,13,266,974,26,3,2024-07-25,False,False,False,0.7675334909377463,0.20961386918833727,0.02048857368006304,0.002364066193853428,Peak,Thursday,July
2024-07-25 14:00:00,92,413,7,0,512,79,236,5,0,320,31.5,62,3,16.5,832,False,14,171,649,12,0,2024-07-25,False,False,False,0.7800480769230769,0.20552884615384615,0.014423076923076924,0.0,Peak,Thursday,July
2024-07-25 15:00:00,94,411,10,2,517,81,234,5,2,322,31.5,63,2,15.8,839,False,15,175,645,15,4,2024-07-25,False,False,False,0.768772348033373,0.20858164481525626,0.017878426698450536,0.004767580452920143,Peak,Thursday,July
2024-07-25 16:00:00,95,412,8,0,515,82,236,8,0,326,31.4,63,2,16.3,841,False,16,177,648,16,0,2024-07-25,False,False,False,0.7705112960760999,0.21046373365041618,0.019024970273483946,0.0,Peak,Thursday,July
2024-07-25 17:00:00,144,622,14,2,782,124,353,12,3,492,30.9,64,2,15.4,1274,False,17,268,975,26,5,2024-07-25,False,False,False,0.7653061224489796,0.21036106750392464,0.02040816326530612,0.003924646781789639,Peak,Thursday,July
2024-07-25 18:00:00,142,620,12,0,774,122,356,11,1,490,30.3,67,1,14.8,1264,False,18,264,976,23,1,2024-07-25,False,False,False,0.7721518987341772,0.2088607594936709,0.01819620253164557,0.0007911392405063291,Peak,Thursday,July
2024-07-25 19:00:00,143,621,13,1,778,123,353,12,2,490,29.7,71,0,13.0,1268,False,19,266,974,25,3,2024-07-25,False,False,False,0.7681388012618297,0.20977917981072555,0.01971608832807571,0.002365930599369085,Peak,Thursday,July
2024-07-25 20:00:00,94,413,10,0,517,79,236,7,2,324,29.1,73,0,9.8,841,False,20,173,649,17,2,2024-07-25,False,False,False,0.7717003567181926,0.2057074910820452,0.020214030915576695,0.0023781212841854932,Shoulder,Thursday,July
2024-07-25 21:00:00,93,411,8,2,514,80,234,5,0,319,28.2,75,0,9.5,833,False,21,173,645,13,2,2024-07-25,False,False,False,0.7743097238895558,0.20768307322929172,0.015606242496998799,0.0024009603841536613,Shoulder,Thursday,July
2024-07-25 22:00:00,94,412,9,0,515,82,236,7,1,326,27.8,76,1,9.1,841,False,22,176,648,16,1,2024-07-25,False,False,False,0.7705112960760999,0.20927467300832342,0.019024970273483946,0.0011890606420927466,Shoulder,Thursday,July
2024-07-25 23:00:00,46,206,4,1,257,40,117,2,0,159,27.4,78,3,8.6,416,False,23,86,323,6,1,2024-07-25,False,False,False,0.7764423076923077,0.20673076923076922,0.014423076923076924,0.002403846153846154,Shoulder,Thursday,July
2024-07-26 00:00:00,42,217,0,0,259,81,188,0,0,269,27.1,81,2,9.4,528,False,0,123,405,0,0,2024-07-26,False,False,False,0.7670454545454546,0.23295454545454544,0.0,0.0,Off-Peak,Friday,July
2024-07-26 01:00:00,23,51,1,0,75,24,50,3,1,78,26.8,83,3,9.0,153,False,1,47,101,4,1,2024-07-26,False,False,False,0.6601307189542484,0.30718954248366015,0.026143790849673203,0.006535947712418301,Off-Peak,Friday,July
2024-07-26 02:00:00,25,53,3,0,81,26,53,5,0,84,26.7,84,3,9.7,165,False,2,51,106,8,0,2024-07-26,False,False,False,0.6424242424242425,0.3090909090909091,0.048484848484848485,0.0,Off-Peak,Friday,July
2024-07-26 03:00:00,23,51,1,0,75,24,50,3,1,78,26.5,85,3,9.6,153,False,3,47,101,4,1,2024-07-26,False,False,False,0.6601307189542484,0.30718954248366015,0.026143790849673203,0.006535947712418301,Off-Peak,Friday,July
2024-07-26 04:00:00,25,53,3,0,81,26,53,5,0,84,26.5,86,2,9.1,165,False,4,51,106,8,0,2024-07-26,False,False,False,0.6424242424242425,0.3090909090909091,0.048484848484848485,0.0,Off-Peak,Friday,July
2024-07-26 05:00:00,87,438,4,1,530,164,381,6,1,552,26.6,87,2,9.2,1082,False,5,251,819,10,2,2024-07-26,False,False,False,0.7569316081330869,0.23197781885397412,0.009242144177449169,0.0018484288354898336,Shoulder,Friday,July
2024-07-26 06:00:00,86,436,6,0,528,163,379,9,1,552,27.0,84,51,9.9,1080,False,6,249,815,15,1,2024-07-26,False,False,False,0.7546296296296297,0.23055555555555557,0.013888888888888888,0.000925925925925926,Shoulder,Friday,July
2024-07-26 07:00:00,131,656,9,2,798,248,572,14,3,837,27.0,84,51,10.2,1635,False,7,379,1228,23,5,2024-07-26,False,False,True,0.7510703363914373,0.23180428134556574,0.014067278287461774,0.0030581039755351682,Peak,Friday,July
2024-07-26 08:00:00,129,654,7,0,790,246,569,14,1,830,27.6,83,51,10.9,1620,False,8,375,1223,21,1,2024-07-26,False,False,True,0.7549382716049383,0.23148148148148148,0.012962962962962963,0.0006172839506172839,Peak,Friday,July
2024-07-26 09:00:00,85,437,4,1,527,164,381,6,3,554,28.6,76,53,14.5,1081,False,9,249,818,10,4,2024-07-26,False,False,False,0.7567067530064755,0.2303422756706753,0.009250693802035153,0.0037002775208140612,Shoulder,Friday,July
2024-07-26 10:00:00,87,435,6,0,528,162,379,9,1,551,29.2,75,53,18.1,1079,False,10,249,814,15,1,2024-07-26,False,False,False,0.7544022242817423,0.23076923076923078,0.013901760889712697,0.0009267840593141798,Shoulder,Friday,July
2024-07-26 11:00:00,131,656,9,2,798,248,572,16,3,839,29.8,73,51,16.0,1637,False,11,379,1228,25,5,2024-07-26,False,False,True,0.7501527183872938,0.23152107513744655,0.015271838729383017,0.0030543677458766036,Peak,Friday,July
2024-07-26 12:00:00,129,654,8,0,791,246,569,14,1,830,30.4,69,3,18.0,1621,False,12,375,1223,22,1,2024-07-26,False,False,True,0.7544725478099938,0.2313386798272671,0.013571869216533004,0.0006169031462060457,Peak,Friday,July
2024-07-26 13:00:00,130,655,9,1,795,247,570,14,2,833,30.7,68,51,18.2,1628,False,13,377,1225,23,3,2024-07-26,False,False,True,0.7524570024570024,0.23157248157248156,0.014127764127764128,0.0018427518427518428,Peak,Friday,July
2024-07-26 14:00:00,84,437,3,0,524,163,380,6,0,549,31.1,66,3,18.0,1073,False,14,247,817,9,0,2024-07-26,False,False,False,0.7614165890027959,0.23019571295433364,0.008387698042870456,0.0,Peak,Friday,July
2024-07-26 15:00:00,85,435,4,1,525,161,378,9,3,551,31.3,65,3,17.4,1076,False,15,246,813,13,4,2024-07-26,False,False,False,0.7555762081784386,0.22862453531598512,0.012081784386617101,0.0037174721189591076,Peak,Friday,July
2024-07-26 16:00:00,87,436,6,0,529,163,380,8,1,552,31.5,63,3,15.8,1081,False,16,250,816,14,1,2024-07-26,False,False,False,0.7548566142460684,0.23126734505087881,0.012950971322849213,0.0009250693802035153,Peak,Friday,July
2024-07-26 17:00:00,131,656,9,1,797,248,571,13,3,835,31.3,63,3,14.3,1632,False,17,379,1227,22,4,2024-07-26,False,False,True,0.7518382352941176,0.23223039215686275,0.013480392156862746,0.0024509803921568627,Peak,Friday,July
2024-07-26 18:00:00,129,654,7,0,790,246,569,14,1,830,30.8,63,3,13.3,1620,False,18,375,1223,21,1,2024-07-26,False,False,True,0.7549382716049383,0.23148148148148148,0.012962962962962963,0.0006172839506172839,Peak,Friday,July
2024-07-26 19:00:00,130,655,8,1,794,247,570,12,2,831,29.8,67,3,11.5,1625,False,19,377,1225,20,3,2024-07-26,False,False,True,0.7538461538461538,0.232,0.012307692307692308,0.0018461538461538461,Peak,Friday,July
2024-07-26 20:00:00,84,437,3,0,524,164,380,6,0,550,29.5,69,3,11.3,1074,False,20,248,817,9,0,2024-07-26,False,False,False,0.7607076350093109,0.2309124767225326,0.008379888268156424,0.0,Shoulder,Friday,July
2024-07-26 21:00:00,85,435,4,1,525,162,378,9,2,551,28.3,73,3,11.3,1076,False,21,247,813,13,3,2024-07-26,False,False,False,0.7555762081784386,0.2295539033457249,0.012081784386617101,0.0027881040892193307,Shoulder,Friday,July
2024-07-26 22:00:00,87,436,6,0,529,163,379,8,1,551,28.1,74,2,10.6,1080,False,22,250,815,14,1,2024-07-26,False,False,False,0.7546296296296297,0.23148148148148148,0.012962962962962963,0.000925925925925926,Shoulder,Friday,July
2024-07-26 23:00:00,42,217,2,1,262,81,188,4,0,273,27.6,76,1,10.4,535,False,23,123,405,6,1,2024-07-26,False,False,False,0.7570093457943925,0.22990654205607478,0.011214953271028037,0.001869158878504673,Shoulder,Friday,July
2024-07-27 00:00:00,47,213,0,0,260,85,202,0,0,287,27.2,79,1,10.0,547,True,0,132,415,0,0,2024-07-27,False,False,False,0.7586837294332724,0.2413162705667276,0.0,0.0,Off-Peak,Saturday,July
2024-07-27 01:00:00,23,51,3,0,77,24,51,2,0,77,27.1,81,1,9.5,154,True,1,47,102,5,0,2024-07-27,False,False,False,0.6623376623376623,0.3051948051948052,0.032467532467532464,0.0,Off-Peak,Saturday,July
2024-07-27 02:00:00,25,53,5,0,83,26,53,4,0,83,26.8,82,0,8.6,166,True,2,51,106,9,0,2024-07-27,False,False,False,0.6385542168674698,0.3072289156626506,0.05421686746987952,0.0,Off-Peak,Saturday,July
2024-07-27 03:00:00,23,51,3,0,77,24,51,2,0,77,26.6,83,2,10.3,154,True,3,47,102,5,0,2024-07-27,False,False,False,0.6623376623376623,0.3051948051948052,0.032467532467532464,0.0,Off-Peak,Saturday,July
2024-07-27 04:00:00,25,53,5,0,83,26,53,4,0,83,26.7,84,1,11.0,166,True,4,51,106,9,0,2024-07-27,False,False,False,0.6385542168674698,0.3072289156626506,0.05421686746987952,0.0,Off-Peak,Saturday,July
2024-07-27 05:00:00,99,430,9,1,539,173,405,6,0,584,26.7,85,3,10.7,1123,True,5,272,835,15,1,2024-07-27,False,False,False,0.7435440783615316,0.24220837043633126,0.013357079252003561,0.0008904719501335708,Shoulder,Saturday,July
2024-07-27 06:00:00,97,428,8,0,533,172,403,8,3,586,26.8,84,3,10.6,1119,True,6,269,831,16,3,2024-07-27,False,False,False,0.7426273458445041,0.24039320822162646,0.014298480786416443,0.002680965147453083,Shoulder,Saturday,July
2024-07-27 07:00:00,148,645,14,1,808,261,607,12,1,881,26.7,85,3,11.3,1689,True,7,409,1252,26,2,2024-07-27,False,False,True,0.7412670219064535,0.24215512137359385,0.015393724097098875,0.0011841326228537595,Peak,Saturday,July
2024-07-27 08:00:00,146,642,13,1,802,259,605,11,2,877,27.1,84,3,12.0,1679,True,8,405,1247,24,3,2024-07-27,False,False,True,0.7427039904705182,0.24121500893388922,0.01429422275163788,0.001786777843954735,Peak,Saturday,July
2024-07-27 09:00:00,99,429,7,0,535,173,405,6,0,584,28.4,78,3,15.0,1119,True,9,272,834,13,0,2024-07-27,False,False,False,0.7453083109919572,0.24307417336907952,0.01161751563896336,0.0,Shoulder,Saturday,July
2024-07-27 10:00:00,97,428,9,1,535,171,403,8,3,585,29.8,72,51,20.1,1120,True,10,268,831,17,4,2024-07-27,False,False,False,0.7419642857142857,0.2392857142857143,0.015178571428571428,0.0035714285714285713,Shoulder,Saturday,July
2024-07-27 11:00:00,149,645,15,3,812,261,607,15,1,884,30.5,68,51,20.1,1696,True,11,410,1252,30,4,2024-07-27,False,False,True,0.7382075471698113,0.2417452830188679,0.01768867924528302,0.0023584905660377358,Peak,Saturday,July
2024-07-27 12:00:00,146,642,13,1,802,259,605,12,3,879,30.9,66,3,20.3,1681,True,12,405,1247,25,4,2024-07-27,False,False,True,0.7418203450327187,0.2409280190362879,0.0148720999405116,0.002379535990481856,Peak,Saturday,July
2024-07-27 13:00:00,147,643,14,2,806,260,606,13,0,879,31.2,64,3,19.7,1685,True,13,407,1249,27,2,2024-07-27,False,False,True,0.741246290801187,0.24154302670623146,0.016023738872403562,0.0011869436201780415,Peak,Saturday,July
2024-07-27 14:00:00,95,429,7,0,531,172,405,6,2,585,31.4,65,3,20.3,1116,True,14,267,834,13,2,2024-07-27,False,False,False,0.7473118279569892,0.239247311827957,0.011648745519713262,0.0017921146953405018,Peak,Saturday,July
2024-07-27 15:00:00,97,426,9,1,533,170,403,8,0,581,31.5,64,3,20.8,1114,True,15,267,829,17,1,2024-07-27,False,False,False,0.744165170556553,0.23967684021543986,0.01526032315978456,0.0008976660682226212,Peak,Saturday,July
2024-07-27 16:00:00,97,429,8,0,534,172,404,7,3,586,31.5,64,3,19.6,1120,True,16,269,833,15,3,2024-07-27,False,False,False,0.74375,0.24017857142857144,0.013392857142857142,0.0026785714285714286,Peak,Saturday,July
2024-07-27 17:00:00,148,644,14,1,807,261,607,13,1,882,31.1,65,3,18.2,1689,True,17,409,1251,27,2,2024-07-27,False,False,True,0.7406749555950266,0.24215512137359385,0.015985790408525755,0.0011841326228537595,Peak,Saturday,July
2024-07-27 18:00:00,146,642,12,1,801,259,605,11,3,878,30.8,66,3,17.6,1679,True,18,405,1247,23,4,2024-07-27,False,False,True,0.7427039904705182,0.24121500893388922,0.0136986301369863,0.0023823704586063135,Peak,Saturday,July
2024-07-27 19:00:00,147,643,13,2,805,260,606,12,0,878,30.4,67,3,15.9,1683,True,19,407,1249,25,2,2024-07-27,False,False,True,0.7421271538918598,0.24183006535947713,0.014854426619132501,0.0011883541295306002,Peak,Saturday,July
2024-07-27 20:00:00,96,429,7,0,532,172,405,6,2,585,29.7,70,3,12.9,1117,True,20,268,834,13,2,2024-07-27,False,False,False,0.7466427931960609,0.23992837958818264,0.011638316920322292,0.0017905102954341987,Shoulder,Saturday,July
2024-07-27 21:00:00,99,426,9,1,535,170,403,8,0,581,28.6,73,3,9.4,1116,True,21,269,829,17,1,2024-07-27,False,False,False,0.742831541218638,0.2410394265232975,0.015232974910394265,0.0008960573476702509,Shoulder,Saturday,July
2024-07-27 22:00:00,97,428,8,0,533,172,404,7,2,585,27.8,76,3,8.7,1118,True,22,269,832,15,2,2024-07-27,False,False,False,0.7441860465116279,0.240608228980322,0.013416815742397137,0.0017889087656529517,Shoulder,Saturday,July
2024-07-27 23:00:00,47,213,4,1,265,85,201,3,0,289,27.4,79,3,9.6,554,True,23,132,414,7,1,2024-07-27,False,False,False,0.7472924187725631,0.23826714801444043,0.01263537906137184,0.0018050541516245488,Shoulder,Saturday,July
2024-07-28 00:00:00,47,223,0,0,270,64,205,0,0,269,27.1,81,3,7.6,539,True,0,111,428,0,0,2024-07-28,False,False,False,0.7940630797773655,0.20593692022263452,0.0,0.0,Off-Peak,Sunday,July
2024-07-28 01:00:00,23,51,3,1,78,24,51,3,1,79,26.7,83,3,7.4,157,True,1,47,102,6,2,2024-07-28,False,False,False,0.6496815286624203,0.29936305732484075,0.03821656050955414,0.012738853503184714,Off-Peak,Sunday,July
2024-07-28 02:00:00,25,53,5,0,83,26,53,5,0,84,26.6,84,3,8.3,167,True,2,51,106,10,0,2024-07-28,False,False,False,0.6347305389221557,0.30538922155688625,0.059880239520958084,0.0,Off-Peak,Sunday,July
2024-07-28 03:00:00,23,51,3,1,78,24,51,3,1,79,26.7,85,3,10.2,157,True,3,47,102,6,2,2024-07-28,False,False,False,0.6496815286624203,0.29936305732484075,0.03821656050955414,0.012738853503184714,Off-Peak,Sunday,July
2024-07-28 04:00:00,25,53,5,0,83,26,53,5,0,84,26.6,86,3,10.7,167,True,4,51,106,10,0,2024-07-28,False,False,False,0.6347305389221557,0.30538922155688625,0.059880239520958084,0.0,Off-Peak,Sunday,July
2024-07-28 05:00:00,97,452,10,1,560,129,413,8,0,550,26.3,87,3,11.2,1110,True,5,226,865,18,1,2024-07-28,False,False,False,0.7792792792792793,0.2036036036036036,0.016216216216216217,0.0009009009009009009,Shoulder,Sunday,July
2024-07-28 06:00:00,95,450,8,0,553,127,411,10,3,551,26.0,88,3,9.1,1104,True,6,222,861,18,3,2024-07-28,False,False,False,0.779891304347826,0.20108695652173914,0.016304347826086956,0.002717391304347826,Shoulder,Sunday,July
2024-07-28 07:00:00,145,679,14,1,839,196,618,16,1,831,26.0,90,3,9.7,1670,True,7,341,1297,30,2,2024-07-28,False,False,True,0.7766467065868263,0.20419161676646708,0.017964071856287425,0.0011976047904191617,Peak,Sunday,July
2024-07-28 08:00:00,143,676,13,1,833,192,616,13,2,823,26.4,89,3,10.2,1656,True,8,335,1292,26,3,2024-07-28,False,False,True,0.7801932367149759,0.20229468599033817,0.01570048309178744,0.0018115942028985507,Peak,Sunday,July
2024-07-28 09:00:00,97,451,10,0,558,129,412,8,0,549,28.3,78,51,16.8,1107,True,9,226,863,18,0,2024-07-28,False,False,False,0.7795844625112918,0.2041553748870822,0.016260162601626018,0.0,Shoulder,Sunday,July
2024-07-28 10:00:00,95,450,8,1,554,127,411,10,1,549,29.1,74,51,18.6,1103,True,10,222,861,18,2,2024-07-28,False,False,False,0.7805983680870353,0.20126926563916592,0.016319129646418858,0.001813236627379873,Shoulder,Sunday,July
2024-07-28 11:00:00,145,679,15,1,840,196,618,17,1,832,29.9,71,51,20.8,1672,True,11,341,1297,32,2,2024-07-28,False,False,True,0.7757177033492823,0.20394736842105263,0.019138755980861243,0.0011961722488038277,Peak,Sunday,July
2024-07-28 12:00:00,143,676,13,1,833,192,616,14,3,825,30.7,67,2,20.8,1658,True,12,335,1292,27,4,2024-07-28,False,False,True,0.7792521109770808,0.2020506634499397,0.016284680337756333,0.0024125452352231603,Peak,Sunday,July
2024-07-28 13:00:00,144,677,14,2,837,195,617,16,0,828,31.1,66,2,20.4,1665,True,13,339,1294,30,2,2024-07-28,False,False,True,0.7771771771771772,0.2036036036036036,0.018018018018018018,0.0012012012012012011,Peak,Sunday,July
2024-07-28 14:00:00,94,450,7,0,551,129,411,6,2,548,31.4,65,3,19.5,1099,True,14,223,861,13,2,2024-07-28,False,False,False,0.7834394904458599,0.20291173794358508,0.011828935395814377,0.0018198362147406734,Peak,Sunday,July
2024-07-28 15:00:00,97,447,10,1,555,127,409,8,0,544,31.8,64,0,18.6,1099,True,15,224,856,18,1,2024-07-28,False,False,False,0.7788898999090081,0.20382165605095542,0.01637852593266606,0.0009099181073703367,Peak,Sunday,July
2024-07-28 16:00:00,95,451,8,0,554,128,412,10,2,552,31.6,65,1,17.6,1106,True,16,223,863,18,2,2024-07-28,False,False,False,0.7802893309222423,0.20162748643761302,0.0162748643761302,0.0018083182640144665,Peak,Sunday,July
2024-07-28 17:00:00,145,679,14,1,839,192,618,16,1,827,31.5,64,1,16.8,1666,True,17,337,1297,30,2,2024-07-28,False,False,True,0.7785114045618248,0.20228091236494597,0.01800720288115246,0.0012004801920768306,Peak,Sunday,July
2024-07-28 18:00:00,143,676,12,1,832,191,616,13,3,823,31.6,62,3,16.1,1655,True,18,334,1292,25,4,2024-07-28,False,False,True,0.7806646525679758,0.20181268882175227,0.015105740181268883,0.002416918429003021,Peak,Sunday,July
2024-07-28 19:00:00,144,677,13,2,836,194,617,13,0,824,31.0,65,3,14.8,1660,True,19,338,1294,26,2,2024-07-28,False,False,True,0.7795180722891566,0.2036144578313253,0.01566265060240964,0.0012048192771084338,Peak,Sunday,July
2024-07-28 20:00:00,96,450,10,0,556,129,411,6,2,548,29.9,70,1,15.6,1104,True,20,225,861,16,2,2024-07-28,False,False,False,0.779891304347826,0.20380434782608695,0.014492753623188406,0.0018115942028985507,Shoulder,Sunday,July
2024-07-28 21:00:00,95,449,8,1,553,127,410,8,0,545,29.0,74,0,12.9,1098,True,21,222,859,16,1,2024-07-28,False,False,False,0.7823315118397086,0.20218579234972678,0.014571948998178506,0.0009107468123861566,Shoulder,Sunday,July
2024-07-28 22:00:00,96,450,9,0,555,128,411,10,2,551,28.6,77,1,13.9,1106,True,22,224,861,19,2,2024-07-28,False,False,False,0.7784810126582279,0.20253164556962025,0.017179023508137433,0.0018083182640144665,Shoulder,Sunday,July
2024-07-28 23:00:00,46,223,4,1,274,64,205,4,0,273,28.2,79,3,11.9,547,True,23,110,428,8,1,2024-07-28,False,False,False,0.7824497257769653,0.20109689213893966,0.014625228519195612,0.0018281535648994515,Shoulder,Sunday,July
2024-07-29 00:00:00,51,201,0,0,252,42,119,0,0,161,28.1,80,3,11.7,413,False,0,93,320,0,0,2024-07-29,False,False,False,0.774818401937046,0.22518159806295399,0.0,0.0,Off-Peak,Monday,July
2024-07-29 01:00:00,24,51,3,0,78,23,50,2,1,76,27.8,82,3,11.4,154,False,1,47,101,5,1,2024-07-29,False,False,False,0.6558441558441559,0.3051948051948052,0.032467532467532464,0.006493506493506494,Off-Peak,Monday,July
2024-07-29 02:00:00,26,53,5,0,84,25,52,4,0,81,27.4,83,3,10.9,165,False,2,51,105,9,0,2024-07-29,False,False,False,0.6363636363636364,0.3090909090909091,0.05454545454545454,0.0,Off-Peak,Monday,July
2024-07-29 03:00:00,24,51,3,0,78,23,50,2,1,76,26.7,83,3,10.3,154,False,3,47,101,5,1,2024-07-29,False,False,False,0.6558441558441559,0.3051948051948052,0.032467532467532464,0.006493506493506494,Off-Peak,Monday,July
2024-07-29 04:00:00,26,53,5,0,84,25,52,4,0,81,26.5,83,3,11.4,165,False,4,51,105,9,0,2024-07-29,False,False,False,0.6363636363636364,0.3090909090909091,0.05454545454545454,0.0,Off-Peak,Monday,July
2024-07-29 05:00:00,104,405,7,0,516,85,242,9,1,337,26.4,84,1,13.0,853,False,5,189,647,16,1,2024-07-29,False,False,False,0.7584994138335287,0.22157092614302462,0.01875732708089097,0.0011723329425556857,Shoulder,Monday,July
2024-07-29 06:00:00,102,403,9,1,515,87,240,7,1,335,26.3,85,1,12.4,850,False,6,189,643,16,2,2024-07-29,False,False,False,0.7564705882352941,0.2223529411764706,0.018823529411764704,0.002352941176470588,Shoulder,Monday,July
2024-07-29 07:00:00,155,610,13,1,779,131,362,13,3,509,25.9,87,2,6.6,1288,False,7,286,972,26,4,2024-07-29,False,False,False,0.7546583850931677,0.2220496894409938,0.020186335403726708,0.003105590062111801,Peak,Monday,July
2024-07-29 08:00:00,154,606,12,1,773,129,360,11,0,500,24.8,92,61,3.7,1273,False,8,283,966,23,1,2024-07-29,False,False,False,0.7588373919874313,0.22230950510604872,0.018067556952081697,0.0007855459544383347,Peak,Monday,July
2024-07-29 09:00:00,104,405,7,0,516,84,242,9,2,337,26.2,87,51,7.2,853,False,9,188,647,16,2,2024-07-29,False,False,False,0.7584994138335287,0.22039859320046892,0.01875732708089097,0.0023446658851113715,Shoulder,Monday,July
2024-07-29 10:00:00,102,403,9,1,515,86,240,7,1,334,26.3,86,53,6.3,849,False,10,188,643,16,2,2024-07-29,False,False,False,0.7573616018845701,0.22143698468786807,0.01884570082449941,0.002355712603062426,Shoulder,Monday,July
2024-07-29 11:00:00,156,610,14,2,782,131,362,14,3,510,27.1,82,51,3.0,1292,False,11,287,972,28,5,2024-07-29,False,False,False,0.7523219814241486,0.22213622291021673,0.021671826625386997,0.003869969040247678,Peak,Monday,July
2024-07-29 12:00:00,154,606,13,1,774,129,360,12,1,502,28.0,79,51,4.3,1276,False,12,283,966,25,2,2024-07-29,False,False,False,0.7570532915360502,0.22178683385579936,0.019592476489028215,0.001567398119122257,Peak,Monday,July
2024-07-29 13:00:00,155,609,14,2,780,130,361,13,2,506,29.9,72,51,6.8,1286,False,13,285,970,27,4,2024-07-29,False,False,False,0.7542768273716952,0.22161741835147744,0.020995334370139968,0.003110419906687403,Peak,Monday,July
2024-07-29 14:00:00,101,404,7,0,512,83,240,6,0,329,30.4,68,3,10.7,841,False,14,184,644,13,0,2024-07-29,False,False,False,0.7657550535077289,0.21878715814506539,0.015457788347205707,0.0,Peak,Monday,July
2024-07-29 15:00:00,104,402,9,1,516,84,238,9,3,334,30.7,67,3,13.3,850,False,15,188,640,18,4,2024-07-29,False,False,False,0.7529411764705882,0.2211764705882353,0.021176470588235293,0.004705882352941176,Peak,Monday,July
2024-07-29 16:00:00,102,404,8,0,514,86,241,7,1,335,29.5,75,51,14.4,849,False,16,188,645,15,1,2024-07-29,False,False,False,0.7597173144876325,0.22143698468786807,0.0176678445229682,0.001177856301531213,Peak,Monday,July
2024-07-29 17:00:00,155,606,13,3,777,131,362,13,3,509,29.9,72,3,15.7,1286,False,17,286,968,26,6,2024-07-29,False,False,False,0.7527216174183515,0.2223950233281493,0.02021772939346812,0.004665629860031105,Peak,Monday,July
2024-07-29 18:00:00,153,605,11,1,770,129,360,11,1,501,29.2,76,3,13.6,1271,False,18,282,965,22,2,2024-07-29,False,False,False,0.7592446892210858,0.2218725413060582,0.01730920535011802,0.0015735641227380016,Peak,Monday,July
2024-07-29 19:00:00,154,608,12,2,776,130,361,12,2,505,29.0,77,0,10.0,1281,False,19,284,969,24,4,2024-07-29,False,False,False,0.7564402810304449,0.22170179547228727,0.01873536299765808,0.00312256049960968,Peak,Monday,July
2024-07-29 20:00:00,103,404,7,0,514,83,240,9,0,332,28.4,79,1,8.7,846,False,20,186,644,16,0,2024-07-29,False,False,False,0.7612293144208038,0.2198581560283688,0.018912529550827423,0.0,Shoulder,Monday,July
2024-07-29 21:00:00,102,402,9,1,514,84,238,7,2,331,28.3,79,0,8.6,845,False,21,186,640,16,3,2024-07-29,False,False,False,0.757396449704142,0.22011834319526627,0.01893491124260355,0.0035502958579881655,Shoulder,Monday,July
2024-07-29 22:00:00,103,404,8,0,515,86,241,8,1,336,27.8,81,0,8.7,851,False,22,189,645,16,1,2024-07-29,False,False,False,0.7579318448883666,0.22209165687426558,0.01880141010575793,0.0011750881316098707,Shoulder,Monday,July
2024-07-29 23:00:00,51,201,4,1,257,42,119,3,0,164,27.7,81,0,8.3,421,False,23,93,320,7,1,2024-07-29,False,False,False,0.7600950118764845,0.2209026128266033,0.0166270783847981,0.0023752969121140144,Shoulder,Monday,July
2024-07-30 00:00:00,59,438,3,1,501,49,122,0,0,171,27.5,82,0,8.3,672,False,0,108,560,3,1,2024-07-30,False,True,False,0.8333333333333334,0.16071428571428573,0.004464285714285714,0.001488095238095238,Off-Peak,Tuesday,July
2024-07-30 01:00:00,24,49,2,0,75,23,50,3,0,76,26.9,86,1,4.0,151,False,1,47,99,5,0,2024-07-30,False,True,False,0.6556291390728477,0.31125827814569534,0.033112582781456956,0.0,Off-Peak,Tuesday,July
2024-07-30 02:00:00,22,43,3,0,68,25,52,5,0,82,26.6,88,0,4.7,150,False,2,47,95,8,0,2024-07-30,False,True,False,0.6333333333333333,0.31333333333333335,0.05333333333333334,0.0,Off-Peak,Tuesday,July
2024-07-30 03:00:00,20,42,2,0,64,23,50,3,0,76,26.1,90,1,4.8,140,False,3,43,92,5,0,2024-07-30,False,True,False,0.6571428571428571,0.30714285714285716,0.03571428571428571,0.0,Off-Peak,Tuesday,July
2024-07-30 04:00:00,22,44,0,1,67,25,52,5,0,82,25.9,90,0,7.3,149,False,4,47,96,5,1,2024-07-30,False,True,False,0.6442953020134228,0.31543624161073824,0.03355704697986577,0.006711409395973154,Off-Peak,Tuesday,July
2024-07-30 05:00:00,87,490,4,0,581,101,251,10,3,365,25.8,90,0,7.6,946,False,5,188,741,14,3,2024-07-30,False,True,False,0.7832980972515856,0.19873150105708245,0.014799154334038054,0.003171247357293869,Shoulder,Tuesday,July
2024-07-30 06:00:00,122,388,15,0,525,99,249,8,1,357,25.8,89,0,7.6,882,False,6,221,637,23,1,2024-07-30,False,True,False,0.7222222222222222,0.25056689342403626,0.026077097505668934,0.0011337868480725624,Shoulder,Tuesday,July
2024-07-30 07:00:00,98,302,14,0,414,151,374,14,3,542,25.7,88,3,7.6,956,False,7,249,676,28,3,2024-07-30,False,True,False,0.7071129707112971,0.2604602510460251,0.029288702928870293,0.0031380753138075313,Peak,Tuesday,July
2024-07-30 08:00:00,61,449,13,1,524,149,372,13,1,535,26.3,86,1,8.4,1059,False,8,210,821,26,2,2024-07-30,False,True,False,0.7752596789423984,0.19830028328611898,0.024551463644948063,0.0018885741265344666,Peak,Tuesday,July
2024-07-30 09:00:00,94,482,6,0,582,98,250,9,3,360,27.3,85,1,8.3,942,False,9,192,732,15,3,2024-07-30,False,True,False,0.7770700636942676,0.20382165605095542,0.01592356687898089,0.0031847133757961785,Shoulder,Tuesday,July
2024-07-30 10:00:00,95,498,16,0,609,100,248,8,1,357,29.2,77,1,8.9,966,False,10,195,746,24,1,2024-07-30,False,True,False,0.772256728778468,0.20186335403726707,0.024844720496894408,0.0010351966873706005,Shoulder,Tuesday,July
2024-07-30 11:00:00,57,258,13,0,328,151,374,15,3,543,30.3,72,51,10.2,871,False,11,208,632,28,3,2024-07-30,False,True,False,0.7256027554535017,0.23880597014925373,0.03214695752009185,0.003444316877152698,Peak,Tuesday,July
2024-07-30 12:00:00,79,342,12,1,434,149,372,13,1,535,30.8,70,51,11.1,969,False,12,228,714,25,2,2024-07-30,False,True,False,0.7368421052631579,0.23529411764705882,0.025799793601651185,0.0020639834881320948,Peak,Tuesday,July
2024-07-30 13:00:00,122,426,14,0,562,150,373,14,2,539,31.3,66,51,14.2,1101,False,13,272,799,28,2,2024-07-30,False,True,False,0.7257039055404177,0.24704813805631246,0.025431425976385105,0.0018165304268846503,Peak,Tuesday,July
2024-07-30 14:00:00,119,407,8,1,535,98,248,7,0,353,31.2,66,51,16.6,888,False,14,217,655,15,1,2024-07-30,False,True,False,0.7376126126126126,0.24436936936936937,0.016891891891891893,0.0011261261261261261,Peak,Tuesday,July
2024-07-30 15:00:00,84,635,11,0,730,101,245,10,3,359,31.5,66,51,18.7,1089,False,15,185,880,21,3,2024-07-30,False,True,False,0.8080808080808081,0.16988062442607896,0.01928374655647383,0.0027548209366391185,Peak,Tuesday,July
2024-07-30 16:00:00,72,707,9,0,788,99,250,8,1,358,31.0,67,53,16.1,1146,False,16,171,957,17,1,2024-07-30,False,True,False,0.8350785340314136,0.14921465968586387,0.014834205933682374,0.0008726003490401396,Peak,Tuesday,July
2024-07-30 17:00:00,83,601,10,0,694,151,374,14,3,542,30.6,66,3,15.6,1236,False,17,234,975,24,3,2024-07-30,False,True,False,0.7888349514563107,0.18932038834951456,0.019417475728155338,0.0024271844660194173,Peak,Tuesday,July
2024-07-30 18:00:00,58,625,7,1,691,149,372,12,1,534,30.8,64,3,13.5,1225,False,18,207,997,19,2,2024-07-30,False,True,False,0.8138775510204082,0.1689795918367347,0.015510204081632653,0.0016326530612244899,Peak,Tuesday,July
2024-07-30 19:00:00,118,283,11,0,412,150,373,13,2,538,30.2,66,3,9.7,950,False,19,268,656,24,2,2024-07-30,False,True,False,0.6905263157894737,0.28210526315789475,0.02526315789473684,0.002105263157894737,Peak,Tuesday,July
2024-07-30 20:00:00,86,703,10,0,799,98,248,7,0,353,29.5,68,3,9.0,1152,False,20,184,951,17,0,2024-07-30,False,True,False,0.8255208333333334,0.1597222222222222,0.014756944444444444,0.0,Shoulder,Tuesday,July
2024-07-30 21:00:00,84,341,8,1,434,100,246,9,3,358,28.9,74,3,9.3,792,False,21,184,587,17,4,2024-07-30,False,True,False,0.7411616161616161,0.23232323232323232,0.021464646464646464,0.005050505050505051,Shoulder,Tuesday,July
2024-07-30 22:00:00,105,430,12,1,548,99,248,8,1,356,28.6,75,3,9.4,904,False,22,204,678,20,2,2024-07-30,False,True,False,0.75,0.22566371681415928,0.022123893805309734,0.0022123893805309734,Shoulder,Tuesday,July
2024-07-30 23:00:00,89,482,14,1,586,49,122,4,0,175,28.2,76,3,8.2,761,False,23,138,604,18,1,2024-07-30,False,True,False,0.7936925098554534,0.18134034165571616,0.023653088042049936,0.001314060446780552,Shoulder,Tuesday,July
2024-07-31 00:00:00,68,742,0,0,810,59,243,2,2,306,27.8,77,3,10.1,1116,False,0,127,985,2,2,2024-07-31,False,False,False,0.8826164874551972,0.11379928315412187,0.0017921146953405018,0.0017921146953405018,Off-Peak,Wednesday,July
2024-07-31 01:00:00,20,43,2,1,66,22,44,4,0,70,27.3,79,3,9.7,136,False,1,42,87,6,1,2024-07-31,False,False,False,0.6397058823529411,0.3088235294117647,0.04411764705882353,0.007352941176470588,Off-Peak,Wednesday,July
2024-07-31 02:00:00,23,47,2,2,74,20,43,2,0,65,26.8,82,3,10.6,139,False,2,43,90,4,2,2024-07-31,False,False,False,0.6474820143884892,0.30935251798561153,0.02877697841726619,0.014388489208633094,Off-Peak,Wednesday,July
2024-07-31 03:00:00,20,44,0,1,65,23,40,0,0,63,26.3,86,3,8.7,128,False,3,43,84,0,1,2024-07-31,False,False,False,0.65625,0.3359375,0.0,0.0078125,Off-Peak,Wednesday,July
2024-07-31 04:00:00,21,45,4,1,71,21,49,0,1,71,25.9,88,3,8.8,142,False,4,42,94,4,2,2024-07-31,False,False,False,0.6619718309859155,0.29577464788732394,0.028169014084507043,0.014084507042253521,Off-Peak,Wednesday,July
2024-07-31 05:00:00,47,259,0,1,307,81,331,0,1,413,25.8,88,3,6.9,720,False,5,128,590,0,2,2024-07-31,False,False,False,0.8194444444444444,0.17777777777777778,0.0,0.002777777777777778,Shoulder,Wednesday,July
2024-07-31 06:00:00,97,269,8,0,374,47,324,8,0,379,25.5,90,53,3.0,753,False,6,144,593,16,0,2024-07-31,False,False,False,0.7875166002656042,0.19123505976095617,0.021248339973439574,0.0,Shoulder,Wednesday,July
2024-07-31 07:00:00,66,366,5,1,438,69,375,14,1,459,25.5,93,61,2.6,897,False,7,135,741,19,2,2024-07-31,False,False,False,0.8260869565217391,0.1505016722408027,0.021181716833890748,0.002229654403567447,Peak,Wednesday,July
2024-07-31 08:00:00,49,227,8,1,285,77,192,13,0,282,24.7,96,63,8.2,567,False,8,126,419,21,1,2024-07-31,False,False,False,0.7389770723104057,0.2222222222222222,0.037037037037037035,0.001763668430335097,Peak,Wednesday,July
2024-07-31 09:00:00,90,756,8,0,854,64,278,12,0,354,24.3,95,65,8.3,1208,False,9,154,1034,20,0,2024-07-31,False,False,False,0.8559602649006622,0.12748344370860928,0.016556291390728478,0.0,Shoulder,Wednesday,July
2024-07-31 10:00:00,102,891,6,0,999,36,130,14,1,181,24.5,95,61,6.2,1180,False,10,138,1021,20,1,2024-07-31,False,False,False,0.8652542372881356,0.11694915254237288,0.01694915254237288,0.000847457627118644,Shoulder,Wednesday,July
2024-07-31 11:00:00,86,357,10,0,453,91,227,9,0,327,25.4,91,55,9.3,780,False,11,177,584,19,0,2024-07-31,False,False,False,0.7487179487179487,0.22692307692307692,0.02435897435897436,0.0,Peak,Wednesday,July
2024-07-31 12:00:00,53,272,5,0,330,56,162,10,3,231,25.9,86,63,8.1,561,False,12,109,434,15,3,2024-07-31,False,False,False,0.7736185383244206,0.19429590017825313,0.026737967914438502,0.0053475935828877,Peak,Wednesday,July
2024-07-31 13:00:00,75,250,6,0,331,34,379,7,2,422,25.7,85,61,7.1,753,False,13,109,629,13,2,2024-07-31,False,False,False,0.8353253652058433,0.14475431606905712,0.017264276228419653,0.0026560424966799467,Peak,Wednesday,July
2024-07-31 14:00:00,54,228,9,0,291,87,247,15,0,349,26.8,78,53,7.6,640,False,14,141,475,24,0,2024-07-31,False,False,False,0.7421875,0.2203125,0.0375,0.0,Peak,Wednesday,July
2024-07-31 15:00:00,70,526,6,0,602,65,368,16,1,450,26.8,78,51,7.3,1052,False,15,135,894,22,1,2024-07-31,False,False,False,0.8498098859315589,0.12832699619771862,0.02091254752851711,0.0009505703422053232,Peak,Wednesday,July
2024-07-31 16:00:00,37,768,7,0,812,77,262,10,0,349,27.0,79,3,4.5,1161,False,16,114,1030,17,0,2024-07-31,False,False,False,0.8871662360034454,0.09819121447028424,0.014642549526270457,0.0,Peak,Wednesday,July
2024-07-31 17:00:00,42,624,5,0,671,58,309,11,0,378,27.4,78,3,3.6,1049,False,17,100,933,16,0,2024-07-31,False,False,False,0.8894184938036225,0.09532888465204957,0.015252621544327931,0.0,Peak,Wednesday,July
2024-07-31 18:00:00,60,702,7,0,769,85,373,10,0,468,27.5,76,3,2.7,1237,False,18,145,1075,17,0,2024-07-31,False,False,False,0.8690379951495554,0.11721907841552143,0.0137429264349232,0.0,Peak,Wednesday,July
2024-07-31 19:00:00,73,681,7,0,761,84,127,10,1,222,26.7,80,3,3.5,983,False,19,157,808,17,1,2024-07-31,False,False,False,0.8219735503560529,0.15971515768056968,0.017293997965412006,0.001017293997965412,Peak,Wednesday,July
2024-07-31 20:00:00,57,636,4,1,698,84,263,15,0,362,25.2,90,3,5.4,1060,False,20,141,899,19,1,2024-07-31,False,False,False,0.8481132075471698,0.1330188679245283,0.017924528301886792,0.0009433962264150943,Shoulder,Wednesday,July
2024-07-31 21:00:00,57,217,8,1,283,50,311,10,2,373,26.9,86,51,4.8,656,False,21,107,528,18,3,2024-07-31,False,False,False,0.8048780487804879,0.16310975609756098,0.027439024390243903,0.004573170731707317,Shoulder,Wednesday,July
2024-07-31 22:00:00,57,841,7,1,906,50,375,12,2,439,26.4,92,3,1.6,1345,False,22,107,1216,19,3,2024-07-31,False,False,False,0.9040892193308551,0.0795539033457249,0.01412639405204461,0.0022304832713754648,Shoulder,Wednesday,July
2024-07-31 23:00:00,40,902,8,1,951,58,216,17,0,291,26.1,93,3,2.2,1242,False,23,98,1118,25,1,2024-07-31,False,False,False,0.9001610305958132,0.07890499194847021,0.020128824476650563,0.0008051529790660225,Shoulder,Wednesday,July
2024-08-01 00:00:00,55,236,0,0,291,33,118,4,0,155,25.7,94,3,3.2,446,False,0,88,354,4,0,2024-08-01,False,False,False,0.7937219730941704,0.19730941704035873,0.008968609865470852,0.0,Off-Peak,Thursday,August
2024-08-01 01:00:00,57,258,0,0,315,35,168,5,0,208,25.6,94,3,4.3,523,False,1,92,426,5,0,2024-08-01,False,False,False,0.8145315487571702,0.17590822179732313,0.009560229445506692,0.0,Off-Peak,Thursday,August
2024-08-01 02:00:00,64,243,1,0,308,39,187,8,0,234,25.4,93,3,7.3,542,False,2,103,430,9,0,2024-08-01,False,False,False,0.7933579335793358,0.1900369003690037,0.016605166051660517,0.0,Off-Peak,Thursday,August
2024-08-01 03:00:00,68,329,2,0,399,45,190,12,0,247,24.8,95,3,4.2,646,False,3,113,519,14,0,2024-08-01,False,False,False,0.8034055727554179,0.17492260061919504,0.021671826625386997,0.0,Off-Peak,Thursday,August
2024-08-01 04:00:00,72,344,4,0,420,58,193,14,0,265,24.5,96,3,4.4,685,False,4,130,537,18,0,2024-08-01,False,False,False,0.7839416058394161,0.1897810218978102,0.026277372262773723,0.0,Off-Peak,Thursday,August
2024-08-01 05:00:00,86,375,6,0,467,69,206,20,0,295,24.3,96,3,6.2,762,False,5,155,581,26,0,2024-08-01,False,False,False,0.7624671916010499,0.20341207349081364,0.03412073490813648,0.0,Shoulder,Thursday,August
2024-08-01 06:00:00,88,404,8,3,503,77,219,23,5,324,24.6,93,3,6.5,827,False,6,165,623,31,8,2024-08-01,False,False,False,0.7533252720677146,0.19951632406287786,0.037484885126964934,0.009673518742442563,Shoulder,Thursday,August
2024-08-01 07:00:00,80,415,10,5,510,83,225,25,7,340,24.6,93,3,5.2,850,False,7,163,640,35,12,2024-08-01,False,False,False,0.7529411764705882,0.19176470588235295,0.041176470588235294,0.01411764705882353,Peak,Thursday,August
2024-08-01 08:00:00,78,426,13,3,520,88,228,29,4,349,25.3,91,3,7.0,869,False,8,166,654,42,7,2024-08-01,False,False,False,0.7525891829689298,0.19102416570771003,0.04833141542002301,0.00805523590333717,Peak,Thursday,August
2024-08-01 09:00:00,82,410,15,4,511,86,239,30,6,361,27.4,85,3,8.7,872,False,9,168,649,45,10,2024-08-01,False,False,False,0.7442660550458715,0.1926605504587156,0.051605504587155966,0.011467889908256881,Shoulder,Thursday,August
2024-08-01 10:00:00,84,450,17,1,552,87,337,32,3,459,28.9,77,3,11.0,1011,False,10,171,787,49,4,2024-08-01,False,False,False,0.7784371909000989,0.16913946587537093,0.04846686449060336,0.003956478733926805,Shoulder,Thursday,August
2024-08-01 11:00:00,88,442,19,2,551,76,276,34,2,388,29.9,71,3,12.7,939,False,11,164,718,53,4,2024-08-01,False,False,False,0.7646432374866879,0.17465388711395102,0.05644302449414271,0.004259850905218318,Peak,Thursday,August
2024-08-01 12:00:00,90,433,20,1,544,73,269,37,1,380,30.6,66,3,13.9,924,False,12,163,702,57,2,2024-08-01,False,False,False,0.7597402597402597,0.1764069264069264,0.06168831168831169,0.0021645021645021645,Peak,Thursday,August
2024-08-01 13:00:00,92,400,21,4,517,60,264,39,5,368,31.0,64,3,15.9,885,False,13,152,664,60,9,2024-08-01,False,False,False,0.7502824858757062,0.17175141242937852,0.06779661016949153,0.010169491525423728,Peak,Thursday,August
2024-08-01 14:00:00,96,435,23,2,556,58,258,36,3,355,31.1,63,3,18.0,911,False,14,154,693,59,5,2024-08-01,False,False,False,0.7607025246981339,0.1690450054884742,0.06476399560922064,0.005488474204171241,Peak,Thursday,August
2024-08-01 15:00:00,98,455,24,5,582,64,260,31,6,361,30.9,64,3,17.1,943,False,15,162,715,55,11,2024-08-01,False,False,False,0.7582184517497349,0.17179215270413573,0.05832449628844114,0.01166489925768823,Peak,Thursday,August
2024-08-01 16:00:00,95,465,18,3,581,76,275,25,4,380,30.5,67,3,17.0,961,False,16,171,740,43,7,2024-08-01,False,False,False,0.7700312174817898,0.17793964620187305,0.044745057232049947,0.007284079084287201,Peak,Thursday,August
2024-08-01 17:00:00,91,452,13,2,558,78,320,22,2,422,30.3,68,3,17.1,980,False,17,169,772,35,4,2024-08-01,False,False,False,0.7877551020408163,0.17244897959183675,0.03571428571428571,0.004081632653061225,Peak,Thursday,August
2024-08-01 18:00:00,93,414,8,1,516,84,290,16,2,392,29.9,71,3,14.6,908,False,18,177,704,24,3,2024-08-01,False,False,False,0.775330396475771,0.1949339207048458,0.02643171806167401,0.003303964757709251,Peak,Thursday,August
2024-08-01 19:00:00,95,353,5,2,455,89,289,14,5,397,29.3,73,3,11.5,852,False,19,184,642,19,7,2024-08-01,False,False,False,0.7535211267605634,0.215962441314554,0.022300469483568074,0.008215962441314555,Peak,Thursday,August
2024-08-01 20:00:00,92,312,3,0,407,77,282,10,3,372,28.6,76,3,9.4,779,False,20,169,594,13,3,2024-08-01,False,False,False,0.7625160462130937,0.21694480102695765,0.01668806161745828,0.0038510911424903724,Shoulder,Thursday,August
2024-08-01 21:00:00,90,281,2,0,373,74,278,8,2,362,28.6,76,1,10.9,735,False,21,164,559,10,2,2024-08-01,False,False,False,0.7605442176870748,0.22312925170068026,0.013605442176870748,0.0027210884353741495,Shoulder,Thursday,August
2024-08-01 22:00:00,85,233,0,0,318,63,265,6,0,334,28.0,78,1,9.1,652,False,22,148,498,6,0,2024-08-01,False,False,False,0.7638036809815951,0.22699386503067484,0.009202453987730062,0.0,Shoulder,Thursday,August
2024-08-01 23:00:00,82,215,0,0,297,60,192,3,0,255,27.5,80,3,8.5,552,False,23,142,407,3,0,2024-08-01,False,False,False,0.7373188405797102,0.2572463768115942,0.005434782608695652,0.0,Shoulder,Thursday,August
2024-08-02 00:00:00,57,225,0,0,282,32,129,6,0,167,27.2,81,3,8.9,449,False,0,89,354,6,0,2024-08-02,False,False,False,0.7884187082405345,0.19821826280623608,0.013363028953229399,0.0,Off-Peak,Friday,August
2024-08-02 01:00:00,59,247,0,0,306,36,146,7,0,189,26.9,83,1,8.5,495,False,1,95,393,7,0,2024-08-02,False,False,False,0.793939393939394,0.1919191919191919,0.014141414141414142,0.0,Off-Peak,Friday,August
2024-08-02 02:00:00,67,274,0,0,341,44,165,11,0,220,26.4,84,1,7.6,561,False,2,111,439,11,0,2024-08-02,False,False,False,0.7825311942959001,0.19786096256684493,0.0196078431372549,0.0,Off-Peak,Friday,August
2024-08-02 03:00:00,69,318,1,0,388,49,177,15,0,241,26.1,85,3,7.3,629,False,3,118,495,16,0,2024-08-02,False,False,False,0.7869634340222575,0.1875993640699523,0.025437201907790145,0.0,Off-Peak,Friday,August
2024-08-02 04:00:00,75,336,3,0,414,59,191,18,0,268,26.0,85,51,8.4,682,False,4,134,527,21,0,2024-08-02,False,False,False,0.7727272727272727,0.19648093841642228,0.030791788856304986,0.0,Off-Peak,Friday,August
2024-08-02 05:00:00,88,367,6,0,461,63,200,23,2,288,25.7,86,2,9.2,749,False,5,151,567,29,2,2024-08-02,False,False,False,0.7570093457943925,0.20160213618157544,0.03871829105473965,0.0026702269692923898,Shoulder,Friday,August
2024-08-02 06:00:00,89,400,8,2,499,68,214,25,6,313,25.6,87,0,9.7,812,False,6,157,614,33,8,2024-08-02,False,False,False,0.7561576354679803,0.1933497536945813,0.04064039408866995,0.009852216748768473,Shoulder,Friday,August
2024-08-02 07:00:00,92,415,10,4,521,75,222,28,8,333,25.3,88,1,7.7,854,False,7,167,637,38,12,2024-08-02,False,False,False,0.7459016393442623,0.1955503512880562,0.04449648711943794,0.01405152224824356,Peak,Friday,August
2024-08-02 08:00:00,94,423,13,3,533,81,226,29,5,341,25.7,88,3,9.1,874,False,8,175,649,42,8,2024-08-02,False,False,False,0.7425629290617849,0.20022883295194507,0.04805491990846682,0.009153318077803204,Peak,Friday,August
2024-08-02 09:00:00,97,438,15,3,553,84,270,32,7,393,27.8,77,2,8.6,946,False,9,181,708,47,10,2024-08-02,False,False,False,0.7484143763213531,0.19133192389006343,0.049682875264270614,0.010570824524312896,Shoulder,Friday,August
2024-08-02 10:00:00,100,450,17,2,569,76,316,33,4,429,29.2,73,3,9.8,998,False,10,176,766,50,6,2024-08-02,False,False,False,0.7675350701402806,0.17635270541082165,0.050100200400801605,0.006012024048096192,Shoulder,Friday,August
2024-08-02 11:00:00,106,441,19,2,568,72,276,35,3,386,30.2,69,3,8.9,954,False,11,178,717,54,5,2024-08-02,False,False,False,0.7515723270440252,0.18658280922431866,0.05660377358490566,0.005241090146750524,Peak,Friday,August
2024-08-02 12:00:00,98,432,20,2,552,69,266,38,2,375,31.1,65,3,10.5,927,False,12,167,698,58,4,2024-08-02,False,False,False,0.7529665587918015,0.18015102481121897,0.06256742179072276,0.004314994606256742,Peak,Friday,August
2024-08-02 13:00:00,95,410,21,3,529,67,261,39,6,373,31.4,63,51,12.8,902,False,13,162,671,60,9,2024-08-02,False,False,False,0.7439024390243902,0.17960088691796008,0.06651884700665188,0.009977827050997782,Peak,Friday,August
2024-08-02 14:00:00,97,424,23,1,545,65,245,41,4,355,30.9,64,51,16.9,900,False,14,162,669,64,5,2024-08-02,False,False,False,0.7433333333333333,0.18,0.07111111111111111,0.005555555555555556,Peak,Friday,August
2024-08-02 15:00:00,99,455,22,4,580,69,257,44,7,377,30.6,66,53,17.2,957,False,15,168,712,66,11,2024-08-02,False,False,False,0.7439916405433646,0.1755485893416928,0.06896551724137931,0.011494252873563218,Peak,Friday,August
2024-08-02 16:00:00,102,465,17,3,587,73,264,47,5,389,30.4,71,51,17.1,976,False,16,175,729,64,8,2024-08-02,False,False,False,0.7469262295081968,0.17930327868852458,0.06557377049180328,0.00819672131147541,Peak,Friday,August
2024-08-02 17:00:00,94,431,14,2,541,75,313,50,3,441,29.4,76,53,13.5,982,False,17,169,744,64,5,2024-08-02,False,False,False,0.7576374745417516,0.17209775967413443,0.06517311608961303,0.0050916496945010185,Peak,Friday,August
2024-08-02 18:00:00,91,412,9,2,514,81,290,36,3,410,29.9,71,3,11.1,924,False,18,172,702,45,5,2024-08-02,False,False,False,0.7597402597402597,0.18614718614718614,0.048701298701298704,0.005411255411255411,Peak,Friday,August
2024-08-02 19:00:00,90,343,6,2,441,76,279,27,5,387,29.3,74,3,7.9,828,False,19,166,622,33,7,2024-08-02,False,False,False,0.751207729468599,0.20048309178743962,0.03985507246376811,0.008454106280193236,Peak,Friday,August
2024-08-02 20:00:00,89,314,2,0,405,70,261,20,4,355,28.4,78,3,6.5,760,False,20,159,575,22,4,2024-08-02,False,False,False,0.756578947368421,0.20921052631578949,0.02894736842105263,0.005263157894736842,Shoulder,Friday,August
2024-08-02 21:00:00,86,288,1,0,375,65,258,18,0,341,27.7,81,3,8.4,716,False,21,151,546,19,0,2024-08-02,False,False,False,0.7625698324022346,0.21089385474860337,0.02653631284916201,0.0,Shoulder,Friday,August
2024-08-02 22:00:00,85,245,0,0,330,57,225,16,0,298,26.7,85,3,6.3,628,False,22,142,470,16,0,2024-08-02,False,False,False,0.7484076433121019,0.22611464968152867,0.025477707006369428,0.0,Shoulder,Friday,August
2024-08-02 23:00:00,81,212,0,0,293,48,198,13,0,259,26.2,88,3,3.6,552,False,23,129,410,13,0,2024-08-02,False,False,False,0.7427536231884058,0.23369565217391305,0.02355072463768116,0.0,Shoulder,Friday,August
2024-08-03 00:00:00,45,216,0,0,261,23,141,3,0,167,25.9,90,3,9.0,428,True,0,68,357,3,0,2024-08-03,False,False,False,0.8341121495327103,0.1588785046728972,0.007009345794392523,0.0,Off-Peak,Saturday,August
2024-08-03 01:00:00,56,242,0,0,298,26,156,5,0,187,25.6,92,3,7.1,485,True,1,82,398,5,0,2024-08-03,False,False,False,0.8206185567010309,0.16907216494845362,0.010309278350515464,0.0,Off-Peak,Saturday,August
2024-08-03 02:00:00,67,254,0,0,321,29,179,7,0,215,25.4,93,2,5.9,536,True,2,96,433,7,0,2024-08-03,False,False,False,0.8078358208955224,0.1791044776119403,0.013059701492537313,0.0,Off-Peak,Saturday,August
2024-08-03 03:00:00,70,275,2,0,347,34,187,11,0,232,25.3,93,2,7.4,579,True,3,104,462,13,0,2024-08-03,False,False,False,0.7979274611398963,0.17962003454231434,0.022452504317789293,0.0,Off-Peak,Saturday,August
2024-08-03 04:00:00,74,308,3,0,385,45,195,14,0,254,24.8,96,3,3.6,639,True,4,119,503,17,0,2024-08-03,False,False,False,0.7871674491392802,0.18622848200312989,0.026604068857589983,0.0,Off-Peak,Saturday,August
2024-08-03 05:00:00,83,327,6,0,416,53,209,16,1,279,24.5,97,3,4.2,695,True,5,136,536,22,1,2024-08-03,False,False,False,0.7712230215827338,0.19568345323741007,0.031654676258992806,0.0014388489208633094,Shoulder,Saturday,August
2024-08-03 06:00:00,86,381,8,0,475,60,218,22,3,303,25.1,94,3,7.4,778,True,6,146,599,30,3,2024-08-03,False,False,False,0.7699228791773779,0.18766066838046272,0.038560411311053984,0.0038560411311053984,Shoulder,Saturday,August
2024-08-03 07:00:00,88,390,9,3,490,72,229,25,6,332,25.5,92,2,8.2,822,True,7,160,619,34,9,2024-08-03,False,False,False,0.7530413625304136,0.19464720194647203,0.0413625304136253,0.010948905109489052,Peak,Saturday,August
2024-08-03 08:00:00,92,400,12,4,508,81,262,27,8,378,26.1,90,51,11.4,886,True,8,173,662,39,12,2024-08-03,False,False,False,0.7471783295711061,0.19525959367945825,0.04401805869074492,0.013544018058690745,Peak,Saturday,August
2024-08-03 09:00:00,94,436,16,3,549,84,295,31,10,420,27.3,84,1,8.4,969,True,9,178,731,47,13,2024-08-03,False,False,False,0.7543859649122807,0.18369453044375644,0.048503611971104234,0.013415892672858616,Shoulder,Saturday,August
2024-08-03 10:00:00,96,454,17,2,569,76,307,34,5,422,28.5,78,1,12.9,991,True,10,172,761,51,7,2024-08-03,False,False,False,0.7679112008072654,0.17356205852674067,0.05146316851664985,0.007063572149344097,Shoulder,Saturday,August
2024-08-03 11:00:00,98,471,19,1,589,71,313,35,3,422,29.5,75,51,12.2,1011,True,11,169,784,54,4,2024-08-03,False,False,False,0.7754698318496538,0.1671612265084075,0.05341246290801187,0.003956478733926805,Peak,Saturday,August
2024-08-03 12:00:00,97,460,21,5,583,65,321,36,1,423,29.9,72,1,13.4,1006,True,12,162,781,57,6,2024-08-03,False,False,False,0.7763419483101391,0.1610337972166998,0.05666003976143141,0.005964214711729622,Peak,Saturday,August
2024-08-03 13:00:00,95,432,23,2,552,62,232,40,4,338,29.6,72,51,11.4,890,True,13,157,664,63,6,2024-08-03,False,False,False,0.7460674157303371,0.17640449438202246,0.07078651685393259,0.006741573033707865,Peak,Saturday,August
2024-08-03 14:00:00,90,417,24,3,534,60,245,43,2,350,30.7,70,51,12.5,884,True,14,150,662,67,5,2024-08-03,False,False,False,0.748868778280543,0.16968325791855204,0.0757918552036199,0.005656108597285068,Peak,Saturday,August
2024-08-03 15:00:00,94,444,20,4,562,63,266,44,7,380,29.9,73,53,14.5,942,True,15,157,710,64,11,2024-08-03,False,False,False,0.7537154989384289,0.16666666666666666,0.06794055201698514,0.01167728237791932,Peak,Saturday,August
2024-08-03 16:00:00,96,453,18,2,569,75,294,41,6,416,29.0,76,51,12.2,985,True,16,171,747,59,8,2024-08-03,False,False,False,0.7583756345177665,0.1736040609137056,0.05989847715736041,0.008121827411167513,Peak,Saturday,August
2024-08-03 17:00:00,87,446,14,1,548,78,306,33,2,419,29.6,73,3,10.4,967,True,17,165,752,47,3,2024-08-03,False,False,False,0.7776628748707343,0.17063081695966908,0.04860392967942089,0.0031023784901758012,Peak,Saturday,August
2024-08-03 18:00:00,83,431,8,2,524,74,283,30,2,389,29.9,71,2,8.7,913,True,18,157,714,38,4,2024-08-03,False,False,False,0.7820372398685652,0.171960569550931,0.0416210295728368,0.004381161007667032,Peak,Saturday,August
2024-08-03 19:00:00,78,345,7,1,431,71,262,22,4,359,29.2,74,3,5.5,790,True,19,149,607,29,5,2024-08-03,False,False,False,0.7683544303797468,0.18860759493670887,0.03670886075949367,0.006329113924050633,Peak,Saturday,August
2024-08-03 20:00:00,74,304,3,0,381,65,224,21,3,313,28.4,76,3,7.1,694,True,20,139,528,24,3,2024-08-03,False,False,False,0.760806916426513,0.20028818443804033,0.0345821325648415,0.004322766570605188,Shoulder,Saturday,August
2024-08-03 21:00:00,65,252,0,0,317,54,215,15,1,285,26.8,88,2,4.3,602,True,21,119,467,15,1,2024-08-03,False,False,False,0.7757475083056479,0.19767441860465115,0.024916943521594685,0.0016611295681063123,Shoulder,Saturday,August
2024-08-03 22:00:00,62,218,0,0,280,47,196,8,0,251,26.8,86,3,4.4,531,True,22,109,414,8,0,2024-08-03,False,False,False,0.7796610169491526,0.20527306967984935,0.015065913370998116,0.0,Shoulder,Saturday,August
2024-08-03 23:00:00,55,207,0,0,262,45,188,8,0,241,26.5,87,3,6.5,503,True,23,100,395,8,0,2024-08-03,False,False,False,0.7852882703777336,0.1988071570576541,0.015904572564612324,0.0,Shoulder,Saturday,August
2024-08-04 00:00:00,63,228,0,0,291,37,146,2,0,185,26.1,87,3,5.2,476,True,0,100,374,2,0,2024-08-04,False,False,False,0.7857142857142857,0.21008403361344538,0.004201680672268907,0.0,Off-Peak,Sunday,August
2024-08-04 01:00:00,66,245,0,0,311,39,157,4,0,200,25.6,89,51,4.0,511,True,1,105,402,4,0,2024-08-04,False,False,False,0.786692759295499,0.2054794520547945,0.007827788649706457,0.0,Off-Peak,Sunday,August
2024-08-04 02:00:00,68,274,0,0,342,43,179,6,0,228,24.2,96,65,11.8,570,True,2,111,453,6,0,2024-08-04,False,False,False,0.7947368421052632,0.19473684210526315,0.010526315789473684,0.0,Off-Peak,Sunday,August
2024-08-04 03:00:00,74,295,4,0,373,46,183,11,0,240,23.6,96,65,5.9,613,True,3,120,478,15,0,2024-08-04,False,False,False,0.7797716150081566,0.19575856443719414,0.024469820554649267,0.0,Off-Peak,Sunday,August
2024-08-04 04:00:00,78,319,5,0,402,48,195,13,0,256,23.5,96,63,8.0,658,True,4,126,514,18,0,2024-08-04,False,False,False,0.7811550151975684,0.19148936170212766,0.02735562310030395,0.0,Off-Peak,Sunday,August
2024-08-04 05:00:00,81,357,6,0,444,50,205,15,2,272,23.6,95,63,4.4,716,True,5,131,562,21,2,2024-08-04,False,False,False,0.7849162011173184,0.1829608938547486,0.029329608938547486,0.002793296089385475,Shoulder,Sunday,August
2024-08-04 06:00:00,85,381,8,0,474,55,218,18,3,294,23.7,96,55,4.3,768,True,6,140,599,26,3,2024-08-04,False,False,False,0.7799479166666666,0.18229166666666666,0.033854166666666664,0.00390625,Shoulder,Sunday,August
2024-08-04 07:00:00,87,398,11,2,498,59,232,24,7,322,24.0,96,55,3.7,820,True,7,146,630,35,9,2024-08-04,False,False,False,0.7682926829268293,0.17804878048780487,0.042682926829268296,0.01097560975609756,Peak,Sunday,August
2024-08-04 08:00:00,89,406,13,5,513,64,266,26,8,364,23.8,96,51,2.9,877,True,8,153,672,39,13,2024-08-04,False,False,False,0.766248574686431,0.17445838084378562,0.04446978335233751,0.014823261117445839,Peak,Sunday,August
2024-08-04 09:00:00,95,438,17,3,553,68,295,30,11,404,25.3,92,53,2.4,957,True,9,163,733,47,14,2024-08-04,False,False,False,0.7659352142110762,0.1703239289446186,0.04911180773249739,0.014629049111807733,Shoulder,Sunday,August
2024-08-04 10:00:00,97,464,19,1,581,76,317,33,4,430,26.4,87,53,8.9,1011,True,10,173,781,52,5,2024-08-04,False,False,False,0.7725024727992087,0.17111770524233433,0.051434223541048464,0.004945598417408506,Shoulder,Sunday,August
2024-08-04 11:00:00,100,481,23,0,604,79,333,35,2,449,27.0,83,51,11.1,1053,True,11,179,814,58,2,2024-08-04,False,False,False,0.7730294396961064,0.16999050332383667,0.055080721747388414,0.001899335232668566,Peak,Sunday,August
2024-08-04 12:00:00,108,470,25,4,607,82,352,38,3,475,28.2,78,51,10.3,1082,True,12,190,822,63,7,2024-08-04,False,False,False,0.7597042513863216,0.1756007393715342,0.05822550831792976,0.006469500924214418,Peak,Sunday,August
2024-08-04 13:00:00,129,452,22,3,606,87,296,41,6,430,28.5,78,51,11.5,1036,True,13,216,748,63,9,2024-08-04,False,False,False,0.722007722007722,0.2084942084942085,0.060810810810810814,0.008687258687258687,Peak,Sunday,August
2024-08-04 14:00:00,146,427,21,3,597,93,254,40,3,390,28.7,77,51,10.3,987,True,14,239,681,61,6,2024-08-04,False,False,False,0.6899696048632219,0.24214792299898683,0.06180344478216818,0.0060790273556231,Peak,Sunday,August
2024-08-04 15:00:00,138,445,19,2,604,95,267,37,8,407,28.9,75,3,10.9,1011,True,15,233,712,56,10,2024-08-04,False,False,False,0.7042532146389713,0.2304648862512364,0.05539070227497527,0.009891196834817012,Peak,Sunday,August
2024-08-04 16:00:00,121,468,17,1,607,98,285,34,5,422,29.0,73,3,10.2,1029,True,16,219,753,51,6,2024-08-04,False,False,False,0.7317784256559767,0.21282798833819241,0.04956268221574344,0.0058309037900874635,Peak,Sunday,August
2024-08-04 17:00:00,117,436,15,2,570,88,300,31,3,422,29.1,72,3,8.1,992,True,17,205,736,46,5,2024-08-04,False,False,False,0.7419354838709677,0.20665322580645162,0.046370967741935484,0.005040322580645161,Peak,Sunday,August
2024-08-04 18:00:00,109,421,9,3,542,84,281,39,2,406,29.0,71,3,6.5,948,True,18,193,702,48,5,2024-08-04,False,False,False,0.740506329113924,0.20358649789029537,0.05063291139240506,0.005274261603375527,Peak,Sunday,August
2024-08-04 19:00:00,95,415,6,1,517,80,254,26,3,363,28.0,77,3,3.7,880,True,19,175,669,32,4,2024-08-04,False,False,False,0.7602272727272728,0.19886363636363635,0.03636363636363636,0.004545454545454545,Peak,Sunday,August
2024-08-04 20:00:00,91,404,5,0,500,78,227,21,1,327,27.1,82,3,6.0,827,True,20,169,631,26,1,2024-08-04,False,False,False,0.7629987908101572,0.20435308343409916,0.03143893591293833,0.0012091898428053204,Shoulder,Sunday,August
2024-08-04 21:00:00,86,382,0,0,468,75,218,18,0,311,26.8,83,51,2.7,779,True,21,161,600,18,0,2024-08-04,False,False,False,0.7702182284980744,0.20667522464698332,0.023106546854942234,0.0,Shoulder,Sunday,August
2024-08-04 22:00:00,82,250,0,0,332,67,197,9,0,273,26.4,86,3,3.1,605,True,22,149,447,9,0,2024-08-04,False,False,False,0.7388429752066116,0.2462809917355372,0.01487603305785124,0.0,Shoulder,Sunday,August
2024-08-04 23:00:00,79,217,0,0,296,66,189,6,0,261,26.3,86,3,3.7,557,True,23,145,406,6,0,2024-08-04,False,False,False,0.7289048473967684,0.26032315978456017,0.010771992818671455,0.0,Shoulder,Sunday,August
2024-08-05 00:00:00,76,338,0,0,414,46,186,4,0,236,26.0,89,51,4.5,650,False,0,122,524,4,0,2024-08-05,False,False,False,0.8061538461538461,0.18769230769230769,0.006153846153846154,0.0,Off-Peak,Monday,August
2024-08-05 01:00:00,79,365,0,0,444,58,188,7,0,253,25.5,94,61,3.5,697,False,1,137,553,7,0,2024-08-05,False,False,False,0.793400286944046,0.19655667144906744,0.010043041606886656,0.0,Off-Peak,Monday,August
2024-08-05 02:00:00,81,384,0,0,465,59,195,9,0,263,25.3,96,3,2.3,728,False,2,140,579,9,0,2024-08-05,False,False,False,0.7953296703296703,0.19230769230769232,0.012362637362637362,0.0,Off-Peak,Monday,August
2024-08-05 03:00:00,84,407,4,0,495,61,199,13,0,273,24.6,99,3,3.1,768,False,3,145,606,17,0,2024-08-05,False,False,False,0.7890625,0.18880208333333334,0.022135416666666668,0.0,Off-Peak,Monday,August
2024-08-05 04:00:00,88,432,6,0,526,64,223,15,0,302,24.6,98,3,3.1,828,False,4,152,655,21,0,2024-08-05,False,False,False,0.7910628019323671,0.18357487922705315,0.025362318840579712,0.0,Off-Peak,Monday,August
2024-08-05 05:00:00,93,451,7,0,551,75,261,18,0,354,24.4,97,3,2.7,905,False,5,168,712,25,0,2024-08-05,False,False,False,0.7867403314917127,0.1856353591160221,0.027624309392265192,0.0,Shoulder,Monday,August
2024-08-05 06:00:00,95,486,8,1,590,103,285,21,2,411,24.4,97,3,2.4,1001,False,6,198,771,29,3,2024-08-05,False,False,False,0.7702297702297702,0.1978021978021978,0.028971028971028972,0.002997002997002997,Shoulder,Monday,August
2024-08-05 07:00:00,97,513,10,2,622,126,293,24,5,448,24.4,96,3,3.8,1070,False,7,223,806,34,7,2024-08-05,False,False,False,0.7532710280373832,0.20841121495327103,0.03177570093457944,0.0065420560747663555,Peak,Monday,August
2024-08-05 08:00:00,99,530,14,4,647,97,317,27,4,445,24.7,96,3,4.3,1092,False,8,196,847,41,8,2024-08-05,False,False,False,0.7756410256410257,0.1794871794871795,0.037545787545787544,0.007326007326007326,Peak,Monday,August
2024-08-05 09:00:00,108,547,16,3,674,85,333,33,6,457,26.8,88,51,4.2,1131,False,9,193,880,49,9,2024-08-05,False,False,False,0.7780725022104332,0.17064544650751548,0.04332449160035367,0.007957559681697613,Shoulder,Monday,August
2024-08-05 10:00:00,115,522,19,2,658,80,359,35,7,481,27.8,81,51,4.9,1139,False,10,195,881,54,9,2024-08-05,False,False,False,0.7734855136084284,0.17120280948200176,0.04741000877963126,0.007901668129938543,Shoulder,Monday,August
2024-08-05 11:00:00,139,503,22,3,667,78,383,42,5,508,28.9,76,51,4.9,1175,False,11,217,886,64,8,2024-08-05,False,False,False,0.7540425531914894,0.18468085106382978,0.05446808510638298,0.006808510638297872,Peak,Monday,August
2024-08-05 12:00:00,158,532,27,4,721,73,368,44,4,489,29.7,72,51,9.4,1210,False,12,231,900,71,8,2024-08-05,False,False,False,0.743801652892562,0.19090909090909092,0.05867768595041322,0.006611570247933884,Peak,Monday,August
2024-08-05 13:00:00,177,521,24,5,727,67,337,39,4,447,30.1,69,51,10.8,1174,False,13,244,858,63,9,2024-08-05,False,False,False,0.7308347529812607,0.20783645655877342,0.05366269165247019,0.007666098807495741,Peak,Monday,August
2024-08-05 14:00:00,165,502,21,2,690,74,326,36,3,439,30.4,67,51,10.7,1129,False,14,239,828,57,5,2024-08-05,False,False,False,0.733392382639504,0.21169176262178918,0.050487156775907885,0.0044286979627989375,Peak,Monday,August
2024-08-05 15:00:00,148,524,19,1,692,95,319,32,2,448,30.2,67,2,12.0,1140,False,15,243,843,51,3,2024-08-05,False,False,False,0.7394736842105263,0.2131578947368421,0.04473684210526316,0.002631578947368421,Peak,Monday,August
2024-08-05 16:00:00,129,543,16,1,689,98,335,43,3,479,30.0,66,51,11.9,1168,False,16,227,878,59,4,2024-08-05,False,False,False,0.7517123287671232,0.19434931506849315,0.05051369863013699,0.003424657534246575,Peak,Monday,August
2024-08-05 17:00:00,116,502,14,2,634,111,354,37,2,504,29.1,72,3,14.0,1138,False,17,227,856,51,4,2024-08-05,False,False,False,0.7521968365553603,0.19947275922671354,0.04481546572934974,0.0035149384885764497,Peak,Monday,August
2024-08-05 18:00:00,107,461,11,2,581,119,321,34,1,475,28.2,76,3,11.2,1056,False,18,226,782,45,3,2024-08-05,False,False,False,0.740530303030303,0.21401515151515152,0.04261363636363636,0.002840909090909091,Peak,Monday,August
2024-08-05 19:00:00,99,434,8,0,541,103,314,25,0,442,27.2,82,51,10.8,983,False,19,202,748,33,0,2024-08-05,False,False,False,0.7609359104781281,0.20549338758901323,0.0335707019328586,0.0,Peak,Monday,August
2024-08-05 20:00:00,97,402,6,0,505,97,307,22,0,426,26.3,89,53,8.4,931,False,20,194,709,28,0,2024-08-05,False,False,False,0.761546723952739,0.2083780880773362,0.03007518796992481,0.0,Shoulder,Monday,August
2024-08-05 21:00:00,95,353,3,0,451,92,293,14,0,399,27.2,84,51,6.5,850,False,21,187,646,17,0,2024-08-05,False,False,False,0.76,0.22,0.02,0.0,Shoulder,Monday,August
2024-08-05 22:00:00,86,320,0,0,406,85,287,7,0,379,26.6,88,3,7.9,785,False,22,171,607,7,0,2024-08-05,False,False,False,0.7732484076433122,0.2178343949044586,0.008917197452229299,0.0,Shoulder,Monday,August
2024-08-05 23:00:00,84,232,0,0,316,68,279,3,0,350,26.0,89,2,7.3,666,False,23,152,511,3,0,2024-08-05,False,False,False,0.7672672672672672,0.22822822822822822,0.0045045045045045045,0.0,Shoulder,Monday,August
2024-08-06 00:00:00,56,253,0,0,309,54,173,6,0,233,25.9,89,1,4.6,542,False,0,110,426,6,0,2024-08-06,False,False,False,0.7859778597785978,0.2029520295202952,0.01107011070110701,0.0,Off-Peak,Tuesday,August
2024-08-06 01:00:00,69,245,0,0,314,57,168,8,0,233,25.8,90,1,3.2,547,False,1,126,413,8,0,2024-08-06,False,False,False,0.7550274223034735,0.2303473491773309,0.014625228519195612,0.0,Off-Peak,Tuesday,August
2024-08-06 02:00:00,71,224,0,0,295,62,154,11,0,227,25.4,93,2,3.9,522,False,2,133,378,11,0,2024-08-06,False,False,False,0.7241379310344828,0.2547892720306513,0.0210727969348659,0.0,Off-Peak,Tuesday,August
2024-08-06 03:00:00,75,217,0,0,292,75,166,14,0,255,25.3,93,3,5.8,547,False,3,150,383,14,0,2024-08-06,False,False,False,0.70018281535649,0.2742230347349177,0.025594149908592323,0.0,Off-Peak,Tuesday,August
2024-08-06 04:00:00,88,302,3,0,393,88,183,16,0,287,25.2,93,2,5.2,680,False,4,176,485,19,0,2024-08-06,False,False,False,0.7132352941176471,0.25882352941176473,0.027941176470588237,0.0,Off-Peak,Tuesday,August
2024-08-06 05:00:00,93,341,4,0,438,93,264,19,0,376,24.7,96,2,2.7,814,False,5,186,605,23,0,2024-08-06,False,False,False,0.7432432432432432,0.2285012285012285,0.028255528255528257,0.0,Shoulder,Tuesday,August
2024-08-06 06:00:00,95,498,6,2,601,107,355,22,1,485,24.6,96,51,3.4,1086,False,6,202,853,28,3,2024-08-06,False,False,False,0.785451197053407,0.1860036832412523,0.02578268876611418,0.0027624309392265192,Shoulder,Tuesday,August
2024-08-06 07:00:00,119,500,9,4,632,124,373,25,3,525,24.9,96,3,0.8,1157,False,7,243,873,34,7,2024-08-06,False,False,False,0.7545375972342264,0.21002592912705273,0.029386343993085567,0.006050129645635264,Peak,Tuesday,August
2024-08-06 08:00:00,106,510,12,3,631,115,396,28,4,543,25.3,93,51,7.4,1174,False,8,221,906,40,7,2024-08-06,False,False,False,0.7717206132879046,0.18824531516183987,0.034071550255536626,0.00596252129471891,Peak,Tuesday,August
2024-08-06 09:00:00,89,457,13,5,564,85,348,34,5,472,25.1,90,51,4.0,1036,False,9,174,805,47,10,2024-08-06,False,False,False,0.777027027027027,0.16795366795366795,0.045366795366795366,0.009652509652509652,Shoulder,Tuesday,August
2024-08-06 10:00:00,76,422,15,7,520,80,329,36,6,451,26.2,87,1,4.6,971,False,10,156,751,51,13,2024-08-06,False,False,False,0.7734294541709578,0.16065911431513905,0.05252317198764161,0.013388259526261586,Shoulder,Tuesday,August
2024-08-06 11:00:00,91,505,18,6,620,78,332,43,3,456,28.0,78,2,2.1,1076,False,11,169,837,61,9,2024-08-06,False,False,False,0.7778810408921933,0.1570631970260223,0.056691449814126396,0.008364312267657992,Peak,Tuesday,August
2024-08-06 12:00:00,98,548,21,4,671,73,388,47,4,512,29.4,69,2,6.6,1183,False,12,171,936,68,8,2024-08-06,False,False,False,0.7912087912087912,0.1445477599323753,0.057480980557903634,0.006762468300929839,Peak,Tuesday,August
2024-08-06 13:00:00,67,561,23,5,656,77,397,45,2,521,30.0,65,3,8.9,1177,False,13,144,958,68,7,2024-08-06,False,False,False,0.8139337298215803,0.12234494477485132,0.05777400169923534,0.00594732370433305,Peak,Tuesday,August
2024-08-06 14:00:00,75,512,20,3,610,74,356,38,2,470,30.2,64,3,10.2,1080,False,14,149,868,58,5,2024-08-06,False,False,False,0.8037037037037037,0.13796296296296295,0.053703703703703705,0.004629629629629629,Peak,Tuesday,August
2024-08-06 15:00:00,98,524,18,2,642,89,339,35,1,464,29.9,65,2,10.5,1106,False,15,187,863,53,3,2024-08-06,False,False,False,0.7802893309222423,0.16907775768535263,0.04792043399638336,0.0027124773960217,Peak,Tuesday,August
2024-08-06 16:00:00,117,553,16,1,687,99,395,48,2,544,29.9,65,0,10.5,1231,False,16,216,948,64,3,2024-08-06,False,False,False,0.7701056051990252,0.17546709991876522,0.05199025182778229,0.002437043054427295,Peak,Tuesday,August
2024-08-06 17:00:00,124,562,13,2,701,127,434,47,1,609,29.4,70,1,10.2,1310,False,17,251,996,60,3,2024-08-06,False,False,False,0.7603053435114504,0.1916030534351145,0.04580152671755725,0.0022900763358778627,Peak,Tuesday,August
2024-08-06 18:00:00,109,541,12,1,663,116,471,44,0,631,28.8,73,1,8.5,1294,False,18,225,1012,56,1,2024-08-06,False,False,False,0.7820710973724884,0.17387944358578053,0.04327666151468315,0.0007727975270479134,Peak,Tuesday,August
2024-08-06 19:00:00,96,434,9,0,539,104,454,35,0,593,28.2,76,0,5.5,1132,False,19,200,888,44,0,2024-08-06,False,False,False,0.784452296819788,0.17667844522968199,0.038869257950530034,0.0,Peak,Tuesday,August
2024-08-06 20:00:00,93,400,7,0,500,74,367,32,0,473,27.6,80,1,3.8,973,False,20,167,767,39,0,2024-08-06,False,False,False,0.7882836587872559,0.17163412127440905,0.040082219938335044,0.0,Shoulder,Tuesday,August
2024-08-06 21:00:00,87,335,4,0,426,62,333,27,0,422,27.6,79,3,3.9,848,False,21,149,668,31,0,2024-08-06,False,False,False,0.7877358490566038,0.17570754716981132,0.036556603773584904,0.0,Shoulder,Tuesday,August
2024-08-06 22:00:00,86,317,0,0,403,55,297,24,0,376,27.1,86,2,4.7,779,False,22,141,614,24,0,2024-08-06,False,False,False,0.7881899871630296,0.1810012836970475,0.03080872913992298,0.0,Shoulder,Tuesday,August
2024-08-06 23:00:00,73,242,0,0,315,48,285,15,0,348,26.9,82,3,4.1,663,False,23,121,527,15,0,2024-08-06,False,False,False,0.7948717948717948,0.18250377073906485,0.02262443438914027,0.0,Shoulder,Tuesday,August
2024-08-07 00:00:00,65,252,0,0,317,63,163,5,0,231,26.7,84,3,3.6,548,False,0,128,415,5,0,2024-08-07,False,False,False,0.7572992700729927,0.23357664233576642,0.009124087591240875,0.0,Off-Peak,Wednesday,August
2024-08-07 01:00:00,67,245,0,0,312,66,156,8,0,230,26.7,82,3,1.1,542,False,1,133,401,8,0,2024-08-07,False,False,False,0.7398523985239852,0.24538745387453875,0.014760147601476014,0.0,Off-Peak,Wednesday,August
2024-08-07 02:00:00,72,224,0,0,296,70,144,9,0,223,26.3,86,3,2.6,519,False,2,142,368,9,0,2024-08-07,False,False,False,0.7090558766859345,0.27360308285163776,0.017341040462427744,0.0,Off-Peak,Wednesday,August
2024-08-07 03:00:00,76,219,0,0,295,78,137,11,0,226,25.6,92,3,1.1,521,False,3,154,356,11,0,2024-08-07,False,False,False,0.6833013435700576,0.29558541266794625,0.02111324376199616,0.0,Off-Peak,Wednesday,August
2024-08-07 04:00:00,87,326,0,0,413,85,171,13,0,269,25.1,93,3,1.8,682,False,4,172,497,13,0,2024-08-07,False,False,False,0.7287390029325513,0.25219941348973607,0.01906158357771261,0.0,Off-Peak,Wednesday,August
2024-08-07 05:00:00,94,357,1,0,452,97,286,17,0,400,24.9,94,3,1.8,852,False,5,191,643,18,0,2024-08-07,False,False,False,0.7546948356807511,0.22417840375586853,0.02112676056338028,0.0,Shoulder,Wednesday,August
2024-08-07 06:00:00,97,495,4,1,597,114,353,21,2,490,24.6,95,3,1.8,1087,False,6,211,848,25,3,2024-08-07,False,False,False,0.7801287948482061,0.19411223551057957,0.022999080036798528,0.0027598896044158236,Shoulder,Wednesday,August
2024-08-07 07:00:00,115,518,5,3,641,120,372,25,4,521,24.9,94,3,1.8,1162,False,7,235,890,30,7,2024-08-07,False,False,False,0.76592082616179,0.20223752151462995,0.025817555938037865,0.006024096385542169,Peak,Wednesday,August
2024-08-07 08:00:00,129,504,9,5,647,105,396,27,3,531,24.4,95,63,8.1,1178,False,8,234,900,36,8,2024-08-07,False,False,False,0.7640067911714771,0.19864176570458403,0.030560271646859084,0.006791171477079796,Peak,Wednesday,August
2024-08-07 09:00:00,99,487,11,4,601,94,348,29,6,477,27.2,83,51,7.2,1078,False,9,193,835,40,10,2024-08-07,False,False,False,0.774582560296846,0.1790352504638219,0.03710575139146568,0.00927643784786642,Shoulder,Wednesday,August
2024-08-07 10:00:00,96,462,13,6,577,88,334,23,5,450,28.6,75,3,9.8,1027,False,10,184,796,36,11,2024-08-07,False,False,False,0.7750730282375852,0.17916260954235638,0.035053554040895815,0.010710808179162609,Shoulder,Wednesday,August
2024-08-07 11:00:00,101,454,15,5,575,83,322,26,2,433,28.8,75,51,8.9,1008,False,11,184,776,41,7,2024-08-07,False,False,False,0.7698412698412699,0.18253968253968253,0.040674603174603176,0.006944444444444444,Peak,Wednesday,August
2024-08-07 12:00:00,118,546,14,3,681,97,356,29,3,485,25.9,90,65,10.4,1166,False,12,215,902,43,6,2024-08-07,False,False,False,0.7735849056603774,0.1843910806174957,0.03687821612349914,0.005145797598627788,Peak,Wednesday,August
2024-08-07 13:00:00,87,576,17,4,684,92,377,35,3,507,27.7,83,51,6.6,1191,False,13,179,953,52,7,2024-08-07,False,False,False,0.8001679261125105,0.15029387069689337,0.0436607892527288,0.005877413937867338,Peak,Wednesday,August
2024-08-07 14:00:00,85,532,13,3,633,85,345,32,4,466,29.4,75,51,8.3,1099,False,14,170,877,45,7,2024-08-07,False,False,False,0.7979981801637852,0.15468607825295724,0.04094631483166515,0.006369426751592357,Peak,Wednesday,August
2024-08-07 15:00:00,93,524,11,3,631,88,331,28,3,450,27.6,78,63,10.0,1081,False,15,181,855,39,6,2024-08-07,False,False,False,0.7909343200740055,0.16743755781683625,0.036077705827937095,0.005550416281221091,Peak,Wednesday,August
2024-08-07 16:00:00,127,583,9,2,721,106,396,36,2,540,27.7,79,51,9.4,1261,False,16,233,979,45,4,2024-08-07,False,False,False,0.7763679619349723,0.18477398889770025,0.035685963521015066,0.0031720856463124504,Peak,Wednesday,August
2024-08-07 17:00:00,144,552,6,1,703,113,414,37,3,567,27.3,82,51,8.6,1270,False,17,257,966,43,4,2024-08-07,False,False,False,0.7606299212598425,0.20236220472440944,0.03385826771653543,0.0031496062992125984,Peak,Wednesday,August
2024-08-07 18:00:00,102,516,4,1,623,100,421,42,2,565,27.7,80,51,2.7,1188,False,18,202,937,46,3,2024-08-07,False,False,False,0.7887205387205387,0.17003367003367004,0.03872053872053872,0.0025252525252525255,Peak,Wednesday,August
2024-08-07 19:00:00,95,424,3,0,522,94,405,39,0,538,27.2,85,3,2.6,1060,False,19,189,829,42,0,2024-08-07,False,False,False,0.7820754716981132,0.17830188679245282,0.03962264150943396,0.0,Peak,Wednesday,August
2024-08-07 20:00:00,91,405,2,0,498,75,397,36,0,508,26.1,91,3,4.8,1006,False,20,166,802,38,0,2024-08-07,False,False,False,0.7972166998011928,0.16500994035785288,0.03777335984095427,0.0,Shoulder,Wednesday,August
2024-08-07 21:00:00,86,337,0,0,423,62,363,32,0,457,25.9,90,3,6.0,880,False,21,148,700,32,0,2024-08-07,False,False,False,0.7954545454545454,0.16818181818181818,0.03636363636363636,0.0,Shoulder,Wednesday,August
2024-08-07 22:00:00,83,314,0,0,397,54,296,28,0,378,25.5,93,3,3.9,775,False,22,137,610,28,0,2024-08-07,False,False,False,0.7870967741935484,0.1767741935483871,0.03612903225806452,0.0,Shoulder,Wednesday,August
2024-08-07 23:00:00,72,245,0,0,317,46,285,25,0,356,25.0,96,3,4.6,673,False,23,118,530,25,0,2024-08-07,False,False,False,0.787518573551263,0.17533432392273401,0.03714710252600297,0.0,Shoulder,Wednesday,August
2024-08-08 00:00:00,45,234,0,0,279,34,176,9,0,219,24.7,96,3,2.3,498,False,0,79,410,9,0,2024-08-08,False,False,False,0.8232931726907631,0.15863453815261044,0.018072289156626505,0.0,Off-Peak,Thursday,August
2024-08-08 01:00:00,47,225,0,0,272,35,145,10,0,190,24.5,97,3,5.2,462,False,1,82,370,10,0,2024-08-08,False,False,False,0.8008658008658008,0.1774891774891775,0.021645021645021644,0.0,Off-Peak,Thursday,August
2024-08-08 02:00:00,52,220,0,0,272,43,164,13,0,220,24.5,95,3,5.5,492,False,2,95,384,13,0,2024-08-08,False,False,False,0.7804878048780488,0.19308943089430894,0.026422764227642278,0.0,Off-Peak,Thursday,August
2024-08-08 03:00:00,56,217,0,0,273,52,177,16,0,245,24.2,96,3,5.2,518,False,3,108,394,16,0,2024-08-08,False,False,False,0.7606177606177607,0.2084942084942085,0.03088803088803089,0.0,Off-Peak,Thursday,August
2024-08-08 04:00:00,64,308,0,0,372,64,203,19,0,286,24.2,96,3,5.0,658,False,4,128,511,19,0,2024-08-08,False,False,False,0.776595744680851,0.1945288753799392,0.028875379939209727,0.0,Off-Peak,Thursday,August
2024-08-08 05:00:00,66,335,0,0,401,67,248,21,0,336,24.4,95,51,2.2,737,False,5,133,583,21,0,2024-08-08,False,False,False,0.7910447761194029,0.18046132971506107,0.028493894165535955,0.0,Shoulder,Thursday,August
2024-08-08 06:00:00,78,474,9,2,563,75,325,24,4,428,24.2,98,51,0.5,991,False,6,153,799,33,6,2024-08-08,False,False,False,0.8062563067608476,0.15438950554994954,0.033299697275479316,0.006054490413723511,Shoulder,Thursday,August
2024-08-08 07:00:00,85,507,11,4,607,80,349,28,6,463,24.3,98,3,1.6,1070,False,7,165,856,39,10,2024-08-08,False,False,False,0.8,0.1542056074766355,0.03644859813084112,0.009345794392523364,Peak,Thursday,August
2024-08-08 08:00:00,100,462,13,4,579,83,296,33,5,417,24.8,96,3,5.0,996,False,8,183,758,46,9,2024-08-08,False,False,False,0.7610441767068273,0.18373493975903615,0.04618473895582329,0.009036144578313253,Peak,Thursday,August
2024-08-08 09:00:00,83,455,15,5,558,81,254,37,8,380,26.5,93,53,7.2,938,False,9,164,709,52,13,2024-08-08,False,False,False,0.755863539445629,0.17484008528784648,0.05543710021321962,0.013859275053304905,Shoulder,Thursday,August
2024-08-08 10:00:00,86,443,17,6,552,72,238,45,6,361,26.9,91,51,6.8,913,False,10,158,681,62,12,2024-08-08,False,False,False,0.7458926615553122,0.17305585980284777,0.06790799561883899,0.013143483023001095,Shoulder,Thursday,August
2024-08-08 11:00:00,88,426,16,4,534,70,224,48,4,346,27.4,88,51,7.9,880,False,11,158,650,64,8,2024-08-08,False,False,False,0.7386363636363636,0.17954545454545454,0.07272727272727272,0.00909090909090909,Peak,Thursday,August
2024-08-08 12:00:00,105,510,15,2,632,85,356,39,3,483,29.4,77,51,12.7,1115,False,12,190,866,54,5,2024-08-08,False,False,False,0.7766816143497758,0.17040358744394618,0.0484304932735426,0.004484304932735426,Peak,Thursday,August
2024-08-08 13:00:00,87,501,18,5,611,82,337,36,5,460,30.6,69,3,14.8,1071,False,13,169,838,54,10,2024-08-08,False,False,False,0.7824463118580766,0.15779645191409897,0.05042016806722689,0.009337068160597572,Peak,Thursday,August
2024-08-08 14:00:00,85,453,20,4,562,74,285,28,4,391,31.0,64,3,14.4,953,False,14,159,738,48,8,2024-08-08,False,False,False,0.7743966421825813,0.16684155299055614,0.05036726128016789,0.008394543546694649,Peak,Thursday,August
2024-08-08 15:00:00,92,424,23,3,542,63,264,26,3,356,30.9,63,3,15.6,898,False,15,155,688,49,6,2024-08-08,False,False,False,0.7661469933184856,0.17260579064587972,0.05456570155902005,0.0066815144766146995,Peak,Thursday,August
2024-08-08 16:00:00,102,465,14,2,583,82,346,37,5,470,30.6,61,3,16.2,1053,False,16,184,811,51,7,2024-08-08,False,False,False,0.7701804368471035,0.17473884140550808,0.04843304843304843,0.006647673314339981,Peak,Thursday,August
2024-08-08 17:00:00,116,506,17,1,640,74,354,44,4,476,30.0,67,3,16.5,1116,False,17,190,860,61,5,2024-08-08,False,False,False,0.7706093189964157,0.17025089605734767,0.05465949820788531,0.004480286738351254,Peak,Thursday,August
2024-08-08 18:00:00,81,500,15,0,596,72,345,42,2,461,29.9,68,3,14.3,1057,False,18,153,845,57,2,2024-08-08,False,False,False,0.7994323557237465,0.14474929044465468,0.05392620624408704,0.001892147587511826,Peak,Thursday,August
2024-08-08 19:00:00,75,411,13,0,499,61,339,39,1,440,29.1,72,2,11.2,939,False,19,136,750,52,1,2024-08-08,False,False,False,0.7987220447284346,0.1448349307774228,0.055378061767838126,0.0010649627263045794,Peak,Thursday,August
2024-08-08 20:00:00,66,353,11,0,430,53,322,38,0,413,28.6,76,1,10.5,843,False,20,119,675,49,0,2024-08-08,False,False,False,0.800711743772242,0.14116251482799524,0.05812574139976275,0.0,Shoulder,Thursday,August
2024-08-08 21:00:00,54,322,4,0,380,40,316,35,0,391,28.3,80,3,11.2,771,False,21,94,638,39,0,2024-08-08,False,False,False,0.8274967574578469,0.1219195849546044,0.05058365758754864,0.0,Shoulder,Thursday,August
2024-08-08 22:00:00,53,262,0,0,315,34,294,29,0,357,28.4,81,3,11.8,672,False,22,87,556,29,0,2024-08-08,False,False,False,0.8273809523809523,0.12946428571428573,0.043154761904761904,0.0,Shoulder,Thursday,August
2024-08-08 23:00:00,42,220,0,0,262,32,262,26,0,320,28.3,81,3,11.0,582,False,23,74,482,26,0,2024-08-08,False,False,False,0.8281786941580757,0.12714776632302405,0.044673539518900345,0.0,Shoulder,Thursday,August
2024-08-09 00:00:00,54,228,0,0,282,36,188,3,0,227,28.1,81,3,8.6,509,False,0,90,416,3,0,2024-08-09,False,False,False,0.8172888015717092,0.17681728880157171,0.005893909626719057,0.0,Off-Peak,Friday,August
2024-08-09 01:00:00,57,212,0,0,269,38,157,5,0,200,27.4,85,3,5.8,469,False,1,95,369,5,0,2024-08-09,False,False,False,0.7867803837953091,0.2025586353944563,0.010660980810234541,0.0,Off-Peak,Friday,August
2024-08-09 02:00:00,62,210,0,0,272,44,173,9,0,226,27.1,87,51,8.7,498,False,2,106,383,9,0,2024-08-09,False,False,False,0.7690763052208835,0.21285140562248997,0.018072289156626505,0.0,Off-Peak,Friday,August
2024-08-09 03:00:00,76,215,0,0,291,53,179,12,0,244,27.1,86,51,10.5,535,False,3,129,394,12,0,2024-08-09,False,False,False,0.7364485981308411,0.2411214953271028,0.022429906542056073,0.0,Off-Peak,Friday,August
2024-08-09 04:00:00,84,303,0,0,387,62,198,15,0,275,26.7,88,3,7.6,662,False,4,146,501,15,0,2024-08-09,False,False,False,0.756797583081571,0.22054380664652568,0.022658610271903322,0.0,Off-Peak,Friday,August
2024-08-09 05:00:00,98,327,0,0,425,76,235,16,0,327,25.9,92,51,6.6,752,False,5,174,562,16,0,2024-08-09,False,False,False,0.7473404255319149,0.23138297872340424,0.02127659574468085,0.0,Shoulder,Friday,August
2024-08-09 06:00:00,105,434,10,1,550,85,279,20,2,386,25.6,91,51,10.2,936,False,6,190,713,30,3,2024-08-09,False,False,False,0.7617521367521367,0.202991452991453,0.03205128205128205,0.003205128205128205,Shoulder,Friday,August
2024-08-09 07:00:00,129,455,12,5,601,91,357,23,3,474,25.2,92,51,10.0,1075,False,7,220,812,35,8,2024-08-09,False,False,False,0.7553488372093023,0.20465116279069767,0.03255813953488372,0.0074418604651162795,Peak,Friday,August
2024-08-09 08:00:00,117,442,14,3,576,94,296,26,5,421,25.4,92,51,6.6,997,False,8,211,738,40,8,2024-08-09,False,False,False,0.7402206619859579,0.21163490471414242,0.04012036108324975,0.00802407221664995,Peak,Friday,August
2024-08-09 09:00:00,93,431,16,6,546,82,288,31,6,407,27.5,79,53,10.4,953,False,9,175,719,47,12,2024-08-09,False,False,False,0.7544596012591815,0.18363064008394545,0.04931794333683106,0.012591815320041973,Shoulder,Friday,August
2024-08-09 10:00:00,84,423,18,5,530,73,231,32,4,340,27.7,81,51,8.6,870,False,10,157,654,50,9,2024-08-09,False,False,False,0.7517241379310344,0.18045977011494252,0.05747126436781609,0.010344827586206896,Shoulder,Friday,August
2024-08-09 11:00:00,87,414,15,5,521,61,210,35,3,309,26.5,85,61,18.4,830,False,11,148,624,50,8,2024-08-09,False,False,False,0.7518072289156627,0.1783132530120482,0.060240963855421686,0.00963855421686747,Peak,Friday,August
2024-08-09 12:00:00,117,450,17,1,585,88,248,34,2,372,26.2,82,51,12.0,957,False,12,205,698,51,3,2024-08-09,False,False,False,0.7293625914315569,0.2142110762800418,0.05329153605015674,0.003134796238244514,Peak,Friday,August
2024-08-09 13:00:00,99,468,19,6,592,84,287,29,4,404,27.5,80,51,14.9,996,False,13,183,755,48,10,2024-08-09,False,False,False,0.7580321285140562,0.18373493975903615,0.04819277108433735,0.010040160642570281,Peak,Friday,August
2024-08-09 14:00:00,87,453,21,3,564,75,176,21,2,274,27.9,81,51,15.0,838,False,14,162,629,42,5,2024-08-09,False,False,False,0.7505966587112172,0.19331742243436753,0.050119331742243436,0.0059665871121718375,Peak,Friday,August
2024-08-09 15:00:00,96,427,24,4,551,64,289,17,1,371,28.6,77,51,17.0,922,False,15,160,716,41,5,2024-08-09,False,False,False,0.7765726681127982,0.1735357917570499,0.044468546637744036,0.005422993492407809,Peak,Friday,August
2024-08-09 16:00:00,136,485,13,1,635,90,336,30,5,461,28.6,78,3,15.7,1096,False,16,226,821,43,6,2024-08-09,False,False,False,0.7490875912408759,0.2062043795620438,0.03923357664233577,0.005474452554744526,Peak,Friday,August
2024-08-09 17:00:00,125,500,16,2,643,93,314,34,3,444,28.2,78,3,14.4,1087,False,17,218,814,50,5,2024-08-09,False,False,False,0.7488500459981601,0.20055197792088317,0.045998160073597055,0.004599816007359705,Peak,Friday,August
2024-08-09 18:00:00,117,496,14,0,627,83,278,31,2,394,28.3,78,3,13.4,1021,False,18,200,774,45,2,2024-08-09,False,False,False,0.7580803134182175,0.1958863858961802,0.04407443682664055,0.0019588638589618022,Peak,Friday,August
2024-08-09 19:00:00,96,441,12,0,549,72,213,30,1,316,27.9,79,2,12.8,865,False,19,168,654,42,1,2024-08-09,False,False,False,0.7560693641618497,0.19421965317919074,0.048554913294797684,0.0011560693641618498,Peak,Friday,August
2024-08-09 20:00:00,84,365,10,0,459,64,182,27,0,273,27.5,81,3,8.9,732,False,20,148,547,37,0,2024-08-09,False,False,False,0.7472677595628415,0.20218579234972678,0.050546448087431695,0.0,Shoulder,Friday,August
2024-08-09 21:00:00,75,321,5,0,401,51,176,21,0,248,27.2,81,3,13.5,649,False,21,126,497,26,0,2024-08-09,False,False,False,0.765793528505393,0.1941448382126348,0.040061633281972264,0.0,Shoulder,Friday,August
2024-08-09 22:00:00,63,256,0,0,319,45,167,14,0,226,27.1,83,3,10.4,545,False,22,108,423,14,0,2024-08-09,False,False,False,0.7761467889908257,0.1981651376146789,0.025688073394495414,0.0,Shoulder,Friday,August
2024-08-09 23:00:00,61,225,0,0,286,34,161,8,0,203,26.8,86,3,9.4,489,False,23,95,386,8,0,2024-08-09,False,False,False,0.7893660531697342,0.19427402862985685,0.016359918200409,0.0,Shoulder,Friday,August
2024-08-10 00:00:00,43,277,0,0,320,43,192,1,0,236,26.2,89,3,7.2,556,True,0,86,469,1,0,2024-08-10,False,False,False,0.8435251798561151,0.15467625899280577,0.0017985611510791368,0.0,Off-Peak,Saturday,August
2024-08-10 01:00:00,45,228,0,0,273,48,167,3,0,218,25.5,93,3,6.2,491,True,1,93,395,3,0,2024-08-10,False,False,False,0.8044806517311609,0.1894093686354379,0.006109979633401222,0.0,Off-Peak,Saturday,August
2024-08-10 02:00:00,56,246,0,0,302,54,175,7,0,236,25.2,94,3,5.6,538,True,2,110,421,7,0,2024-08-10,False,False,False,0.7825278810408922,0.20446096654275092,0.013011152416356878,0.0,Off-Peak,Saturday,August
2024-08-10 03:00:00,67,265,0,0,332,65,181,10,0,256,24.8,96,3,2.7,588,True,3,132,446,10,0,2024-08-10,False,False,False,0.7585034013605442,0.22448979591836735,0.017006802721088437,0.0,Off-Peak,Saturday,August
2024-08-10 04:00:00,74,383,0,0,457,72,199,13,0,284,25.0,94,3,2.3,741,True,4,146,582,13,0,2024-08-10,False,False,False,0.7854251012145749,0.1970310391363023,0.017543859649122806,0.0,Off-Peak,Saturday,August
2024-08-10 05:00:00,88,396,0,0,484,86,247,14,0,347,24.6,96,3,2.3,831,True,5,174,643,14,0,2024-08-10,False,False,False,0.7737665463297232,0.20938628158844766,0.01684717208182912,0.0,Shoulder,Saturday,August
2024-08-10 06:00:00,95,438,10,2,545,95,386,16,2,499,24.6,96,3,2.0,1044,True,6,190,824,26,4,2024-08-10,False,False,False,0.789272030651341,0.18199233716475097,0.02490421455938697,0.0038314176245210726,Shoulder,Saturday,August
2024-08-10 07:00:00,102,455,13,3,573,101,375,20,3,499,24.6,98,3,3.4,1072,True,7,203,830,33,6,2024-08-10,False,False,False,0.7742537313432836,0.18936567164179105,0.030783582089552237,0.005597014925373134,Peak,Saturday,August
2024-08-10 08:00:00,116,442,14,3,575,97,329,23,5,454,24.9,97,3,2.7,1029,True,8,213,771,37,8,2024-08-10,False,False,False,0.749271137026239,0.20699708454810495,0.03595724003887269,0.007774538386783284,Peak,Saturday,August
2024-08-10 09:00:00,92,437,16,5,550,84,294,29,7,414,26.9,86,3,6.0,964,True,9,176,731,45,12,2024-08-10,False,False,False,0.758298755186722,0.1825726141078838,0.046680497925311204,0.012448132780082987,Shoulder,Saturday,August
2024-08-10 10:00:00,81,429,18,3,531,75,260,31,5,371,28.4,79,3,5.4,902,True,10,156,689,49,8,2024-08-10,False,False,False,0.7638580931263859,0.1729490022172949,0.05432372505543237,0.008869179600886918,Shoulder,Saturday,August
2024-08-10 11:00:00,85,374,17,4,480,63,236,33,4,336,29.1,75,53,11.2,816,True,11,148,610,50,8,2024-08-10,False,False,False,0.7475490196078431,0.18137254901960784,0.061274509803921566,0.00980392156862745,Peak,Saturday,August
2024-08-10 12:00:00,101,395,18,2,516,109,274,32,3,418,29.1,79,53,10.7,934,True,12,210,669,50,5,2024-08-10,False,False,False,0.7162740899357601,0.22483940042826553,0.05353319057815846,0.0053533190578158455,Peak,Saturday,August
2024-08-10 13:00:00,97,368,20,5,490,96,329,26,4,455,30.1,74,51,9.8,945,True,13,193,697,46,9,2024-08-10,False,False,False,0.7375661375661375,0.20423280423280424,0.04867724867724868,0.009523809523809525,Peak,Saturday,August
2024-08-10 14:00:00,85,356,22,3,466,87,316,21,2,426,30.2,71,2,10.2,892,True,14,172,672,43,5,2024-08-10,False,False,False,0.7533632286995515,0.19282511210762332,0.04820627802690583,0.005605381165919282,Peak,Saturday,August
2024-08-10 15:00:00,94,387,23,2,506,76,325,15,1,417,30.1,70,3,12.3,923,True,15,170,712,38,3,2024-08-10,False,False,False,0.771397616468039,0.18418201516793067,0.041170097508125676,0.0032502708559046588,Peak,Saturday,August
2024-08-10 16:00:00,124,390,16,2,532,102,343,30,5,480,29.7,74,53,13.8,1012,True,16,226,733,46,7,2024-08-10,False,False,False,0.724308300395257,0.22332015810276679,0.045454545454545456,0.00691699604743083,Peak,Saturday,August
2024-08-10 17:00:00,112,366,15,1,494,116,314,32,4,466,29.5,75,3,12.8,960,True,17,228,680,47,5,2024-08-10,False,False,False,0.7083333333333334,0.2375,0.04895833333333333,0.005208333333333333,Peak,Saturday,August
2024-08-10 18:00:00,105,327,13,0,445,98,277,31,2,408,28.9,78,3,10.2,853,True,18,203,604,44,2,2024-08-10,False,False,False,0.7080890973036342,0.23798358733880423,0.05158264947245018,0.0023446658851113715,Peak,Saturday,August
2024-08-10 19:00:00,94,298,14,0,406,95,231,28,1,355,28.4,79,3,7.9,761,True,19,189,529,42,1,2024-08-10,False,False,False,0.695137976346912,0.2483574244415243,0.05519053876478318,0.001314060446780552,Peak,Saturday,August
2024-08-10 20:00:00,82,285,11,0,378,89,193,25,0,307,27.5,84,2,8.3,685,True,20,171,478,36,0,2024-08-10,False,False,False,0.6978102189781021,0.24963503649635035,0.052554744525547446,0.0,Shoulder,Saturday,August
2024-08-10 21:00:00,73,269,6,0,348,63,187,18,0,268,26.5,86,53,6.6,616,True,21,136,456,24,0,2024-08-10,False,False,False,0.7402597402597403,0.22077922077922077,0.03896103896103896,0.0,Shoulder,Saturday,August
2024-08-10 22:00:00,61,248,0,0,309,57,177,11,0,245,26.6,90,3,4.1,554,True,22,118,425,11,0,2024-08-10,False,False,False,0.7671480144404332,0.21299638989169675,0.019855595667870037,0.0,Shoulder,Saturday,August
2024-08-10 23:00:00,56,237,0,0,293,46,171,6,0,223,26.3,92,1,5.0,516,True,23,102,408,6,0,2024-08-10,False,False,False,0.7906976744186046,0.19767441860465115,0.011627906976744186,0.0,Shoulder,Saturday,August
2024-08-11 00:00:00,64,287,0,0,351,64,194,3,0,261,26.1,93,3,4.8,612,True,0,128,481,3,0,2024-08-11,False,True,False,0.7859477124183006,0.20915032679738563,0.004901960784313725,0.0,Off-Peak,Sunday,August
2024-08-11 01:00:00,58,248,0,0,306,68,176,5,0,249,26.4,91,3,1.5,555,True,1,126,424,5,0,2024-08-11,False,True,False,0.7639639639639639,0.22702702702702704,0.009009009009009009,0.0,Off-Peak,Sunday,August
2024-08-11 02:00:00,56,256,0,0,312,65,187,8,0,260,26.2,93,3,1.3,572,True,2,121,443,8,0,2024-08-11,False,True,False,0.7744755244755245,0.21153846153846154,0.013986013986013986,0.0,Off-Peak,Sunday,August
2024-08-11 03:00:00,67,263,0,0,330,76,182,11,0,269,25.5,96,3,1.9,599,True,3,143,445,11,0,2024-08-11,False,True,False,0.7429048414023373,0.2387312186978297,0.018363939899833055,0.0,Off-Peak,Sunday,August
2024-08-11 04:00:00,74,394,0,0,468,87,210,14,0,311,24.4,98,65,10.4,779,True,4,161,604,14,0,2024-08-11,False,True,False,0.7753530166880617,0.20667522464698332,0.01797175866495507,0.0,Off-Peak,Sunday,August
2024-08-11 05:00:00,88,425,0,0,513,96,248,15,0,359,24.5,97,51,3.2,872,True,5,184,673,15,0,2024-08-11,False,True,False,0.7717889908256881,0.21100917431192662,0.017201834862385322,0.0,Shoulder,Sunday,August
2024-08-11 06:00:00,99,446,12,0,557,129,376,24,3,532,24.5,96,61,3.3,1089,True,6,228,822,36,3,2024-08-11,False,True,False,0.7548209366391184,0.209366391184573,0.03305785123966942,0.0027548209366391185,Shoulder,Sunday,August
2024-08-11 07:00:00,98,463,14,2,577,137,355,21,2,515,24.1,96,61,8.9,1092,True,7,235,818,35,4,2024-08-11,False,True,False,0.7490842490842491,0.21520146520146521,0.03205128205128205,0.003663003663003663,Peak,Sunday,August
2024-08-11 08:00:00,97,451,15,3,566,115,330,23,6,474,24.6,94,65,9.0,1040,True,8,212,781,38,9,2024-08-11,False,True,False,0.7509615384615385,0.20384615384615384,0.03653846153846154,0.008653846153846154,Peak,Sunday,August
2024-08-11 09:00:00,93,436,18,4,551,98,284,32,4,418,26.1,89,51,11.2,969,True,9,191,720,50,8,2024-08-11,False,True,False,0.7430340557275542,0.19711042311661506,0.05159958720330237,0.008255933952528379,Shoulder,Sunday,August
2024-08-11 10:00:00,89,430,20,4,543,85,265,33,6,389,26.3,86,63,13.0,932,True,10,174,695,53,10,2024-08-11,False,True,False,0.7457081545064378,0.18669527896995708,0.05686695278969957,0.01072961373390558,Shoulder,Sunday,August
2024-08-11 11:00:00,87,384,19,5,495,96,256,35,3,390,26.9,86,53,8.9,885,True,11,183,640,54,8,2024-08-11,False,True,False,0.7231638418079096,0.20677966101694914,0.061016949152542375,0.00903954802259887,Peak,Sunday,August
2024-08-11 12:00:00,96,397,17,2,512,129,328,32,4,493,27.7,81,51,12.0,1005,True,12,225,725,49,6,2024-08-11,False,True,False,0.7213930348258707,0.22388059701492538,0.04875621890547264,0.005970149253731343,Peak,Sunday,August
2024-08-11 13:00:00,94,369,21,4,488,118,319,27,3,467,28.5,79,51,10.6,955,True,13,212,688,48,7,2024-08-11,False,True,False,0.7204188481675393,0.22198952879581152,0.050261780104712044,0.007329842931937173,Peak,Sunday,August
2024-08-11 14:00:00,82,358,23,3,466,97,306,22,3,428,27.2,83,63,7.4,894,True,14,179,664,45,6,2024-08-11,False,True,False,0.7427293064876958,0.20022371364653244,0.050335570469798654,0.006711409395973154,Peak,Sunday,August
2024-08-11 15:00:00,87,385,24,3,499,108,315,16,2,441,27.6,80,51,4.7,940,True,15,195,700,40,5,2024-08-11,False,True,False,0.7446808510638298,0.2074468085106383,0.0425531914893617,0.005319148936170213,Peak,Sunday,August
2024-08-11 16:00:00,94,394,16,2,506,146,354,31,4,535,28.3,78,3,5.8,1041,True,16,240,748,47,6,2024-08-11,False,True,False,0.7185398655139289,0.23054755043227665,0.04514889529298751,0.005763688760806916,Peak,Sunday,August
2024-08-11 17:00:00,98,373,14,1,486,121,310,33,3,467,28.4,76,3,5.4,953,True,17,219,683,47,4,2024-08-11,False,True,False,0.7166841552990556,0.229800629590766,0.04931794333683106,0.004197271773347324,Peak,Sunday,August
2024-08-11 18:00:00,97,336,13,0,446,98,267,32,3,400,28.0,78,3,4.7,846,True,18,195,603,45,3,2024-08-11,False,True,False,0.7127659574468085,0.23049645390070922,0.05319148936170213,0.0035460992907801418,Peak,Sunday,August
2024-08-11 19:00:00,88,299,11,0,398,96,234,29,2,361,27.3,86,3,2.2,759,True,19,184,533,40,2,2024-08-11,False,True,False,0.7022397891963109,0.24242424242424243,0.052700922266139656,0.002635046113306983,Peak,Sunday,August
2024-08-11 20:00:00,74,295,10,0,379,87,195,26,0,308,26.5,89,3,3.4,687,True,20,161,490,36,0,2024-08-11,False,True,False,0.7132459970887919,0.23435225618631733,0.05240174672489083,0.0,Shoulder,Sunday,August
2024-08-11 21:00:00,65,279,8,0,352,76,186,19,0,281,25.4,90,3,6.9,633,True,21,141,465,27,0,2024-08-11,False,True,False,0.7345971563981043,0.22274881516587677,0.04265402843601896,0.0,Shoulder,Sunday,August
2024-08-11 22:00:00,62,268,0,0,330,67,178,12,0,257,24.9,91,3,5.2,587,True,22,129,446,12,0,2024-08-11,False,True,False,0.7597955706984668,0.21976149914821125,0.020442930153321975,0.0,Shoulder,Sunday,August
2024-08-11 23:00:00,58,257,0,0,315,66,172,7,0,245,24.5,95,3,4.4,560,True,23,124,429,7,0,2024-08-11,False,True,False,0.7660714285714286,0.22142857142857142,0.0125,0.0,Shoulder,Sunday,August
2024-08-12 00:00:00,56,236,0,0,292,39,186,3,0,228,24.8,92,3,2.1,520,False,0,95,422,3,0,2024-08-12,False,False,False,0.8115384615384615,0.18269230769230768,0.0057692307692307696,0.0,Off-Peak,Monday,August
2024-08-12 01:00:00,68,227,0,0,295,43,165,5,0,213,25.1,91,3,4.8,508,False,1,111,392,5,0,2024-08-12,False,False,False,0.7716535433070866,0.21850393700787402,0.00984251968503937,0.0,Off-Peak,Monday,August
2024-08-12 02:00:00,70,222,0,0,292,47,173,7,0,227,25.4,90,3,5.6,519,False,2,117,395,7,0,2024-08-12,False,False,False,0.7610789980732178,0.2254335260115607,0.01348747591522158,0.0,Off-Peak,Monday,August
2024-08-12 03:00:00,74,219,4,0,297,54,180,11,0,245,25.3,91,3,3.6,542,False,3,128,399,15,0,2024-08-12,False,False,False,0.7361623616236163,0.23616236162361623,0.027675276752767528,0.0,Off-Peak,Monday,August
2024-08-12 04:00:00,87,310,5,0,402,63,198,14,0,275,25.1,93,3,5.0,677,False,4,150,508,19,0,2024-08-12,False,False,False,0.7503692762186115,0.22156573116691286,0.028064992614475627,0.0,Off-Peak,Monday,August
2024-08-12 05:00:00,92,337,6,0,435,78,246,15,2,341,25.3,90,51,4.4,776,False,5,170,583,21,2,2024-08-12,False,False,False,0.7512886597938144,0.2190721649484536,0.027061855670103094,0.002577319587628866,Shoulder,Monday,August
2024-08-12 06:00:00,94,476,8,0,578,94,385,17,3,499,25.0,92,2,7.8,1077,False,6,188,861,25,3,2024-08-12,False,False,False,0.7994428969359332,0.1745589600742804,0.02321262766945218,0.002785515320334262,Shoulder,Monday,August
2024-08-12 07:00:00,118,517,11,3,649,91,374,23,7,495,24.3,93,3,8.3,1144,False,7,209,891,34,10,2024-08-12,False,False,False,0.7788461538461539,0.18269230769230768,0.02972027972027972,0.008741258741258742,Peak,Monday,August
2024-08-12 08:00:00,105,464,13,4,586,93,329,25,8,455,24.4,93,51,4.9,1041,False,8,198,793,38,12,2024-08-12,False,False,False,0.7617675312199808,0.19020172910662825,0.03650336215177714,0.011527377521613832,Peak,Monday,August
2024-08-12 09:00:00,88,457,17,3,565,84,284,29,11,408,26.4,87,1,2.3,973,False,9,172,741,46,14,2024-08-12,False,False,False,0.7615621788283659,0.17677286742034942,0.047276464542651594,0.014388489208633094,Shoulder,Monday,August
2024-08-12 10:00:00,75,445,19,2,541,75,263,32,4,374,28.1,79,51,7.1,915,False,10,150,708,51,6,2024-08-12,False,False,False,0.7737704918032787,0.16393442622950818,0.05573770491803279,0.006557377049180328,Shoulder,Monday,August
2024-08-12 11:00:00,90,428,23,1,542,62,238,34,2,336,29.1,74,51,9.2,878,False,11,152,666,57,3,2024-08-12,False,False,False,0.7585421412300684,0.17312072892938496,0.06492027334851937,0.003416856492027335,Peak,Monday,August
2024-08-12 12:00:00,97,512,25,5,639,89,324,37,3,453,29.7,72,1,11.3,1092,False,12,186,836,62,8,2024-08-12,False,False,False,0.7655677655677655,0.17032967032967034,0.056776556776556776,0.007326007326007326,Peak,Monday,August
2024-08-12 13:00:00,65,503,22,2,592,85,319,40,6,450,30.2,68,1,10.6,1042,False,13,150,822,62,8,2024-08-12,False,False,False,0.7888675623800384,0.14395393474088292,0.05950095969289827,0.007677543186180422,Peak,Monday,August
2024-08-12 14:00:00,74,455,21,3,553,76,306,39,3,424,30.5,66,2,10.8,977,False,14,150,761,60,6,2024-08-12,False,False,False,0.7789150460593655,0.1535312180143296,0.06141248720573183,0.006141248720573183,Peak,Monday,August
2024-08-12 15:00:00,97,426,19,4,546,65,305,37,8,415,30.6,64,3,9.6,961,False,15,162,731,56,12,2024-08-12,False,False,False,0.7606659729448492,0.16857440166493237,0.05827263267429761,0.012486992715920915,Peak,Monday,August
2024-08-12 16:00:00,116,467,17,2,602,91,347,33,5,476,30.4,63,3,9.4,1078,False,16,207,814,50,7,2024-08-12,False,False,False,0.7551020408163265,0.19202226345083487,0.04638218923933209,0.006493506493506494,Peak,Monday,August
2024-08-12 17:00:00,123,518,15,2,658,94,312,30,3,439,30.1,62,3,7.3,1097,False,17,217,830,45,5,2024-08-12,False,False,False,0.7566089334548769,0.19781221513217867,0.04102096627164995,0.004557885141294439,Peak,Monday,August
2024-08-12 18:00:00,109,503,9,2,623,85,286,38,2,411,29.4,66,3,4.7,1034,False,18,194,789,47,4,2024-08-12,False,False,False,0.7630560928433269,0.18762088974854932,0.045454545454545456,0.0038684719535783366,Peak,Monday,August
2024-08-12 19:00:00,98,414,6,1,519,73,230,25,3,331,28.2,79,3,3.4,850,False,19,171,644,31,4,2024-08-12,False,False,False,0.7576470588235295,0.2011764705882353,0.036470588235294116,0.004705882352941176,Peak,Monday,August
2024-08-12 20:00:00,94,356,5,0,455,66,188,22,1,277,27.3,77,3,6.2,732,False,20,160,544,27,1,2024-08-12,False,False,False,0.7431693989071039,0.2185792349726776,0.036885245901639344,0.001366120218579235,Shoulder,Monday,August
2024-08-12 21:00:00,88,325,0,0,413,52,185,19,0,256,27.8,75,3,10.1,669,False,21,140,510,19,0,2024-08-12,False,False,False,0.7623318385650224,0.20926756352765322,0.028400597907324365,0.0,Shoulder,Monday,August
2024-08-12 22:00:00,86,267,0,0,353,46,176,8,0,230,27.4,77,3,9.8,583,False,22,132,443,8,0,2024-08-12,False,False,False,0.7598627787307033,0.22641509433962265,0.0137221269296741,0.0,Shoulder,Monday,August
2024-08-12 23:00:00,75,224,0,0,299,43,171,7,0,221,27.1,81,3,10.9,520,False,23,118,395,7,0,2024-08-12,False,False,False,0.7596153846153846,0.22692307692307692,0.013461538461538462,0.0,Shoulder,Monday,August
2024-08-13 00:00:00,43,238,0,0,281,42,198,4,0,244,26.7,83,3,9.4,525,False,0,85,436,4,0,2024-08-13,False,False,False,0.8304761904761905,0.1619047619047619,0.007619047619047619,0.0,Off-Peak,Tuesday,August
2024-08-13 01:00:00,45,231,0,0,276,47,181,7,0,235,26.4,85,3,9.0,511,False,1,92,412,7,0,2024-08-13,False,False,False,0.8062622309197651,0.18003913894324852,0.0136986301369863,0.0,Off-Peak,Tuesday,August
2024-08-13 02:00:00,56,224,0,0,280,53,189,9,0,251,26.0,87,3,9.0,531,False,2,109,413,9,0,2024-08-13,False,False,False,0.7777777777777778,0.20527306967984935,0.01694915254237288,0.0,Off-Peak,Tuesday,August
2024-08-13 03:00:00,67,229,0,0,296,64,193,13,0,270,25.8,88,3,10.1,566,False,3,131,422,13,0,2024-08-13,False,False,False,0.7455830388692579,0.2314487632508834,0.022968197879858657,0.0,Off-Peak,Tuesday,August
2024-08-13 04:00:00,74,344,0,0,418,71,216,15,0,302,25.6,88,3,10.1,720,False,4,145,560,15,0,2024-08-13,False,False,False,0.7777777777777778,0.2013888888888889,0.020833333333333332,0.0,Off-Peak,Tuesday,August
2024-08-13 05:00:00,88,360,2,0,450,85,253,18,0,356,25.4,87,3,9.7,806,False,5,173,613,20,0,2024-08-13,False,False,False,0.760545905707196,0.21464019851116625,0.02481389578163772,0.0,Shoulder,Tuesday,August
2024-08-13 06:00:00,95,477,5,3,580,94,379,21,2,496,25.4,87,3,8.4,1076,False,6,189,856,26,5,2024-08-13,False,False,False,0.7955390334572491,0.17565055762081785,0.024163568773234202,0.004646840148698885,Shoulder,Tuesday,August
2024-08-13 07:00:00,102,519,7,4,632,98,358,24,3,483,25.4,85,3,8.6,1115,False,7,200,877,31,7,2024-08-13,False,False,False,0.7865470852017937,0.17937219730941703,0.02780269058295964,0.006278026905829596,Peak,Tuesday,August
2024-08-13 08:00:00,116,465,11,3,595,96,334,27,2,459,25.7,85,3,9.2,1054,False,8,212,799,38,5,2024-08-13,False,False,False,0.7580645161290323,0.20113851992409867,0.036053130929791274,0.004743833017077799,Peak,Tuesday,August
2024-08-13 09:00:00,92,459,12,5,568,84,287,33,5,409,27.2,80,1,9.2,977,False,9,176,746,45,10,2024-08-13,False,False,False,0.7635619242579325,0.18014329580348004,0.04605936540429888,0.01023541453428864,Shoulder,Tuesday,August
2024-08-13 10:00:00,81,447,14,7,549,73,268,35,4,380,28.6,74,3,12.2,929,False,10,154,715,49,11,2024-08-13,False,False,False,0.7696447793326158,0.16576964477933262,0.0527448869752422,0.011840688912809472,Shoulder,Tuesday,August
2024-08-13 11:00:00,85,430,17,6,538,62,259,42,2,365,29.6,68,2,13.2,903,False,11,147,689,59,8,2024-08-13,False,False,False,0.7630121816168328,0.16279069767441862,0.06533776301218161,0.008859357696566999,Peak,Tuesday,August
2024-08-13 12:00:00,102,514,20,7,643,106,331,44,3,484,29.9,66,51,14.5,1127,False,12,208,845,64,10,2024-08-13,False,False,False,0.7497781721384206,0.18456078083407276,0.05678793256433008,0.008873114463176575,Peak,Tuesday,August
2024-08-13 13:00:00,97,505,22,5,629,95,324,38,3,460,29.8,72,51,14.7,1089,False,13,192,829,60,8,2024-08-13,False,False,False,0.761248852157943,0.1763085399449036,0.05509641873278237,0.0073461891643709825,Peak,Tuesday,August
2024-08-13 14:00:00,85,457,21,3,566,86,319,36,5,446,29.7,71,51,15.8,1012,False,14,171,776,57,8,2024-08-13,False,False,False,0.766798418972332,0.16897233201581027,0.05632411067193676,0.007905138339920948,Peak,Tuesday,August
2024-08-13 15:00:00,94,428,17,2,541,74,336,32,3,445,28.2,81,63,9.5,986,False,15,168,764,49,5,2024-08-13,False,False,False,0.7748478701825557,0.17038539553752535,0.04969574036511156,0.005070993914807302,Peak,Tuesday,August
2024-08-13 16:00:00,124,469,15,1,609,81,365,43,2,491,28.6,77,51,11.8,1100,False,16,205,834,58,3,2024-08-13,False,False,False,0.7581818181818182,0.18636363636363637,0.05272727272727273,0.0027272727272727275,Peak,Tuesday,August
2024-08-13 17:00:00,112,521,12,2,647,103,321,37,3,464,29.1,74,3,12.2,1111,False,17,215,842,49,5,2024-08-13,False,False,False,0.7578757875787578,0.1935193519351935,0.04410441044104411,0.004500450045004501,Peak,Tuesday,August
2024-08-13 18:00:00,105,515,10,1,631,97,294,33,2,426,28.9,74,3,11.9,1057,False,18,202,809,43,3,2024-08-13,False,False,False,0.7653736991485336,0.19110690633869443,0.04068117313150426,0.002838221381267739,Peak,Tuesday,August
2024-08-13 19:00:00,94,471,7,0,572,84,252,25,0,361,28.1,78,3,8.3,933,False,19,178,723,32,0,2024-08-13,False,False,False,0.77491961414791,0.1907824222936763,0.03429796355841372,0.0,Peak,Tuesday,August
2024-08-13 20:00:00,82,368,5,0,455,78,196,22,0,296,26.9,84,1,8.9,751,False,20,160,564,27,0,2024-08-13,False,False,False,0.7509986684420772,0.21304926764314247,0.03595206391478029,0.0,Shoulder,Tuesday,August
2024-08-13 21:00:00,73,337,1,0,411,62,187,14,0,263,26.9,81,1,9.6,674,False,21,135,524,15,0,2024-08-13,False,False,False,0.7774480712166172,0.20029673590504452,0.02225519287833828,0.0,Shoulder,Tuesday,August
2024-08-13 22:00:00,61,279,0,0,340,56,175,7,0,238,26.9,83,3,13.0,578,False,22,117,454,7,0,2024-08-13,False,False,False,0.7854671280276817,0.20242214532871972,0.012110726643598616,0.0,Shoulder,Tuesday,August
2024-08-13 23:00:00,56,226,0,0,282,44,173,3,0,220,26.5,85,3,12.0,502,False,23,100,399,3,0,2024-08-13,False,False,False,0.7948207171314741,0.199203187250996,0.00597609561752988,0.0,Shoulder,Tuesday,August
2024-08-14 00:00:00,47,238,0,0,285,40,195,4,0,239,26.3,86,3,9.5,524,False,0,87,433,4,0,2024-08-14,False,False,False,0.8263358778625954,0.16603053435114504,0.007633587786259542,0.0,Off-Peak,Wednesday,August
2024-08-14 01:00:00,49,229,0,0,278,44,177,6,0,227,26.0,87,3,7.2,505,False,1,93,406,6,0,2024-08-14,False,False,False,0.803960396039604,0.18415841584158416,0.011881188118811881,0.0,Off-Peak,Wednesday,August
2024-08-14 02:00:00,54,224,0,0,278,48,189,8,0,245,25.4,90,3,4.2,523,False,2,102,413,8,0,2024-08-14,False,False,False,0.7896749521988528,0.1950286806883365,0.015296367112810707,0.0,Off-Peak,Wednesday,August
2024-08-14 03:00:00,58,221,0,0,279,55,183,12,0,250,25.1,90,3,6.6,529,False,3,113,404,12,0,2024-08-14,False,False,False,0.7637051039697542,0.21361058601134217,0.022684310018903593,0.0,Off-Peak,Wednesday,August
2024-08-14 04:00:00,66,312,0,0,378,64,231,14,0,309,25.2,89,3,8.3,687,False,4,130,543,14,0,2024-08-14,False,False,False,0.7903930131004366,0.18922852983988356,0.020378457059679767,0.0,Off-Peak,Wednesday,August
2024-08-14 05:00:00,68,339,1,0,408,79,259,17,0,355,25.4,88,3,9.8,763,False,5,147,598,18,0,2024-08-14,False,False,False,0.783748361730013,0.1926605504587156,0.023591087811271297,0.0,Shoulder,Wednesday,August
2024-08-14 06:00:00,80,478,4,1,563,95,377,21,1,494,25.3,88,3,9.4,1057,False,6,175,855,25,2,2024-08-14,False,False,False,0.8088930936613056,0.16556291390728478,0.023651844843897825,0.001892147587511826,Shoulder,Wednesday,August
2024-08-14 07:00:00,87,518,5,2,612,93,356,24,3,476,25.0,88,3,7.6,1088,False,7,180,874,29,5,2024-08-14,False,False,False,0.8033088235294118,0.16544117647058823,0.02665441176470588,0.004595588235294118,Peak,Wednesday,August
2024-08-14 08:00:00,110,466,9,4,589,94,331,27,4,456,25.5,88,3,8.3,1045,False,8,204,797,36,8,2024-08-14,False,False,False,0.7626794258373206,0.19521531100478468,0.03444976076555024,0.007655502392344498,Peak,Wednesday,August
2024-08-14 09:00:00,85,459,11,3,558,85,285,33,5,408,27.0,83,3,7.8,966,False,9,170,744,44,8,2024-08-14,False,False,False,0.7701863354037267,0.17598343685300208,0.045548654244306416,0.008281573498964804,Shoulder,Wednesday,August
2024-08-14 10:00:00,88,447,13,2,550,76,266,35,6,383,28.7,78,3,6.9,933,False,10,164,713,48,8,2024-08-14,False,False,False,0.7642015005359056,0.1757770632368703,0.05144694533762058,0.00857449088960343,Shoulder,Wednesday,August
2024-08-14 11:00:00,90,430,15,3,538,63,257,42,3,365,29.7,74,3,9.5,903,False,11,153,687,57,6,2024-08-14,False,False,False,0.760797342192691,0.16943521594684385,0.06312292358803986,0.006644518272425249,Peak,Wednesday,August
2024-08-14 12:00:00,107,514,14,4,639,90,329,44,4,467,30.4,72,3,13.0,1106,False,12,197,843,58,8,2024-08-14,False,False,False,0.7622061482820977,0.17811934900542495,0.05244122965641953,0.007233273056057866,Peak,Wednesday,August
2024-08-14 13:00:00,89,505,18,5,617,86,320,38,2,446,28.4,80,61,13.2,1063,False,13,175,825,56,7,2024-08-14,False,False,False,0.7761053621825024,0.16462841015992474,0.05268109125117592,0.00658513640639699,Peak,Wednesday,August
2024-08-14 14:00:00,87,457,13,2,559,77,307,36,2,422,28.5,79,51,13.8,981,False,14,164,764,49,4,2024-08-14,False,False,False,0.7787971457696228,0.1671763506625892,0.04994903160040775,0.004077471967380225,Peak,Wednesday,August
2024-08-14 15:00:00,93,428,11,1,533,68,316,32,1,417,29.3,78,51,15.4,950,False,15,161,744,43,2,2024-08-14,False,False,False,0.783157894736842,0.1694736842105263,0.045263157894736845,0.002105263157894737,Peak,Wednesday,August
2024-08-14 16:00:00,104,469,9,1,583,92,355,44,2,493,29.3,76,51,16.4,1076,False,16,196,824,53,3,2024-08-14,False,False,False,0.7657992565055762,0.1821561338289963,0.04925650557620818,0.0027881040892193307,Peak,Wednesday,August
2024-08-14 17:00:00,116,520,6,2,644,96,312,37,1,446,28.5,76,51,15.5,1090,False,17,212,832,43,3,2024-08-14,False,False,False,0.763302752293578,0.1944954128440367,0.03944954128440367,0.0027522935779816515,Peak,Wednesday,August
2024-08-14 18:00:00,83,504,4,1,592,88,268,33,0,389,27.0,84,51,12.2,981,False,18,171,772,37,1,2024-08-14,False,False,False,0.7869520897043832,0.1743119266055046,0.03771661569826707,0.0010193679918450561,Peak,Wednesday,August
2024-08-14 19:00:00,77,416,3,0,496,74,235,25,0,334,27.1,86,3,5.7,830,False,19,151,651,28,0,2024-08-14,False,False,False,0.7843373493975904,0.1819277108433735,0.033734939759036145,0.0,Peak,Wednesday,August
2024-08-14 20:00:00,68,358,2,0,428,67,196,22,0,285,26.7,89,3,7.6,713,False,20,135,554,24,0,2024-08-14,False,False,False,0.7769985974754559,0.18934081346423562,0.033660589060308554,0.0,Shoulder,Wednesday,August
2024-08-14 21:00:00,56,327,0,0,383,53,187,14,0,254,26.3,92,3,10.1,637,False,21,109,514,14,0,2024-08-14,False,False,False,0.8069073783359497,0.17111459968602827,0.02197802197802198,0.0,Shoulder,Wednesday,August
2024-08-14 22:00:00,55,266,0,0,321,47,179,7,0,233,26.0,92,3,10.1,554,False,22,102,445,7,0,2024-08-14,False,False,False,0.8032490974729242,0.18411552346570398,0.01263537906137184,0.0,Shoulder,Wednesday,August
2024-08-14 23:00:00,44,224,0,0,268,44,173,3,0,220,25.7,92,3,9.8,488,False,23,88,397,3,0,2024-08-14,False,False,False,0.8135245901639344,0.18032786885245902,0.006147540983606557,0.0,Shoulder,Wednesday,August
2024-08-15 00:00:00,64,237,0,0,301,41,195,4,0,240,25.4,93,3,9.3,541,False,0,105,432,4,0,2024-08-15,False,False,False,0.7985212569316081,0.19408502772643252,0.0073937153419593345,0.0,Off-Peak,Thursday,August
2024-08-15 01:00:00,67,230,0,0,297,44,182,6,0,232,25.1,94,3,8.0,529,False,1,111,412,6,0,2024-08-15,False,False,False,0.77882797731569,0.20982986767485823,0.011342155009451797,0.0,Off-Peak,Thursday,August
2024-08-15 02:00:00,69,223,0,0,292,48,190,8,0,246,24.9,95,3,6.9,538,False,2,117,413,8,0,2024-08-15,False,False,False,0.7676579925650557,0.2174721189591078,0.01486988847583643,0.0,Off-Peak,Thursday,August
2024-08-15 03:00:00,75,228,2,0,305,55,194,12,0,261,24.7,96,3,7.6,566,False,3,130,422,14,0,2024-08-15,False,False,False,0.7455830388692579,0.22968197879858657,0.024734982332155476,0.0,Off-Peak,Thursday,August
2024-08-15 04:00:00,79,343,3,0,425,64,217,14,0,295,24.6,96,3,7.6,720,False,4,143,560,17,0,2024-08-15,False,False,False,0.7777777777777778,0.1986111111111111,0.02361111111111111,0.0,Off-Peak,Thursday,August
2024-08-15 05:00:00,82,359,6,0,447,83,254,17,0,354,24.7,94,3,6.9,801,False,5,165,613,23,0,2024-08-15,False,False,False,0.7652933832709113,0.20599250936329588,0.02871410736579276,0.0,Shoulder,Thursday,August
2024-08-15 06:00:00,86,466,8,3,563,95,379,21,2,497,24.7,94,3,6.5,1060,False,6,181,845,29,5,2024-08-15,False,False,False,0.7971698113207547,0.17075471698113207,0.027358490566037737,0.0047169811320754715,Shoulder,Thursday,August
2024-08-15 07:00:00,88,513,9,5,615,93,358,24,4,479,24.5,94,51,7.4,1094,False,7,181,871,33,9,2024-08-15,False,False,False,0.7961608775137111,0.16544789762340037,0.03016453382084095,0.008226691042047532,Peak,Thursday,August
2024-08-15 08:00:00,90,464,12,3,569,94,335,27,3,459,24.8,94,3,7.9,1028,False,8,184,799,39,6,2024-08-15,False,False,False,0.7772373540856031,0.17898832684824903,0.037937743190661476,0.005836575875486381,Peak,Thursday,August
2024-08-15 09:00:00,96,458,16,4,574,85,288,33,6,412,26.5,87,51,6.7,986,False,9,181,746,49,10,2024-08-15,False,False,False,0.7565922920892495,0.18356997971602435,0.04969574036511156,0.010141987829614604,Shoulder,Thursday,August
2024-08-15 10:00:00,98,446,17,1,562,76,269,35,5,385,28.0,78,3,5.5,947,False,10,174,715,52,6,2024-08-15,False,False,False,0.7550158394931362,0.18373812038014783,0.054910242872228086,0.006335797254487857,Shoulder,Thursday,August
2024-08-15 11:00:00,101,429,19,2,551,63,260,42,2,367,29.1,75,3,7.6,918,False,11,164,689,61,4,2024-08-15,False,False,False,0.7505446623093682,0.1786492374727669,0.0664488017429194,0.004357298474945534,Peak,Thursday,August
2024-08-15 12:00:00,109,511,21,2,643,90,332,44,3,469,30.1,71,2,5.9,1112,False,12,199,843,65,5,2024-08-15,False,False,False,0.7580935251798561,0.1789568345323741,0.05845323741007194,0.0044964028776978415,Peak,Thursday,August
2024-08-15 13:00:00,130,505,23,4,662,86,325,38,3,452,30.8,69,3,8.3,1114,False,13,216,830,61,7,2024-08-15,False,False,False,0.7450628366247756,0.19389587073608616,0.05475763016157989,0.0062836624775583485,Peak,Thursday,August
2024-08-15 14:00:00,147,456,23,2,628,77,320,35,5,437,30.8,69,2,11.4,1065,False,14,224,776,58,7,2024-08-15,False,False,False,0.7286384976525822,0.21032863849765257,0.054460093896713614,0.006572769953051643,Peak,Thursday,August
2024-08-15 15:00:00,139,427,20,5,591,68,336,32,4,440,30.2,70,1,12.1,1031,False,15,207,763,52,9,2024-08-15,False,False,False,0.7400581959262852,0.20077594568380214,0.0504364694471387,0.008729388942774006,Peak,Thursday,August
2024-08-15 16:00:00,124,468,18,3,613,92,365,42,2,501,30.4,68,3,13.0,1114,False,16,216,833,60,5,2024-08-15,False,False,False,0.7477558348294434,0.19389587073608616,0.05385996409335727,0.004488330341113106,Peak,Thursday,August
2024-08-15 17:00:00,118,517,14,2,651,97,321,37,3,458,29.4,74,51,14.5,1109,False,17,215,838,51,5,2024-08-15,False,False,False,0.7556357078449053,0.19386834986474302,0.045987376014427414,0.004508566275924256,Peak,Thursday,August
2024-08-15 18:00:00,110,506,8,1,625,88,294,33,2,417,28.9,75,3,12.8,1042,False,18,198,800,41,3,2024-08-15,False,False,False,0.7677543186180422,0.19001919385796545,0.03934740882917467,0.0028790786948176585,Peak,Thursday,August
2024-08-15 19:00:00,96,467,7,2,572,74,252,25,0,351,28.1,79,3,6.6,923,False,19,170,719,32,2,2024-08-15,False,False,False,0.7789815817984832,0.18418201516793067,0.03466955579631636,0.0021668472372697724,Peak,Thursday,August
2024-08-15 20:00:00,92,380,3,0,475,67,196,22,0,285,27.3,83,3,5.2,760,False,20,159,576,25,0,2024-08-15,False,False,False,0.7578947368421053,0.20921052631578949,0.03289473684210526,0.0,Shoulder,Thursday,August
2024-08-15 21:00:00,87,326,0,0,413,53,187,14,0,254,27.8,82,3,13.0,667,False,21,140,513,14,0,2024-08-15,False,False,False,0.7691154422788605,0.2098950524737631,0.020989505247376312,0.0,Shoulder,Thursday,August
2024-08-15 22:00:00,83,279,0,0,362,47,175,7,0,229,27.5,84,3,12.5,591,False,22,130,454,7,0,2024-08-15,False,False,False,0.7681895093062606,0.21996615905245348,0.011844331641285956,0.0,Shoulder,Thursday,August
2024-08-15 23:00:00,81,215,0,0,296,44,173,3,0,220,27.3,85,3,9.3,516,False,23,125,388,3,0,2024-08-15,False,False,False,0.751937984496124,0.24224806201550386,0.005813953488372093,0.0,Shoulder,Thursday,August
2024-08-16 00:00:00,56,224,0,0,280,32,143,3,0,178,27.2,86,3,7.4,458,False,0,88,367,3,0,2024-08-16,False,False,False,0.8013100436681223,0.19213973799126638,0.006550218340611353,0.0,Off-Peak,Friday,August
2024-08-16 01:00:00,58,246,0,0,304,36,157,5,0,198,25.7,93,63,1.3,502,False,1,94,403,5,0,2024-08-16,False,False,False,0.8027888446215139,0.18725099601593626,0.0099601593625498,0.0,Off-Peak,Friday,August
2024-08-16 02:00:00,67,273,0,0,340,44,180,8,0,232,24.7,95,63,3.2,572,False,2,111,453,8,0,2024-08-16,False,False,False,0.791958041958042,0.19405594405594406,0.013986013986013986,0.0,Off-Peak,Friday,August
2024-08-16 03:00:00,64,317,0,0,381,49,188,11,0,248,24.6,96,3,3.1,629,False,3,113,505,11,0,2024-08-16,False,False,False,0.8028616852146264,0.17965023847376788,0.017488076311605722,0.0,Off-Peak,Friday,August
2024-08-16 04:00:00,73,335,0,0,408,59,196,14,0,269,24.4,97,51,5.0,677,False,4,132,531,14,0,2024-08-16,False,False,False,0.7843426883308715,0.19497784342688332,0.0206794682422452,0.0,Off-Peak,Friday,August
2024-08-16 05:00:00,87,366,0,0,453,63,210,15,0,288,23.8,97,53,7.2,741,False,5,150,576,15,0,2024-08-16,False,False,False,0.7773279352226721,0.20242914979757085,0.020242914979757085,0.0,Shoulder,Friday,August
2024-08-16 06:00:00,88,398,13,2,501,68,221,24,3,316,23.3,97,51,8.3,817,False,6,156,619,37,5,2024-08-16,False,False,False,0.7576499388004896,0.1909424724602203,0.04528763769889841,0.006119951040391677,Shoulder,Friday,August
2024-08-16 07:00:00,91,414,15,4,524,75,229,21,6,331,23.2,97,51,6.5,855,False,7,166,643,36,10,2024-08-16,False,False,False,0.752046783625731,0.19415204678362574,0.042105263157894736,0.011695906432748537,Peak,Friday,August
2024-08-16 08:00:00,93,422,16,3,534,82,263,23,5,373,23.6,96,3,5.4,907,False,8,175,685,39,8,2024-08-16,False,False,False,0.7552370452039692,0.19294377067254687,0.04299889746416759,0.008820286659316428,Peak,Friday,August
2024-08-16 09:00:00,96,437,19,3,555,84,296,32,7,419,24.3,94,53,7.6,974,False,9,180,733,51,10,2024-08-16,False,False,False,0.7525667351129364,0.18480492813141683,0.052361396303901436,0.01026694045174538,Shoulder,Friday,August
2024-08-16 10:00:00,112,438,21,2,573,76,308,33,8,425,24.9,91,61,6.2,998,False,10,188,746,54,10,2024-08-16,False,False,False,0.7474949899799599,0.18837675350701402,0.05410821643286573,0.01002004008016032,Shoulder,Friday,August
2024-08-16 11:00:00,105,425,20,2,552,72,314,35,5,426,26.2,89,51,6.6,978,False,11,177,739,55,7,2024-08-16,False,False,False,0.7556237218813906,0.18098159509202455,0.05623721881390593,0.007157464212678937,Peak,Friday,August
2024-08-16 12:00:00,93,417,18,2,530,69,322,32,4,427,28.5,79,3,0.5,957,False,12,162,739,50,6,2024-08-16,False,False,False,0.7722048066875653,0.16927899686520376,0.0522466039707419,0.006269592476489028,Peak,Friday,August
2024-08-16 13:00:00,92,412,20,3,527,67,233,27,4,331,29.7,71,3,5.8,858,False,13,159,645,47,7,2024-08-16,False,False,False,0.7517482517482518,0.1853146853146853,0.054778554778554776,0.008158508158508158,Peak,Friday,August
2024-08-16 14:00:00,95,423,22,2,542,65,246,22,3,336,29.8,68,51,11.2,878,False,14,160,669,44,5,2024-08-16,False,False,False,0.7619589977220956,0.18223234624145787,0.05011389521640091,0.0056947608200455585,Peak,Friday,August
2024-08-16 15:00:00,97,445,23,4,569,69,267,16,2,354,29.2,74,3,11.6,923,False,15,166,712,39,6,2024-08-16,False,False,False,0.771397616468039,0.17984832069339113,0.04225352112676056,0.0065005417118093175,Peak,Friday,August
2024-08-16 16:00:00,101,454,21,3,579,73,295,31,3,402,28.8,75,51,13.5,981,False,16,174,749,52,6,2024-08-16,False,False,False,0.763506625891947,0.17737003058103976,0.053007135575942915,0.0061162079510703364,Peak,Friday,August
2024-08-16 17:00:00,93,430,13,3,539,75,312,33,3,423,28.1,80,3,12.3,962,False,17,168,742,46,6,2024-08-16,False,False,False,0.7713097713097713,0.17463617463617465,0.04781704781704782,0.006237006237006237,Peak,Friday,August
2024-08-16 18:00:00,90,411,14,2,517,82,284,32,1,399,27.7,80,3,11.1,916,False,18,172,695,46,3,2024-08-16,False,False,False,0.7587336244541485,0.18777292576419213,0.05021834061135371,0.0032751091703056767,Peak,Friday,August
2024-08-16 19:00:00,89,352,12,1,454,76,263,28,0,367,27.7,80,3,10.4,821,False,19,165,615,40,1,2024-08-16,False,False,False,0.7490864799025578,0.20097442143727162,0.048721071863580996,0.001218026796589525,Peak,Friday,August
2024-08-16 20:00:00,88,313,11,0,412,70,225,25,0,320,27.2,82,3,9.2,732,False,20,158,538,36,0,2024-08-16,False,False,False,0.7349726775956285,0.21584699453551912,0.04918032786885246,0.0,Shoulder,Friday,August
2024-08-16 21:00:00,86,287,9,0,382,65,216,19,0,300,27.3,82,51,13.3,682,False,21,151,503,28,0,2024-08-16,False,False,False,0.7375366568914956,0.22140762463343108,0.04105571847507331,0.0,Shoulder,Friday,August
2024-08-16 22:00:00,84,244,0,0,328,57,197,12,0,266,26.9,84,2,11.2,594,False,22,141,441,12,0,2024-08-16,False,False,False,0.7424242424242424,0.23737373737373738,0.020202020202020204,0.0,Shoulder,Friday,August
2024-08-16 23:00:00,75,210,0,0,285,48,189,7,0,244,26.7,87,51,5.9,529,False,23,123,399,7,0,2024-08-16,False,False,False,0.7542533081285444,0.23251417769376181,0.013232514177693762,0.0,Shoulder,Friday,August
2024-08-17 00:00:00,75,256,0,0,331,66,185,11,0,262,26.0,92,3,3.3,593,True,0,141,441,11,0,2024-08-17,False,False,False,0.7436762225969646,0.23777403035413153,0.01854974704890388,0.0,Off-Peak,Saturday,August
2024-08-17 01:00:00,78,249,0,0,327,70,178,12,0,260,25.7,93,3,6.1,587,True,1,148,427,12,0,2024-08-17,False,False,False,0.727427597955707,0.252129471890971,0.020442930153321975,0.0,Off-Peak,Saturday,August
2024-08-17 02:00:00,80,228,0,0,308,67,166,15,0,248,25.2,94,3,5.7,556,True,2,147,394,15,0,2024-08-17,False,False,False,0.7086330935251799,0.2643884892086331,0.02697841726618705,0.0,Off-Peak,Saturday,August
2024-08-17 03:00:00,83,223,0,0,306,78,259,18,0,355,25.1,94,3,7.1,661,True,3,161,482,18,0,2024-08-17,False,False,False,0.7291981845688351,0.24357034795763993,0.02723146747352496,0.0,Off-Peak,Saturday,August
2024-08-17 04:00:00,87,330,0,0,417,89,293,21,4,407,24.5,94,55,4.9,824,True,4,176,623,21,4,2024-08-17,False,False,False,0.7560679611650486,0.21359223300970873,0.025485436893203883,0.0048543689320388345,Off-Peak,Saturday,August
2024-08-17 05:00:00,92,361,4,0,457,98,468,23,8,597,25.0,94,51,5.0,1054,True,5,190,829,27,8,2024-08-17,False,False,False,0.786527514231499,0.18026565464895636,0.025616698292220113,0.007590132827324478,Shoulder,Saturday,August
2024-08-17 06:00:00,94,500,17,3,614,131,475,26,12,644,25.1,95,3,4.7,1258,True,6,225,975,43,15,2024-08-17,False,False,False,0.775039745627981,0.17885532591414943,0.03418124006359301,0.01192368839427663,Shoulder,Saturday,August
2024-08-17 07:00:00,98,521,19,4,642,139,439,30,14,622,24.7,97,3,6.2,1264,True,7,237,960,49,18,2024-08-17,False,False,False,0.759493670886076,0.1875,0.038765822784810125,0.014240506329113924,Peak,Saturday,August
2024-08-17 08:00:00,97,508,20,3,628,117,417,36,11,581,24.8,95,3,6.1,1209,True,8,214,925,56,14,2024-08-17,False,False,False,0.7650951199338296,0.17700578990901572,0.04631927212572374,0.011579818031430935,Peak,Saturday,August
2024-08-17 09:00:00,106,491,23,5,625,100,367,39,13,519,25.7,95,51,7.0,1144,True,9,206,858,62,18,2024-08-17,False,False,False,0.75,0.18006993006993008,0.05419580419580419,0.015734265734265736,Shoulder,Saturday,August
2024-08-17 10:00:00,114,466,25,7,612,87,348,47,10,492,26.9,89,3,4.3,1104,True,10,201,814,72,17,2024-08-17,False,False,False,0.7373188405797102,0.18206521739130435,0.06521739130434782,0.015398550724637682,Shoulder,Saturday,August
2024-08-17 11:00:00,128,458,24,6,616,98,354,49,9,510,28.6,80,3,6.9,1126,True,11,226,812,73,15,2024-08-17,False,False,False,0.7211367673179396,0.20071047957371227,0.06483126110124333,0.013321492007104795,Peak,Saturday,August
2024-08-17 12:00:00,136,550,22,7,715,131,385,41,8,565,29.6,75,3,9.4,1280,True,12,267,935,63,15,2024-08-17,False,False,False,0.73046875,0.20859375,0.04921875,0.01171875,Peak,Saturday,August
2024-08-17 13:00:00,155,581,24,5,765,120,379,38,12,549,30.0,73,51,9.8,1314,True,13,275,960,62,17,2024-08-17,False,False,False,0.730593607305936,0.20928462709284626,0.0471841704718417,0.01293759512937595,Peak,Saturday,August
2024-08-17 14:00:00,154,536,26,6,722,99,357,30,10,496,29.5,73,51,9.6,1218,True,14,253,893,56,16,2024-08-17,False,False,False,0.7331691297208539,0.2077175697865353,0.04597701149425287,0.013136288998357963,Peak,Saturday,August
2024-08-17 15:00:00,137,528,27,2,694,110,363,38,13,524,29.7,75,51,10.1,1218,True,15,247,891,65,15,2024-08-17,False,False,False,0.7315270935960592,0.20279146141215107,0.053366174055829226,0.012315270935960592,Peak,Saturday,August
2024-08-17 16:00:00,129,611,25,1,766,148,498,39,11,696,28.8,80,61,9.7,1462,True,16,277,1109,64,12,2024-08-17,False,False,True,0.7585499316005472,0.18946648426812585,0.04377564979480164,0.008207934336525308,Peak,Saturday,August
2024-08-17 17:00:00,115,585,17,2,719,123,461,49,9,642,28.8,79,51,10.4,1361,True,17,238,1046,66,11,2024-08-17,False,False,False,0.7685525349008082,0.17487141807494488,0.048493754592211606,0.008082292432035268,Peak,Saturday,August
2024-08-17 18:00:00,106,520,18,1,645,102,443,46,10,601,28.1,81,53,11.1,1246,True,18,208,963,64,11,2024-08-17,False,False,False,0.7728731942215088,0.16693418940609953,0.051364365971107544,0.00882825040128411,Peak,Saturday,August
2024-08-17 19:00:00,98,426,14,0,538,98,437,41,9,585,27.6,85,51,7.2,1123,True,19,196,863,55,9,2024-08-17,False,False,False,0.7684772929652716,0.1745325022261799,0.048975957257346395,0.008014247551202136,Peak,Saturday,August
2024-08-17 20:00:00,96,409,13,0,518,89,429,40,8,566,27.0,88,3,6.4,1084,True,20,185,838,53,8,2024-08-17,False,False,False,0.7730627306273062,0.1706642066420664,0.048892988929889296,0.007380073800738007,Shoulder,Saturday,August
2024-08-17 21:00:00,94,342,11,0,447,78,385,37,6,506,26.6,84,1,9.0,953,True,21,172,727,48,6,2024-08-17,False,False,False,0.7628541448058762,0.18048268625393493,0.05036726128016789,0.0062959076600209865,Shoulder,Saturday,August
2024-08-17 22:00:00,85,318,0,0,403,69,298,31,4,402,26.4,86,3,7.2,805,True,22,154,616,31,4,2024-08-17,False,False,False,0.7652173913043478,0.19130434782608696,0.03850931677018633,0.004968944099378882,Shoulder,Saturday,August
2024-08-17 23:00:00,83,249,0,0,332,68,287,28,0,383,26.1,87,2,8.5,715,True,23,151,536,28,0,2024-08-17,False,False,False,0.7496503496503496,0.2111888111888112,0.039160839160839164,0.0,Shoulder,Saturday,August
2024-08-18 00:00:00,45,242,0,0,287,63,162,6,0,231,25.8,88,3,7.9,518,True,0,108,404,6,0,2024-08-18,False,False,False,0.7799227799227799,0.2084942084942085,0.011583011583011582,0.0,Off-Peak,Sunday,August
2024-08-18 01:00:00,47,213,0,0,260,67,155,7,0,229,25.8,88,0,8.2,489,True,1,114,368,7,0,2024-08-18,False,False,False,0.7525562372188139,0.2331288343558282,0.014314928425357873,0.0,Off-Peak,Sunday,August
2024-08-18 02:00:00,52,231,0,0,283,64,143,11,0,218,25.3,91,1,6.5,501,True,2,116,374,11,0,2024-08-18,False,False,False,0.7465069860279441,0.2315369261477046,0.021956087824351298,0.0,Off-Peak,Sunday,August
2024-08-18 03:00:00,56,240,0,0,296,75,136,15,0,226,25.0,92,0,5.5,522,True,3,131,376,15,0,2024-08-18,False,False,False,0.7203065134099617,0.2509578544061303,0.028735632183908046,0.0,Off-Peak,Sunday,August
2024-08-18 04:00:00,64,258,6,0,328,86,170,18,0,274,24.7,94,0,5.2,602,True,4,150,428,24,0,2024-08-18,False,False,False,0.7109634551495017,0.24916943521594684,0.03986710963455149,0.0,Off-Peak,Sunday,August
2024-08-18 05:00:00,66,331,7,0,404,95,275,23,0,393,24.5,94,1,5.9,797,True,5,161,606,30,0,2024-08-18,False,False,False,0.7603513174404015,0.20200752823086573,0.037641154328732745,0.0,Shoulder,Sunday,August
2024-08-18 06:00:00,78,346,8,3,435,128,352,31,3,514,24.3,95,1,5.4,949,True,6,206,698,39,6,2024-08-18,False,False,False,0.7355110642781876,0.21707060063224448,0.0410958904109589,0.006322444678609062,Shoulder,Sunday,August
2024-08-18 07:00:00,95,335,10,5,445,135,361,26,6,528,24.2,95,2,7.2,973,True,7,230,696,36,11,2024-08-18,False,False,False,0.7153134635149023,0.23638232271325796,0.03699897225077081,0.011305241521068859,Peak,Sunday,August
2024-08-18 08:00:00,99,322,14,3,438,114,375,27,5,521,24.6,93,51,4.4,959,True,8,213,697,41,8,2024-08-18,False,False,False,0.7267987486965589,0.22210636079249219,0.04275286757038582,0.008342022940563087,Peak,Sunday,August
2024-08-18 09:00:00,83,318,16,4,421,98,347,32,4,481,26.8,84,1,6.8,902,True,9,181,665,48,8,2024-08-18,False,False,False,0.7372505543237251,0.2006651884700665,0.05321507760532151,0.008869179600886918,Shoulder,Sunday,August
2024-08-18 10:00:00,86,330,19,1,436,85,333,33,7,458,28.5,76,1,10.2,894,True,10,171,663,52,8,2024-08-18,False,False,False,0.7416107382550335,0.1912751677852349,0.058165548098434,0.008948545861297539,Shoulder,Sunday,August
2024-08-18 11:00:00,88,349,22,2,461,96,321,35,5,457,29.4,72,51,11.8,918,True,11,184,670,57,7,2024-08-18,False,False,False,0.7298474945533769,0.20043572984749455,0.06209150326797386,0.007625272331154684,Peak,Sunday,August
2024-08-18 12:00:00,103,361,27,2,493,127,355,38,4,524,30.1,70,1,11.9,1017,True,12,230,716,65,6,2024-08-18,False,False,False,0.704031465093412,0.22615535889872174,0.063913470993117,0.0058997050147492625,Peak,Sunday,August
2024-08-18 13:00:00,87,345,24,4,460,118,347,36,6,507,30.3,70,51,12.7,967,True,13,205,692,60,10,2024-08-18,False,False,False,0.7156153050672182,0.21199586349534644,0.06204756980351603,0.010341261633919338,Peak,Sunday,August
2024-08-18 14:00:00,85,328,21,2,436,97,344,39,3,483,30.6,69,3,12.9,919,True,14,182,672,60,5,2024-08-18,False,False,False,0.7312295973884657,0.19804134929270947,0.06528835690968444,0.00544069640914037,Peak,Sunday,August
2024-08-18 15:00:00,92,334,19,5,450,108,330,43,2,483,30.4,71,3,13.0,933,True,15,200,664,62,7,2024-08-18,False,False,False,0.7116827438370846,0.21436227224008575,0.06645230439442658,0.007502679528403001,Peak,Sunday,August
2024-08-18 16:00:00,102,342,16,3,463,144,385,45,3,577,30.0,72,51,13.2,1040,True,16,246,727,61,6,2024-08-18,False,False,False,0.6990384615384615,0.23653846153846153,0.058653846153846154,0.0057692307692307696,Peak,Sunday,August
2024-08-18 17:00:00,114,311,14,2,441,121,412,50,3,586,29.4,72,51,12.8,1027,True,17,235,723,64,5,2024-08-18,False,False,False,0.7039922103213242,0.22882181110029212,0.062317429406037,0.004868549172346641,Peak,Sunday,August
2024-08-18 18:00:00,81,307,11,1,400,98,417,36,1,552,29.1,73,3,11.7,952,True,18,179,724,47,2,2024-08-18,False,False,False,0.7605042016806722,0.1880252100840336,0.04936974789915966,0.0021008403361344537,Peak,Sunday,August
2024-08-18 19:00:00,75,263,8,2,348,93,404,27,0,524,28.1,78,51,9.3,872,True,19,168,667,35,2,2024-08-18,False,False,False,0.7649082568807339,0.1926605504587156,0.040137614678899085,0.0022935779816513763,Peak,Sunday,August
2024-08-18 20:00:00,66,240,6,0,312,85,396,20,0,501,27.6,82,1,6.4,813,True,20,151,636,26,0,2024-08-18,False,False,False,0.7822878228782287,0.1857318573185732,0.03198031980319803,0.0,Shoulder,Sunday,August
2024-08-18 21:00:00,54,224,3,0,281,76,362,18,0,456,28.3,74,3,11.5,737,True,21,130,586,21,0,2024-08-18,False,False,False,0.7951153324287653,0.17639077340569878,0.028493894165535955,0.0,Shoulder,Sunday,August
2024-08-18 22:00:00,53,213,0,0,266,68,295,16,0,379,28.0,78,3,10.3,645,True,22,121,508,16,0,2024-08-18,False,False,False,0.7875968992248062,0.1875968992248062,0.024806201550387597,0.0,Shoulder,Sunday,August
2024-08-18 23:00:00,42,171,0,0,213,65,274,13,0,352,27.5,82,1,12.0,565,True,23,107,445,13,0,2024-08-18,False,False,False,0.7876106194690266,0.18938053097345134,0.023008849557522124,0.0,Shoulder,Sunday,August
2024-08-19 00:00:00,40,247,0,0,287,63,187,5,0,255,27.2,85,0,13.0,542,False,0,103,434,5,0,2024-08-19,False,False,False,0.8007380073800738,0.1900369003690037,0.00922509225092251,0.0,Off-Peak,Monday,August
2024-08-19 01:00:00,42,218,0,0,260,66,156,8,0,230,26.7,87,1,9.7,490,False,1,108,374,8,0,2024-08-19,False,False,False,0.763265306122449,0.22040816326530613,0.0163265306122449,0.0,Off-Peak,Monday,August
2024-08-19 02:00:00,47,236,0,0,283,70,162,9,0,241,26.2,90,0,8.3,524,False,2,117,398,9,0,2024-08-19,False,False,False,0.7595419847328244,0.22328244274809161,0.01717557251908397,0.0,Off-Peak,Monday,August
2024-08-19 03:00:00,51,275,0,0,326,78,178,11,0,267,25.7,93,3,5.8,593,False,3,129,453,11,0,2024-08-19,False,False,False,0.7639123102866779,0.2175379426644182,0.01854974704890388,0.0,Off-Peak,Monday,August
2024-08-19 04:00:00,59,293,5,0,357,85,197,13,0,295,25.2,94,3,4.5,652,False,4,144,490,18,0,2024-08-19,False,False,False,0.7515337423312883,0.22085889570552147,0.027607361963190184,0.0,Off-Peak,Monday,August
2024-08-19 05:00:00,65,346,8,0,419,97,234,17,0,348,24.9,95,3,4.2,767,False,5,162,580,25,0,2024-08-19,False,False,False,0.7561929595827901,0.21121251629726207,0.03259452411994785,0.0,Shoulder,Monday,August
2024-08-19 06:00:00,78,371,7,2,458,113,247,21,2,383,24.5,96,3,3.7,841,False,6,191,618,28,4,2024-08-19,False,False,False,0.7348394768133175,0.22711058263971462,0.03329369797859691,0.0047562425683709865,Shoulder,Monday,August
2024-08-19 07:00:00,80,360,11,4,455,117,266,25,4,412,24.1,95,63,7.2,867,False,7,197,626,36,8,2024-08-19,False,False,False,0.7220299884659747,0.22722029988465975,0.04152249134948097,0.00922722029988466,Peak,Monday,August
2024-08-19 08:00:00,95,347,13,3,458,105,252,26,3,386,24.2,96,63,3.6,844,False,8,200,599,39,6,2024-08-19,False,False,False,0.7097156398104265,0.23696682464454977,0.0462085308056872,0.0071090047393364926,Peak,Monday,August
2024-08-19 09:00:00,78,323,17,5,423,94,267,27,6,394,27.0,87,51,0.8,817,False,9,172,590,44,11,2024-08-19,False,False,False,0.7221542227662179,0.21052631578947367,0.05385556915544676,0.01346389228886169,Shoulder,Monday,August
2024-08-19 10:00:00,81,335,18,6,440,88,230,23,5,346,28.2,82,51,2.9,786,False,10,169,565,41,11,2024-08-19,False,False,False,0.7188295165394402,0.21501272264631044,0.05216284987277354,0.013994910941475827,Shoulder,Monday,August
2024-08-19 11:00:00,83,354,23,4,464,83,209,26,2,320,29.2,77,51,7.2,784,False,11,166,563,49,6,2024-08-19,False,False,False,0.7181122448979592,0.21173469387755103,0.0625,0.007653061224489796,Peak,Monday,August
2024-08-19 12:00:00,96,376,26,2,500,97,247,29,3,376,29.5,75,51,7.6,876,False,12,193,623,55,5,2024-08-19,False,False,False,0.7111872146118722,0.22031963470319635,0.06278538812785388,0.005707762557077625,Peak,Monday,August
2024-08-19 13:00:00,82,360,25,5,472,92,284,35,3,414,29.9,73,1,9.7,886,False,13,174,644,60,8,2024-08-19,False,False,False,0.7268623024830699,0.1963882618510158,0.06772009029345373,0.009029345372460496,Peak,Monday,August
2024-08-19 14:00:00,80,343,20,4,447,85,215,32,4,336,29.8,72,2,9.4,783,False,14,165,558,52,8,2024-08-19,False,False,False,0.7126436781609196,0.210727969348659,0.06641123882503193,0.010217113665389528,Peak,Monday,August
2024-08-19 15:00:00,86,339,20,3,448,88,286,28,2,404,29.6,73,2,9.5,852,False,15,174,625,48,5,2024-08-19,False,False,False,0.7335680751173709,0.20422535211267606,0.056338028169014086,0.005868544600938967,Peak,Monday,August
2024-08-19 16:00:00,95,347,15,2,459,106,323,36,2,467,29.8,72,3,8.6,926,False,16,201,670,51,4,2024-08-19,False,False,False,0.7235421166306696,0.21706263498920086,0.0550755939524838,0.004319654427645789,Peak,Monday,August
2024-08-19 17:00:00,92,366,15,2,475,115,301,37,3,456,29.4,75,3,8.3,931,False,17,207,667,52,5,2024-08-19,False,False,False,0.7164339419978518,0.22234156820622986,0.055853920515574654,0.0053705692803437165,Peak,Monday,August
2024-08-19 18:00:00,81,332,10,1,424,100,276,41,1,418,28.6,77,3,8.4,842,False,18,181,608,51,2,2024-08-19,False,False,False,0.7220902612826603,0.21496437054631828,0.060570071258907364,0.0023752969121140144,Peak,Monday,August
2024-08-19 19:00:00,73,328,8,0,409,94,212,39,0,345,28.3,81,3,1.5,754,False,19,167,540,47,0,2024-08-19,False,False,False,0.7161803713527851,0.22148541114058357,0.0623342175066313,0.0,Peak,Monday,August
2024-08-19 20:00:00,64,315,7,0,386,85,181,36,0,302,27.5,84,3,2.5,688,False,20,149,496,43,0,2024-08-19,False,False,False,0.7209302325581395,0.21656976744186046,0.0625,0.0,Shoulder,Monday,August
2024-08-19 21:00:00,51,243,3,0,297,62,175,32,0,269,25.7,91,3,0.8,566,False,21,113,418,35,0,2024-08-19,False,False,False,0.7385159010600707,0.19964664310954064,0.061837455830388695,0.0,Shoulder,Monday,August
2024-08-19 22:00:00,48,227,0,0,275,54,166,28,0,248,25.9,87,51,7.7,523,False,22,102,393,28,0,2024-08-19,False,False,False,0.751434034416826,0.1950286806883365,0.05353728489483748,0.0,Shoulder,Monday,August
2024-08-19 23:00:00,40,215,0,0,255,46,150,25,0,221,25.5,91,3,7.6,476,False,23,86,365,25,0,2024-08-19,False,False,False,0.7668067226890757,0.18067226890756302,0.052521008403361345,0.0,Shoulder,Monday,August
2024-08-20 00:00:00,45,277,0,0,322,63,183,8,0,254,25.0,93,3,5.0,576,False,0,108,460,8,0,2024-08-20,False,False,False,0.7986111111111112,0.1875,0.013888888888888888,0.0,Off-Peak,Tuesday,August
2024-08-20 01:00:00,56,228,0,0,284,67,152,9,0,228,24.6,95,3,5.4,512,False,1,123,380,9,0,2024-08-20,False,False,False,0.7421875,0.240234375,0.017578125,0.0,Off-Peak,Tuesday,August
2024-08-20 02:00:00,67,246,0,0,313,64,158,13,0,235,24.5,94,63,9.9,548,False,2,131,404,13,0,2024-08-20,False,False,False,0.7372262773722628,0.23905109489051096,0.023722627737226276,0.0,Off-Peak,Tuesday,August
2024-08-20 03:00:00,70,265,1,0,336,75,174,17,0,266,24.0,95,55,9.9,602,False,3,145,439,18,0,2024-08-20,False,False,False,0.729235880398671,0.24086378737541528,0.029900332225913623,0.0,Off-Peak,Tuesday,August
2024-08-20 04:00:00,74,383,4,0,461,86,193,20,0,299,23.6,98,63,5.3,760,False,4,160,576,24,0,2024-08-20,False,False,False,0.7578947368421053,0.21052631578947367,0.031578947368421054,0.0,Off-Peak,Tuesday,August
2024-08-20 05:00:00,83,396,5,0,484,95,230,25,0,350,23.6,97,55,5.4,834,False,5,178,626,30,0,2024-08-20,False,False,False,0.750599520383693,0.21342925659472423,0.03597122302158273,0.0,Shoulder,Tuesday,August
2024-08-20 06:00:00,86,438,9,1,534,128,246,27,3,404,23.8,96,61,5.9,938,False,6,214,684,36,4,2024-08-20,False,False,False,0.7292110874200426,0.2281449893390192,0.03837953091684435,0.0042643923240938165,Shoulder,Tuesday,August
2024-08-20 07:00:00,88,454,8,5,555,135,254,30,5,424,24.1,96,51,2.7,979,False,7,223,708,38,10,2024-08-20,False,False,False,0.7231869254341164,0.22778345250255363,0.03881511746680286,0.010214504596527068,Peak,Tuesday,August
2024-08-20 08:00:00,92,442,13,2,549,115,238,31,3,387,24.6,96,3,4.3,936,False,8,207,680,44,5,2024-08-20,False,False,False,0.7264957264957265,0.22115384615384615,0.04700854700854701,0.005341880341880342,Peak,Tuesday,August
2024-08-20 09:00:00,94,436,15,4,549,98,233,34,4,369,25.0,93,63,3.8,918,False,9,192,669,49,8,2024-08-20,False,False,False,0.7287581699346405,0.20915032679738563,0.05337690631808279,0.008714596949891068,Shoulder,Tuesday,August
2024-08-20 10:00:00,96,429,18,1,544,85,226,35,1,347,24.6,93,63,3.1,891,False,10,181,655,53,2,2024-08-20,False,False,False,0.7351290684624018,0.2031425364758698,0.05948372615039282,0.002244668911335578,Shoulder,Tuesday,August
2024-08-20 11:00:00,97,374,18,3,492,96,205,37,2,340,26.1,86,61,5.2,832,False,11,193,579,55,5,2024-08-20,False,False,False,0.6959134615384616,0.23197115384615385,0.06610576923076923,0.006009615384615385,Peak,Tuesday,August
2024-08-20 12:00:00,95,395,22,1,513,127,256,40,2,425,26.1,86,51,10.1,938,False,12,222,651,62,3,2024-08-20,False,False,False,0.6940298507462687,0.23667377398720682,0.06609808102345416,0.0031982942430703624,Peak,Tuesday,August
2024-08-20 13:00:00,93,368,22,4,487,118,230,34,4,386,26.9,84,51,9.8,873,False,13,211,598,56,8,2024-08-20,False,False,False,0.6849942726231386,0.24169530355097366,0.06414662084765177,0.009163802978235968,Peak,Tuesday,August
2024-08-20 14:00:00,92,356,24,2,474,97,211,32,2,342,27.7,81,51,10.8,816,False,14,189,567,56,4,2024-08-20,False,False,False,0.6948529411764706,0.23161764705882354,0.06862745098039216,0.004901960784313725,Peak,Tuesday,August
2024-08-20 15:00:00,94,387,19,5,505,108,262,46,5,421,27.9,78,3,12.4,926,False,15,202,649,65,10,2024-08-20,False,False,False,0.7008639308855291,0.21814254859611232,0.07019438444924406,0.01079913606911447,Peak,Tuesday,August
2024-08-20 16:00:00,95,390,19,2,506,144,279,49,3,475,27.9,77,51,14.1,981,False,16,239,669,68,5,2024-08-20,False,False,False,0.6819571865443425,0.2436289500509684,0.06931702344546381,0.0050968399592252805,Peak,Tuesday,August
2024-08-20 17:00:00,88,366,15,1,470,122,257,47,2,428,27.6,77,51,13.7,898,False,17,210,623,62,3,2024-08-20,False,False,False,0.6937639198218263,0.23385300668151449,0.06904231625835189,0.0033407572383073497,Peak,Tuesday,August
2024-08-20 18:00:00,83,327,7,3,420,98,232,38,1,369,27.5,77,3,12.7,789,False,18,181,559,45,4,2024-08-20,False,False,False,0.7084917617237009,0.229404309252218,0.057034220532319393,0.005069708491761723,Peak,Tuesday,August
2024-08-20 19:00:00,79,298,6,1,384,93,207,29,2,331,27.1,79,3,11.6,715,False,19,172,505,35,3,2024-08-20,False,False,False,0.7062937062937062,0.24055944055944056,0.04895104895104895,0.004195804195804196,Peak,Tuesday,August
2024-08-20 20:00:00,74,285,4,0,363,85,173,22,0,280,26.3,83,3,11.4,643,False,20,159,458,26,0,2024-08-20,False,False,False,0.7122861586314152,0.24727838258164853,0.04043545878693624,0.0,Shoulder,Tuesday,August
2024-08-20 21:00:00,65,269,0,0,334,76,160,20,0,256,25.0,94,51,9.5,590,False,21,141,429,20,0,2024-08-20,False,False,False,0.7271186440677966,0.23898305084745763,0.03389830508474576,0.0,Shoulder,Tuesday,August
2024-08-20 22:00:00,62,248,0,0,310,68,151,18,0,237,25.0,94,51,10.1,547,False,22,130,399,18,0,2024-08-20,False,False,False,0.7294332723948812,0.2376599634369287,0.03290676416819013,0.0,Shoulder,Tuesday,August
2024-08-20 23:00:00,55,237,0,0,292,65,145,15,0,225,25.0,94,3,8.4,517,False,23,120,382,15,0,2024-08-20,False,False,False,0.7388781431334622,0.23210831721470018,0.029013539651837523,0.0,Shoulder,Tuesday,August
2024-08-21 00:00:00,37,261,0,0,298,65,187,6,0,258,24.7,93,3,6.7,556,False,0,102,448,6,0,2024-08-21,False,False,False,0.8057553956834532,0.18345323741007194,0.01079136690647482,0.0,Off-Peak,Wednesday,August
2024-08-21 01:00:00,39,252,0,0,291,68,166,9,0,243,24.2,94,3,4.3,534,False,1,107,418,9,0,2024-08-21,False,False,False,0.7827715355805244,0.20037453183520598,0.016853932584269662,0.0,Off-Peak,Wednesday,August
2024-08-21 02:00:00,44,270,0,0,314,72,161,10,0,243,23.9,95,3,3.7,557,False,2,116,431,10,0,2024-08-21,False,False,False,0.7737881508078994,0.20825852782764812,0.017953321364452424,0.0,Off-Peak,Wednesday,August
2024-08-21 03:00:00,48,289,0,0,337,80,177,12,0,269,23.9,95,3,5.6,606,False,3,128,466,12,0,2024-08-21,False,False,False,0.768976897689769,0.21122112211221122,0.019801980198019802,0.0,Off-Peak,Wednesday,August
2024-08-21 04:00:00,56,297,0,0,353,87,196,14,0,297,23.7,96,3,4.4,650,False,4,143,493,14,0,2024-08-21,False,False,False,0.7584615384615384,0.22,0.021538461538461538,0.0,Off-Peak,Wednesday,August
2024-08-21 05:00:00,62,360,1,0,423,99,233,18,0,350,23.6,97,3,4.1,773,False,5,161,593,19,0,2024-08-21,False,False,False,0.7671410090556274,0.20827943078913325,0.02457956015523933,0.0,Shoulder,Wednesday,August
2024-08-21 06:00:00,74,375,4,0,453,115,259,23,1,398,23.5,96,3,5.5,851,False,6,189,634,27,1,2024-08-21,False,False,False,0.745005875440658,0.22209165687426558,0.03172737955346651,0.0011750881316098707,Shoulder,Wednesday,August
2024-08-21 07:00:00,75,384,5,2,466,119,267,27,3,416,23.3,98,3,4.8,882,False,7,194,651,32,5,2024-08-21,False,False,False,0.7380952380952381,0.2199546485260771,0.036281179138321996,0.005668934240362812,Peak,Wednesday,August
2024-08-21 08:00:00,92,361,9,5,467,107,241,28,4,380,23.8,97,3,4.1,847,False,8,199,602,37,9,2024-08-21,False,False,False,0.7107438016528925,0.23494687131050768,0.043683589138134596,0.010625737898465172,Peak,Wednesday,August
2024-08-21 09:00:00,75,327,11,3,416,96,236,27,5,364,25.3,93,3,3.7,780,False,9,171,563,38,8,2024-08-21,False,False,False,0.7217948717948718,0.21923076923076923,0.04871794871794872,0.010256410256410256,Shoulder,Wednesday,August
2024-08-21 10:00:00,78,339,13,1,431,90,229,24,6,349,26.4,88,3,5.5,780,False,10,168,568,37,7,2024-08-21,False,False,False,0.7282051282051282,0.2153846153846154,0.047435897435897434,0.008974358974358974,Shoulder,Wednesday,August
2024-08-21 11:00:00,84,358,12,0,454,85,218,27,3,333,27.2,84,3,4.1,787,False,11,169,576,39,3,2024-08-21,False,False,False,0.7318932655654383,0.21473951715374842,0.04955527318932656,0.0038119440914866584,Peak,Wednesday,August
2024-08-21 12:00:00,93,383,14,4,494,99,269,38,4,410,27.5,82,53,2.9,904,False,12,192,652,52,8,2024-08-21,False,False,False,0.7212389380530974,0.21238938053097345,0.05752212389380531,0.008849557522123894,Peak,Wednesday,August
2024-08-21 13:00:00,79,366,16,3,464,94,243,30,2,369,27.0,87,63,4.9,833,False,13,173,609,46,5,2024-08-21,False,False,False,0.7310924369747899,0.20768307322929172,0.055222088835534214,0.006002400960384154,Peak,Wednesday,August
2024-08-21 14:00:00,77,347,11,3,438,87,234,33,2,356,27.3,85,53,4.8,794,False,14,164,581,44,5,2024-08-21,False,False,False,0.7317380352644837,0.20654911838790932,0.055415617128463476,0.006297229219143577,Peak,Wednesday,August
2024-08-21 15:00:00,83,354,10,2,449,90,265,29,2,386,27.5,86,51,2.2,835,False,15,173,619,39,4,2024-08-21,False,False,False,0.7413173652694611,0.20718562874251498,0.046706586826347304,0.004790419161676647,Peak,Wednesday,August
2024-08-21 16:00:00,92,361,7,1,461,108,282,37,2,429,28.1,83,51,2.9,890,False,16,200,643,44,3,2024-08-21,False,False,False,0.7224719101123596,0.2247191011235955,0.04943820224719101,0.0033707865168539327,Peak,Wednesday,August
2024-08-21 17:00:00,89,374,6,2,471,117,270,43,1,431,28.2,81,3,4.7,902,False,17,206,644,49,3,2024-08-21,False,False,False,0.7139689578713969,0.22838137472283815,0.05432372505543237,0.0033259423503325942,Peak,Wednesday,August
2024-08-21 18:00:00,83,356,4,1,444,102,255,34,0,391,28.2,81,3,6.5,835,False,18,185,611,38,1,2024-08-21,False,False,False,0.7317365269461078,0.2215568862275449,0.045508982035928146,0.0011976047904191617,Peak,Wednesday,August
2024-08-21 19:00:00,72,332,2,1,407,96,228,32,0,356,27.3,88,3,2.9,763,False,19,168,560,34,1,2024-08-21,False,False,False,0.7339449541284404,0.22018348623853212,0.04456094364351245,0.001310615989515072,Peak,Wednesday,August
2024-08-21 20:00:00,63,319,1,0,383,87,185,37,0,309,27.6,84,3,2.7,692,False,20,150,504,38,0,2024-08-21,False,False,False,0.7283236994219653,0.21676300578034682,0.05491329479768786,0.0,Shoulder,Wednesday,August
2024-08-21 21:00:00,50,274,0,0,324,64,163,33,0,260,26.2,87,3,3.3,584,False,21,114,437,33,0,2024-08-21,False,False,False,0.7482876712328768,0.1952054794520548,0.05650684931506849,0.0,Shoulder,Wednesday,August
2024-08-21 22:00:00,47,251,0,0,298,56,154,29,0,239,25.7,88,3,3.2,537,False,22,103,405,29,0,2024-08-21,False,False,False,0.7541899441340782,0.19180633147113593,0.054003724394785846,0.0,Shoulder,Wednesday,August
2024-08-21 23:00:00,39,239,0,0,278,51,149,26,0,226,25.0,91,3,4.9,504,False,23,90,388,26,0,2024-08-21,False,False,False,0.7698412698412699,0.17857142857142858,0.051587301587301584,0.0,Shoulder,Wednesday,August
2024-08-22 00:00:00,45,249,0,0,294,63,180,7,0,250,24.9,91,3,4.4,544,False,0,108,429,7,0,2024-08-22,False,False,False,0.7886029411764706,0.19852941176470587,0.012867647058823529,0.0,Off-Peak,Thursday,August
2024-08-22 01:00:00,56,220,0,0,276,67,149,8,0,224,24.8,91,3,5.4,500,False,1,123,369,8,0,2024-08-22,False,False,False,0.738,0.246,0.016,0.0,Off-Peak,Thursday,August
2024-08-22 02:00:00,67,238,0,0,305,64,155,12,0,231,24.8,90,3,5.3,536,False,2,131,393,12,0,2024-08-22,False,False,False,0.7332089552238806,0.24440298507462688,0.022388059701492536,0.0,Off-Peak,Thursday,August
2024-08-22 03:00:00,70,277,0,0,347,75,171,16,0,262,24.8,90,3,4.7,609,False,3,145,448,16,0,2024-08-22,False,False,False,0.735632183908046,0.23809523809523808,0.026272577996715927,0.0,Off-Peak,Thursday,August
2024-08-22 04:00:00,74,295,3,0,372,86,190,19,0,295,24.6,92,3,2.6,667,False,4,160,485,22,0,2024-08-22,False,False,False,0.7271364317841079,0.239880059970015,0.03298350824587706,0.0,Off-Peak,Thursday,August
2024-08-22 05:00:00,83,348,4,0,435,95,227,24,0,346,24.4,92,3,2.5,781,False,5,178,575,28,0,2024-08-22,False,False,False,0.736235595390525,0.22791293213828426,0.03585147247119078,0.0,Shoulder,Thursday,August
2024-08-22 06:00:00,86,373,6,0,465,128,243,27,3,401,24.0,96,3,5.3,866,False,6,214,616,33,3,2024-08-22,False,False,False,0.7113163972286374,0.2471131639722864,0.03810623556581986,0.003464203233256351,Shoulder,Thursday,August
2024-08-22 07:00:00,88,362,9,3,462,135,251,32,6,424,24.4,96,3,4.5,886,False,7,223,613,41,9,2024-08-22,False,False,False,0.6918735891647856,0.2516930022573363,0.046275395033860044,0.010158013544018058,Peak,Thursday,August
2024-08-22 08:00:00,92,349,12,3,456,114,235,30,5,384,25.3,94,2,4.2,840,False,8,206,584,42,8,2024-08-22,False,False,False,0.6952380952380952,0.24523809523809523,0.05,0.009523809523809525,Peak,Thursday,August
2024-08-22 09:00:00,94,325,13,4,436,98,230,33,4,365,24.5,92,65,10.5,801,False,9,192,555,46,8,2024-08-22,False,False,False,0.6928838951310862,0.2397003745318352,0.05742821473158552,0.009987515605493134,Shoulder,Thursday,August
2024-08-22 10:00:00,95,337,15,1,448,85,223,34,6,348,25.4,89,63,4.1,796,False,10,180,560,49,7,2024-08-22,False,False,False,0.7035175879396985,0.22613065326633167,0.06155778894472362,0.008793969849246231,Shoulder,Thursday,August
2024-08-22 11:00:00,97,356,18,4,475,96,202,36,5,339,26.8,85,51,3.4,814,False,11,193,558,54,9,2024-08-22,False,False,False,0.6855036855036855,0.2371007371007371,0.06633906633906633,0.011056511056511056,Peak,Thursday,August
2024-08-22 12:00:00,95,378,22,3,498,127,253,39,4,423,28.6,80,3,1.8,921,False,12,222,631,61,7,2024-08-22,False,False,False,0.6851248642779587,0.24104234527687296,0.06623235613463627,0.00760043431053203,Peak,Thursday,August
2024-08-22 13:00:00,93,362,23,6,484,118,227,40,6,391,29.6,74,51,7.1,875,False,13,211,589,63,12,2024-08-22,False,False,False,0.6731428571428572,0.24114285714285713,0.072,0.013714285714285714,Peak,Thursday,August
2024-08-22 14:00:00,90,345,20,1,456,97,208,42,3,350,29.7,72,51,9.2,806,False,14,187,553,62,4,2024-08-22,False,False,False,0.6861042183622829,0.23200992555831265,0.07692307692307693,0.004962779156327543,Peak,Thursday,August
2024-08-22 15:00:00,92,341,18,2,453,108,259,45,2,414,29.3,74,3,8.7,867,False,15,200,600,63,4,2024-08-22,False,False,False,0.6920415224913494,0.2306805074971165,0.0726643598615917,0.00461361014994233,Peak,Thursday,August
2024-08-22 16:00:00,94,349,16,1,460,142,268,46,3,459,28.5,77,3,7.7,919,False,16,236,617,62,4,2024-08-22,False,False,False,0.6713819368879217,0.25680087051142547,0.06746463547334058,0.004352557127312296,Peak,Thursday,August
2024-08-22 17:00:00,88,368,13,3,472,121,254,47,2,424,28.4,77,51,5.4,896,False,17,209,622,60,5,2024-08-22,False,False,False,0.6941964285714286,0.23325892857142858,0.06696428571428571,0.005580357142857143,Peak,Thursday,August
2024-08-22 18:00:00,83,334,12,0,429,98,229,34,1,362,28.4,76,3,4.8,791,False,18,181,563,46,1,2024-08-22,False,False,False,0.7117572692793932,0.22882427307206069,0.05815423514538559,0.0012642225031605564,Peak,Thursday,August
2024-08-22 19:00:00,79,330,9,0,418,93,204,28,0,325,28.0,83,3,1.1,743,False,19,172,534,37,0,2024-08-22,False,False,False,0.7187079407806191,0.23149394347240915,0.04979811574697174,0.0,Peak,Thursday,August
2024-08-22 20:00:00,74,317,7,0,398,85,170,21,0,276,26.5,88,3,4.4,674,False,20,159,487,28,0,2024-08-22,False,False,False,0.7225519287833828,0.23590504451038577,0.04154302670623145,0.0,Shoulder,Thursday,August
2024-08-22 21:00:00,65,245,4,0,314,76,157,19,0,252,27.3,81,2,9.7,566,False,21,141,402,23,0,2024-08-22,False,False,False,0.7102473498233216,0.24911660777385158,0.04063604240282685,0.0,Shoulder,Thursday,August
2024-08-22 22:00:00,62,228,0,0,290,68,148,17,0,233,26.7,85,1,6.1,523,False,22,130,376,17,0,2024-08-22,False,False,False,0.7189292543021033,0.248565965583174,0.032504780114722756,0.0,Shoulder,Thursday,August
2024-08-22 23:00:00,55,216,0,0,271,65,142,12,0,219,25.7,94,2,5.2,490,False,23,120,358,12,0,2024-08-22,False,False,False,0.7306122448979592,0.24489795918367346,0.024489795918367346,0.0,Shoulder,Thursday,August
2024-08-23 00:00:00,57,244,0,0,301,80,161,9,0,250,25.9,91,61,6.0,551,False,0,137,405,9,0,2024-08-23,False,False,False,0.73502722323049,0.24863883847549909,0.016333938294010888,0.0,Off-Peak,Friday,August
2024-08-23 01:00:00,59,215,0,0,274,78,154,10,0,242,25.8,93,1,5.0,516,False,1,137,369,10,0,2024-08-23,False,False,False,0.7151162790697675,0.2655038759689923,0.01937984496124031,0.0,Off-Peak,Friday,August
2024-08-23 02:00:00,67,233,0,0,300,86,142,13,0,241,25.1,98,2,3.3,541,False,2,153,375,13,0,2024-08-23,False,False,False,0.6931608133086876,0.2828096118299446,0.024029574861367836,0.0,Off-Peak,Friday,August
2024-08-23 03:00:00,69,272,4,0,345,95,135,16,0,246,24.9,99,3,2.9,591,False,3,164,407,20,0,2024-08-23,False,False,False,0.688663282571912,0.27749576988155666,0.0338409475465313,0.0,Off-Peak,Friday,August
2024-08-23 04:00:00,75,290,6,0,371,99,169,19,0,287,24.7,100,51,4.0,658,False,4,174,459,25,0,2024-08-23,False,False,False,0.6975683890577508,0.26443768996960487,0.037993920972644375,0.0,Off-Peak,Friday,August
2024-08-23 05:00:00,88,343,7,0,438,126,284,21,0,431,24.5,99,51,3.8,869,False,5,214,627,28,0,2024-08-23,False,False,False,0.7215189873417721,0.24626006904487918,0.03222094361334868,0.0,Shoulder,Friday,August
2024-08-23 06:00:00,89,368,8,1,466,139,351,24,5,519,23.9,99,63,9.0,985,False,6,228,719,32,6,2024-08-23,False,False,False,0.7299492385786802,0.23147208121827412,0.03248730964467005,0.006091370558375634,Shoulder,Friday,August
2024-08-23 07:00:00,92,357,10,5,464,147,370,28,7,552,23.8,99,63,0.0,1016,False,7,239,727,38,12,2024-08-23,False,False,False,0.7155511811023622,0.23523622047244094,0.03740157480314961,0.011811023622047244,Peak,Friday,August
2024-08-23 08:00:00,94,344,14,2,454,126,394,33,4,557,24.6,96,51,6.8,1011,False,8,220,738,47,6,2024-08-23,False,False,False,0.7299703264094956,0.2176063303659743,0.04648862512363996,0.005934718100890208,Peak,Friday,August
2024-08-23 09:00:00,96,320,16,6,438,118,346,37,6,507,26.3,85,51,1.1,945,False,9,214,666,53,12,2024-08-23,False,False,False,0.7047619047619048,0.22645502645502646,0.056084656084656084,0.012698412698412698,Shoulder,Friday,August
2024-08-23 10:00:00,100,332,19,6,457,115,332,45,3,495,27.6,83,1,2.5,952,False,10,215,664,64,9,2024-08-23,False,False,False,0.6974789915966386,0.22584033613445378,0.06722689075630252,0.009453781512605041,Shoulder,Friday,August
2024-08-23 11:00:00,103,351,22,7,483,116,320,48,2,486,28.9,78,51,4.2,969,False,11,219,671,70,9,2024-08-23,False,False,False,0.6924664602683178,0.2260061919504644,0.07223942208462332,0.009287925696594427,Peak,Friday,August
2024-08-23 12:00:00,98,373,27,3,501,139,354,43,1,537,29.2,77,51,9.7,1038,False,12,237,727,70,4,2024-08-23,False,False,False,0.7003853564547207,0.22832369942196531,0.0674373795761079,0.0038535645472061657,Peak,Friday,August
2024-08-23 13:00:00,95,357,24,6,482,128,375,36,5,544,27.8,82,63,9.4,1026,False,13,223,732,60,11,2024-08-23,False,False,False,0.7134502923976608,0.21734892787524365,0.05847953216374269,0.010721247563352826,Peak,Friday,August
2024-08-23 14:00:00,96,340,21,2,459,117,343,28,3,491,28.0,83,51,9.8,950,False,14,213,683,49,5,2024-08-23,False,False,False,0.7189473684210527,0.22421052631578947,0.05157894736842105,0.005263157894736842,Peak,Friday,August
2024-08-23 15:00:00,98,336,19,3,456,148,329,26,6,509,28.4,81,51,11.1,965,False,15,246,665,45,9,2024-08-23,False,False,False,0.689119170984456,0.2549222797927461,0.046632124352331605,0.00932642487046632,Peak,Friday,August
2024-08-23 16:00:00,102,345,17,0,464,156,394,37,4,591,28.6,80,3,11.1,1055,False,16,258,739,54,4,2024-08-23,False,False,False,0.7004739336492891,0.24454976303317535,0.05118483412322275,0.0037914691943127963,Peak,Friday,August
2024-08-23 17:00:00,94,364,15,3,476,141,412,45,2,600,28.1,80,51,10.3,1076,False,17,235,776,60,5,2024-08-23,False,False,False,0.7211895910780669,0.2184014869888476,0.055762081784386616,0.004646840148698885,Peak,Friday,August
2024-08-23 18:00:00,91,330,12,1,434,130,419,42,2,593,28.0,79,3,9.4,1027,False,18,221,749,54,3,2024-08-23,False,False,False,0.7293086660175268,0.21518987341772153,0.05258033106134372,0.0029211295034079843,Peak,Friday,August
2024-08-23 19:00:00,90,326,8,0,424,116,403,39,5,563,26.9,83,53,11.5,987,False,19,206,729,47,5,2024-08-23,False,False,False,0.7386018237082067,0.20871327254305977,0.047619047619047616,0.005065856129685917,Peak,Friday,August
2024-08-23 20:00:00,88,313,6,0,407,110,395,38,3,546,25.9,90,53,11.6,953,False,20,198,708,44,3,2024-08-23,False,False,False,0.7429171038824763,0.20776495278069254,0.046169989506820566,0.0031479538300104933,Shoulder,Friday,August
2024-08-23 21:00:00,86,241,3,0,330,98,361,35,1,495,24.9,94,63,7.2,825,False,21,184,602,38,1,2024-08-23,False,False,False,0.7296969696969697,0.22303030303030302,0.04606060606060606,0.0012121212121212121,Shoulder,Friday,August
2024-08-23 22:00:00,83,225,0,0,308,96,294,29,0,419,24.8,94,63,7.4,727,False,22,179,519,29,0,2024-08-23,False,False,False,0.7138927097661623,0.24621733149931224,0.039889958734525444,0.0,Shoulder,Friday,August
2024-08-23 23:00:00,80,213,0,0,293,87,283,26,0,396,24.6,93,61,10.1,689,False,23,167,496,26,0,2024-08-23,False,False,False,0.7198838896952104,0.24238026124818576,0.03773584905660377,0.0,Shoulder,Friday,August
2024-08-24 00:00:00,34,222,0,0,256,96,180,3,0,279,24.0,93,65,13.5,535,True,0,130,402,3,0,2024-08-24,True,True,False,0.7514018691588785,0.24299065420560748,0.005607476635514018,0.0,Off-Peak,Saturday,August
2024-08-24 01:00:00,36,213,0,0,249,94,173,5,0,272,23.6,90,63,15.0,521,True,1,130,386,5,0,2024-08-24,True,True,False,0.7408829174664108,0.2495201535508637,0.009596928982725527,0.0,Off-Peak,Saturday,August
2024-08-24 02:00:00,41,221,0,0,262,97,161,9,0,267,23.2,93,63,11.5,529,True,2,138,382,9,0,2024-08-24,True,True,False,0.722117202268431,0.2608695652173913,0.017013232514177693,0.0,Off-Peak,Saturday,August
2024-08-24 03:00:00,43,204,0,0,247,99,254,12,0,365,23.4,92,61,11.9,612,True,3,142,458,12,0,2024-08-24,True,True,False,0.7483660130718954,0.23202614379084968,0.0196078431372549,0.0,Off-Peak,Saturday,August
2024-08-24 04:00:00,51,228,0,0,279,105,287,15,0,407,23.6,91,51,11.2,686,True,4,156,515,15,0,2024-08-24,True,True,False,0.750728862973761,0.22740524781341107,0.021865889212827987,0.0,Off-Peak,Saturday,August
2024-08-24 05:00:00,57,231,3,0,291,112,443,16,0,571,23.6,91,3,10.0,862,True,5,169,674,19,0,2024-08-24,True,True,False,0.7819025522041764,0.19605568445475638,0.022041763341067284,0.0,Shoulder,Saturday,August
2024-08-24 06:00:00,71,306,4,0,381,125,450,22,3,600,23.7,91,3,10.1,981,True,6,196,756,26,3,2024-08-24,True,True,False,0.7706422018348624,0.199796126401631,0.026503567787971458,0.0030581039755351682,Shoulder,Saturday,August
2024-08-24 07:00:00,72,310,6,2,390,135,434,24,5,598,23.9,91,3,8.4,988,True,7,207,744,30,7,2024-08-24,True,True,False,0.7530364372469636,0.20951417004048584,0.030364372469635626,0.00708502024291498,Peak,Saturday,August
2024-08-24 08:00:00,77,315,9,5,406,132,412,26,3,573,24.3,91,3,7.9,979,True,8,209,727,35,8,2024-08-24,True,True,False,0.7425944841675178,0.21348314606741572,0.03575076608784474,0.008171603677221655,Peak,Saturday,August
2024-08-24 09:00:00,74,308,11,2,395,165,361,31,4,561,25.9,83,3,11.7,956,True,9,239,669,42,6,2024-08-24,True,True,False,0.6997907949790795,0.25,0.043933054393305436,0.006276150627615063,Shoulder,Saturday,August
2024-08-24 10:00:00,74,311,13,3,401,171,343,32,1,547,27.6,75,3,21.1,948,True,10,245,654,45,4,2024-08-24,True,True,False,0.689873417721519,0.25843881856540085,0.04746835443037975,0.004219409282700422,Shoulder,Saturday,August
2024-08-24 11:00:00,76,325,15,1,417,219,349,35,2,605,27.8,77,2,14.1,1022,True,11,295,674,50,3,2024-08-24,True,True,False,0.6594911937377691,0.28864970645792565,0.04892367906066536,0.0029354207436399216,Peak,Saturday,August
2024-08-24 12:00:00,83,328,14,6,431,231,380,34,2,647,28.6,76,2,11.7,1078,True,12,314,708,48,8,2024-08-24,True,True,False,0.6567717996289425,0.2912801484230056,0.04452690166975881,0.0074211502782931356,Peak,Saturday,August
2024-08-24 13:00:00,75,303,18,1,397,224,368,29,4,625,28.9,76,1,12.7,1022,True,13,299,671,47,5,2024-08-24,True,True,False,0.6565557729941291,0.2925636007827789,0.04598825831702544,0.004892367906066536,Peak,Saturday,August
2024-08-24 14:00:00,72,281,13,4,370,213,332,21,2,568,29.2,75,2,13.4,938,True,14,285,613,34,6,2024-08-24,True,True,False,0.6535181236673774,0.30383795309168443,0.03624733475479744,0.006396588486140725,Peak,Saturday,August
2024-08-24 15:00:00,80,245,11,3,339,194,358,17,4,573,29.1,75,2,12.1,912,True,15,274,603,28,7,2024-08-24,True,True,False,0.6611842105263158,0.30043859649122806,0.03070175438596491,0.007675438596491228,Peak,Saturday,August
2024-08-24 16:00:00,88,304,10,3,405,182,473,33,3,691,29.0,75,3,11.7,1096,True,16,270,777,43,6,2024-08-24,True,True,False,0.708941605839416,0.24635036496350365,0.03923357664233577,0.005474452554744526,Peak,Saturday,August
2024-08-24 17:00:00,85,311,7,1,404,227,456,36,2,721,29.0,75,3,10.1,1125,True,17,312,767,43,3,2024-08-24,True,True,False,0.6817777777777778,0.2773333333333333,0.03822222222222222,0.0026666666666666666,Peak,Saturday,August
2024-08-24 18:00:00,76,274,5,3,358,156,438,31,1,626,28.9,75,3,7.2,984,True,18,232,712,36,4,2024-08-24,True,True,False,0.7235772357723578,0.23577235772357724,0.036585365853658534,0.0040650406504065045,Peak,Saturday,August
2024-08-24 19:00:00,70,253,4,0,327,122,422,30,2,576,27.1,79,51,12.2,903,True,19,192,675,34,2,2024-08-24,True,True,False,0.7475083056478405,0.21262458471760798,0.03765227021040975,0.0022148394241417496,Peak,Saturday,August
2024-08-24 20:00:00,51,210,3,0,264,116,406,27,0,549,26.2,83,51,7.4,813,True,20,167,616,30,0,2024-08-24,True,True,False,0.7576875768757687,0.2054120541205412,0.03690036900369004,0.0,Shoulder,Saturday,August
2024-08-24 21:00:00,47,204,0,0,251,104,380,21,0,505,26.2,89,3,5.0,756,True,21,151,584,21,0,2024-08-24,True,True,False,0.7724867724867724,0.19973544973544974,0.027777777777777776,0.0,Shoulder,Saturday,August
2024-08-24 22:00:00,44,183,0,0,227,98,293,14,0,405,25.8,91,3,8.2,632,True,22,142,476,14,0,2024-08-24,True,True,False,0.7531645569620253,0.22468354430379747,0.022151898734177215,0.0,Shoulder,Saturday,August
2024-08-24 23:00:00,36,161,0,0,197,92,272,8,0,372,25.5,91,3,6.8,569,True,23,128,433,8,0,2024-08-24,True,True,False,0.7609841827768014,0.22495606326889278,0.014059753954305799,0.0,Shoulder,Saturday,August
2024-08-25 00:00:00,46,261,0,0,307,94,187,4,0,285,25.1,90,61,7.7,592,True,0,140,448,4,0,2024-08-25,False,True,False,0.7567567567567568,0.23648648648648649,0.006756756756756757,0.0,Off-Peak,Sunday,August
2024-08-25 01:00:00,57,252,0,0,309,92,180,5,0,277,24.4,88,55,10.6,586,True,1,149,432,5,0,2024-08-25,False,True,False,0.7372013651877133,0.25426621160409557,0.008532423208191127,0.0,Off-Peak,Sunday,August
2024-08-25 02:00:00,68,270,0,0,338,95,168,6,0,269,23.7,84,3,9.7,607,True,2,163,438,6,0,2024-08-25,False,True,False,0.7215815485996705,0.2685337726523888,0.009884678747940691,0.0,Off-Peak,Sunday,August
2024-08-25 03:00:00,71,289,0,0,360,97,261,11,0,369,23.7,78,3,6.5,729,True,3,168,550,11,0,2024-08-25,False,True,False,0.7544581618655692,0.23045267489711935,0.015089163237311385,0.0,Off-Peak,Sunday,August
2024-08-25 04:00:00,75,297,5,0,377,103,295,13,0,411,23.7,75,3,6.7,788,True,4,178,592,18,0,2024-08-25,False,True,False,0.751269035532995,0.22588832487309646,0.02284263959390863,0.0,Off-Peak,Sunday,August
2024-08-25 05:00:00,84,360,8,0,452,110,470,15,0,595,23.7,73,3,7.9,1047,True,5,194,830,23,0,2024-08-25,False,True,False,0.792741165234002,0.18529130850047756,0.021967526265520534,0.0,Shoulder,Sunday,August
2024-08-25 06:00:00,87,375,7,1,470,123,477,18,1,619,23.3,75,3,6.7,1089,True,6,210,852,25,2,2024-08-25,False,True,False,0.7823691460055097,0.1928374655647383,0.02295684113865932,0.0018365472910927456,Shoulder,Sunday,August
2024-08-25 07:00:00,89,384,11,3,487,133,441,24,5,603,23.0,76,3,6.6,1090,True,7,222,825,35,8,2024-08-25,False,True,False,0.7568807339449541,0.2036697247706422,0.03211009174311927,0.007339449541284404,Peak,Sunday,August
2024-08-25 08:00:00,93,361,13,5,472,127,419,26,2,574,23.6,78,3,8.0,1046,True,8,220,780,39,7,2024-08-25,False,True,False,0.745697896749522,0.21032504780114722,0.0372848948374761,0.006692160611854685,Peak,Sunday,August
2024-08-25 09:00:00,95,327,17,4,443,114,369,30,7,520,23.9,81,3,10.6,963,True,9,209,696,47,11,2024-08-25,False,True,False,0.7227414330218068,0.21703011422637591,0.04880581516095535,0.01142263759086189,Shoulder,Sunday,August
2024-08-25 10:00:00,97,336,18,6,457,139,350,33,4,526,24.5,87,55,5.8,983,True,10,236,686,51,10,2024-08-25,False,True,False,0.6978636826042727,0.24008138351983724,0.05188199389623601,0.01017293997965412,Shoulder,Sunday,August
2024-08-25 11:00:00,99,358,23,5,485,218,356,35,3,612,25.2,87,51,6.2,1097,True,11,317,714,58,8,2024-08-25,False,True,False,0.650865998176846,0.2889699179580675,0.0528714676390155,0.007292616226071103,Peak,Sunday,August
2024-08-25 12:00:00,98,372,26,3,499,226,387,38,2,653,26.1,84,51,6.2,1152,True,12,324,759,64,5,2024-08-25,False,True,False,0.6588541666666666,0.28125,0.05555555555555555,0.004340277777777778,Peak,Sunday,August
2024-08-25 13:00:00,96,366,25,4,491,212,381,41,4,638,27.4,79,51,7.2,1129,True,13,308,747,66,8,2024-08-25,False,True,False,0.6616474756421612,0.2728077945084145,0.05845881310894597,0.0070859167404783,Peak,Sunday,August
2024-08-25 14:00:00,91,347,20,3,461,201,359,40,3,603,28.2,75,3,6.5,1064,True,14,292,706,60,6,2024-08-25,False,True,False,0.6635338345864662,0.2744360902255639,0.05639097744360902,0.005639097744360902,Peak,Sunday,August
2024-08-25 15:00:00,95,354,20,2,471,182,436,37,4,659,28.1,75,3,3.3,1130,True,15,277,790,57,6,2024-08-25,False,True,False,0.6991150442477876,0.24513274336283186,0.050442477876106194,0.005309734513274336,Peak,Sunday,August
2024-08-25 16:00:00,97,361,15,2,475,170,475,34,2,681,28.5,73,3,8.9,1156,True,16,267,836,49,4,2024-08-25,False,True,False,0.7231833910034602,0.2309688581314879,0.04238754325259515,0.0034602076124567475,Peak,Sunday,August
2024-08-25 17:00:00,88,374,13,1,476,215,463,31,4,713,27.8,76,3,10.3,1189,True,17,303,837,44,5,2024-08-25,False,True,False,0.7039529015979815,0.25483599663582845,0.03700588730025231,0.004205214465937763,Peak,Sunday,August
2024-08-25 18:00:00,84,356,10,1,451,154,445,39,1,639,27.3,79,3,5.8,1090,True,18,238,801,49,2,2024-08-25,False,True,False,0.7348623853211009,0.21834862385321102,0.044954128440366975,0.001834862385321101,Peak,Sunday,August
2024-08-25 19:00:00,79,332,8,0,419,120,439,26,0,585,26.7,83,2,3.7,1004,True,19,199,771,34,0,2024-08-25,False,True,False,0.7679282868525896,0.19820717131474103,0.03386454183266932,0.0,Peak,Sunday,August
2024-08-25 20:00:00,74,319,7,0,400,94,431,21,0,546,25.6,91,3,5.3,946,True,20,168,750,28,0,2024-08-25,False,True,False,0.7928118393234672,0.17758985200845667,0.02959830866807611,0.0,Shoulder,Sunday,August
2024-08-25 21:00:00,65,274,3,0,342,90,387,18,0,495,26.2,90,51,7.0,837,True,21,155,661,21,0,2024-08-25,False,True,False,0.7897252090800478,0.18518518518518517,0.025089605734767026,0.0,Shoulder,Sunday,August
2024-08-25 22:00:00,62,251,0,0,313,86,360,12,0,458,26.0,93,51,2.4,771,True,22,148,611,12,0,2024-08-25,False,True,False,0.7924773022049286,0.191958495460441,0.01556420233463035,0.0,Shoulder,Sunday,August
2024-08-25 23:00:00,55,239,0,0,294,83,349,6,0,438,24.9,94,61,8.8,732,True,23,138,588,6,0,2024-08-25,False,True,False,0.8032786885245902,0.1885245901639344,0.00819672131147541,0.0,Shoulder,Sunday,August
2024-08-26 00:00:00,41,244,0,0,285,65,178,11,0,254,24.2,96,63,8.2,539,False,0,106,422,11,0,2024-08-26,False,False,False,0.7829313543599258,0.19666048237476808,0.02040816326530612,0.0,Off-Peak,Monday,August
2024-08-26 01:00:00,43,215,0,0,258,69,171,12,0,252,24.3,96,53,4.0,510,False,1,112,386,12,0,2024-08-26,False,False,False,0.7568627450980392,0.2196078431372549,0.023529411764705882,0.0,Off-Peak,Monday,August
2024-08-26 02:00:00,48,233,0,0,281,66,159,15,0,240,24.4,94,53,4.7,521,False,2,114,392,15,0,2024-08-26,False,False,False,0.7523992322456814,0.21880998080614203,0.028790786948176585,0.0,Off-Peak,Monday,August
2024-08-26 03:00:00,52,272,3,0,327,77,252,18,0,347,24.6,95,53,2.9,674,False,3,129,524,21,0,2024-08-26,False,False,False,0.7774480712166172,0.1913946587537092,0.03115727002967359,0.0,Off-Peak,Monday,August
2024-08-26 04:00:00,60,290,4,0,354,88,285,21,0,394,24.2,97,51,3.9,748,False,4,148,575,25,0,2024-08-26,False,False,False,0.7687165775401069,0.19786096256684493,0.03342245989304813,0.0,Off-Peak,Monday,August
2024-08-26 05:00:00,66,343,6,0,415,97,421,23,2,543,24.1,95,61,5.2,958,False,5,163,764,29,2,2024-08-26,False,False,False,0.7974947807933194,0.17014613778705637,0.030271398747390398,0.0020876826722338203,Shoulder,Monday,August
2024-08-26 06:00:00,79,364,8,0,451,130,448,26,6,610,24.3,96,53,4.3,1061,False,6,209,812,34,6,2024-08-26,False,False,False,0.765315739868049,0.19698397737983034,0.03204524033930255,0.005655042412818096,Shoulder,Monday,August
2024-08-26 07:00:00,80,357,10,1,448,138,434,30,8,610,24.3,96,51,4.6,1058,False,7,218,791,40,9,2024-08-26,False,False,False,0.7476370510396976,0.2060491493383743,0.03780718336483932,0.008506616257088847,Peak,Monday,August
2024-08-26 08:00:00,95,344,13,6,458,116,412,36,5,569,24.6,95,51,6.2,1027,False,8,211,756,49,11,2024-08-26,False,False,False,0.7361246348588121,0.20545277507302823,0.04771178188899708,0.010710808179162609,Peak,Monday,August
2024-08-26 09:00:00,78,320,15,1,414,99,359,39,7,504,24.8,92,51,3.9,918,False,9,177,679,54,8,2024-08-26,False,False,False,0.7396514161220044,0.19281045751633988,0.058823529411764705,0.008714596949891068,Shoulder,Monday,August
2024-08-26 10:00:00,81,332,17,4,434,86,341,42,4,473,25.5,88,51,7.9,907,False,10,167,673,59,8,2024-08-26,False,False,False,0.7420066152149944,0.18412348401323042,0.06504961411245866,0.008820286659316428,Shoulder,Monday,August
2024-08-26 11:00:00,83,351,19,2,455,97,347,45,3,492,25.8,87,55,11.3,947,False,11,180,698,64,5,2024-08-26,False,False,False,0.737064413938754,0.1900739176346357,0.0675818373812038,0.005279831045406547,Peak,Monday,August
2024-08-26 12:00:00,96,373,20,5,494,130,378,56,2,566,26.3,86,53,11.0,1060,False,12,226,751,76,7,2024-08-26,False,False,False,0.7084905660377359,0.21320754716981133,0.07169811320754717,0.006603773584905661,Peak,Monday,August
2024-08-26 13:00:00,82,357,21,0,460,119,366,45,6,536,28.1,81,51,8.2,996,False,13,201,723,66,6,2024-08-26,False,False,False,0.7259036144578314,0.20180722891566266,0.06626506024096386,0.006024096385542169,Peak,Monday,August
2024-08-26 14:00:00,80,340,23,5,448,98,330,40,4,472,29.6,75,51,9.3,920,False,14,178,670,63,9,2024-08-26,False,False,False,0.7282608695652174,0.1934782608695652,0.06847826086956521,0.009782608695652175,Peak,Monday,August
2024-08-26 15:00:00,86,336,24,4,450,109,356,37,8,510,28.9,74,63,12.0,960,False,15,195,692,61,12,2024-08-26,False,False,False,0.7208333333333333,0.203125,0.06354166666666666,0.0125,Peak,Monday,August
2024-08-26 16:00:00,95,344,19,2,460,147,451,48,6,652,29.2,75,53,8.1,1112,False,16,242,795,67,8,2024-08-26,False,False,False,0.7149280575539568,0.21762589928057555,0.06025179856115108,0.007194244604316547,Peak,Monday,August
2024-08-26 17:00:00,92,368,13,2,475,122,434,54,3,613,28.7,73,53,13.9,1088,False,17,214,802,67,5,2024-08-26,False,False,False,0.7371323529411765,0.19669117647058823,0.06158088235294118,0.004595588235294118,Peak,Monday,August
2024-08-26 18:00:00,81,330,8,2,421,101,426,46,3,576,28.0,80,3,11.2,997,False,18,182,756,54,5,2024-08-26,False,False,False,0.7582748244734202,0.18254764292878636,0.05416248746238716,0.0050150451354062184,Peak,Monday,August
2024-08-26 19:00:00,73,326,5,0,404,97,410,41,5,553,27.4,82,2,11.5,957,False,19,170,736,46,5,2024-08-26,False,False,False,0.7690700104493208,0.17763845350052246,0.04806687565308255,0.00522466039707419,Peak,Monday,August
2024-08-26 20:00:00,65,313,3,0,381,88,384,40,4,516,26.9,84,2,13.1,897,False,20,153,697,43,4,2024-08-26,False,False,False,0.7770345596432553,0.1705685618729097,0.04793756967670011,0.004459308807134894,Shoulder,Monday,August
2024-08-26 21:00:00,52,241,2,0,295,77,358,37,0,472,25.9,90,3,5.7,767,False,21,129,599,39,0,2024-08-26,False,False,False,0.7809647979139505,0.1681877444589309,0.05084745762711865,0.0,Shoulder,Monday,August
2024-08-26 22:00:00,49,225,0,0,274,69,291,31,0,391,25.9,90,3,7.6,665,False,22,118,516,31,0,2024-08-26,False,False,False,0.7759398496240602,0.1774436090225564,0.04661654135338346,0.0,Shoulder,Monday,August
2024-08-26 23:00:00,41,213,0,0,254,67,260,28,0,355,25.7,91,3,5.6,609,False,23,108,473,28,0,2024-08-26,False,False,False,0.7766830870279147,0.17733990147783252,0.04597701149425287,0.0,Shoulder,Monday,August
2024-08-27 00:00:00,46,245,0,0,291,92,162,5,0,259,25.5,93,3,5.6,550,False,0,138,407,5,0,2024-08-27,False,False,False,0.74,0.2509090909090909,0.00909090909090909,0.0,Off-Peak,Tuesday,August
2024-08-27 01:00:00,57,216,0,0,273,90,155,7,0,252,24.9,93,61,10.8,525,False,1,147,371,7,0,2024-08-27,False,False,False,0.7066666666666667,0.28,0.013333333333333334,0.0,Off-Peak,Tuesday,August
2024-08-27 02:00:00,68,234,0,0,302,93,143,9,0,245,24.9,93,51,7.3,547,False,2,161,377,9,0,2024-08-27,False,False,False,0.6892138939670932,0.2943327239488117,0.016453382084095063,0.0,Off-Peak,Tuesday,August
2024-08-27 03:00:00,72,273,1,0,346,95,136,13,0,244,24.7,95,51,3.6,590,False,3,167,409,14,0,2024-08-27,False,False,False,0.6932203389830508,0.2830508474576271,0.023728813559322035,0.0,Off-Peak,Tuesday,August
2024-08-27 04:00:00,75,290,3,0,368,101,171,15,0,287,24.7,94,1,7.2,655,False,4,176,461,18,0,2024-08-27,False,False,False,0.7038167938931298,0.2687022900763359,0.02748091603053435,0.0,Off-Peak,Tuesday,August
2024-08-27 05:00:00,84,343,6,0,433,108,286,18,0,412,24.8,93,51,11.5,845,False,5,192,629,24,0,2024-08-27,False,False,False,0.744378698224852,0.2272189349112426,0.028402366863905324,0.0,Shoulder,Tuesday,August
2024-08-27 06:00:00,87,368,8,3,466,121,353,21,2,497,24.6,93,51,10.6,963,False,6,208,721,29,5,2024-08-27,False,False,False,0.7487019730010385,0.21599169262720663,0.030114226375908618,0.005192107995846314,Shoulder,Tuesday,August
2024-08-27 07:00:00,89,357,10,5,461,141,372,24,4,541,23.8,94,63,8.1,1002,False,7,230,729,34,9,2024-08-27,False,False,False,0.7275449101796407,0.22954091816367264,0.033932135728542916,0.008982035928143712,Peak,Tuesday,August
2024-08-27 08:00:00,93,344,13,3,453,115,396,27,3,541,24.7,91,61,3.3,994,False,8,208,740,40,6,2024-08-27,False,False,False,0.744466800804829,0.20925553319919518,0.04024144869215292,0.006036217303822937,Peak,Tuesday,August
2024-08-27 09:00:00,95,320,15,4,434,112,348,33,6,499,26.1,89,51,8.1,933,False,9,207,668,48,10,2024-08-27,False,False,False,0.7159699892818864,0.22186495176848875,0.05144694533762058,0.010718113612004287,Shoulder,Tuesday,August
2024-08-27 10:00:00,97,332,17,1,447,117,334,35,5,491,26.8,88,51,8.2,938,False,10,214,666,52,6,2024-08-27,False,False,False,0.7100213219616205,0.2281449893390192,0.05543710021321962,0.006396588486140725,Shoulder,Tuesday,August
2024-08-27 11:00:00,99,351,19,2,471,136,322,42,2,502,27.4,83,53,9.5,973,False,11,235,673,61,4,2024-08-27,False,False,False,0.6916752312435765,0.24152106885919836,0.06269270298047276,0.0041109969167523125,Peak,Tuesday,August
2024-08-27 12:00:00,98,373,20,1,492,154,356,44,3,557,26.2,86,63,15.0,1049,False,12,252,729,64,4,2024-08-27,False,False,False,0.6949475691134414,0.2402287893231649,0.061010486177311724,0.0038131553860819827,Peak,Tuesday,August
2024-08-27 13:00:00,96,357,21,4,478,121,377,39,3,540,27.6,82,51,14.6,1018,False,13,217,734,60,7,2024-08-27,False,False,False,0.7210216110019646,0.2131630648330059,0.05893909626719057,0.0068762278978389,Peak,Tuesday,August
2024-08-27 14:00:00,91,340,23,2,456,139,344,36,5,524,27.5,81,53,13.0,980,False,14,230,684,59,7,2024-08-27,False,False,False,0.6979591836734694,0.23469387755102042,0.06020408163265306,0.007142857142857143,Peak,Tuesday,August
2024-08-27 15:00:00,95,336,22,5,458,150,330,32,4,516,28.3,76,3,13.5,974,False,15,245,666,54,9,2024-08-27,False,False,False,0.6837782340862423,0.2515400410677618,0.055441478439425054,0.009240246406570842,Peak,Tuesday,August
2024-08-27 16:00:00,97,345,17,3,462,168,395,43,2,608,27.9,77,51,13.6,1070,False,16,265,740,60,5,2024-08-27,False,False,False,0.6915887850467289,0.24766355140186916,0.056074766355140186,0.004672897196261682,Peak,Tuesday,August
2024-08-27 17:00:00,88,364,14,2,468,187,413,37,3,640,28.0,78,51,9.9,1108,False,17,275,777,51,5,2024-08-27,False,False,False,0.7012635379061372,0.24819494584837545,0.046028880866425995,0.004512635379061372,Peak,Tuesday,August
2024-08-27 18:00:00,84,330,9,1,424,152,420,34,2,608,27.8,81,51,9.2,1032,False,18,236,750,43,3,2024-08-27,False,False,False,0.7267441860465116,0.22868217054263565,0.041666666666666664,0.0029069767441860465,Peak,Tuesday,August
2024-08-27 19:00:00,79,326,6,1,412,128,404,25,1,558,25.3,92,63,15.3,970,False,19,207,730,31,2,2024-08-27,False,False,False,0.7525773195876289,0.2134020618556701,0.031958762886597936,0.002061855670103093,Peak,Tuesday,August
2024-08-27 20:00:00,74,313,2,0,389,95,396,22,0,513,25.5,94,55,5.8,902,False,20,169,709,24,0,2024-08-27,False,False,False,0.7860310421286031,0.18736141906873613,0.026607538802660754,0.0,Shoulder,Tuesday,August
2024-08-27 21:00:00,65,242,0,0,307,89,362,14,0,465,25.9,89,53,11.2,772,False,21,154,604,14,0,2024-08-27,False,False,False,0.7823834196891192,0.19948186528497408,0.018134715025906734,0.0,Shoulder,Tuesday,August
2024-08-27 22:00:00,63,226,0,0,289,84,295,7,0,386,25.9,91,51,9.0,675,False,22,147,521,7,0,2024-08-27,False,False,False,0.7718518518518519,0.21777777777777776,0.01037037037037037,0.0,Shoulder,Tuesday,August
2024-08-27 23:00:00,56,214,0,0,270,81,284,4,0,369,25.7,91,51,10.9,639,False,23,137,498,4,0,2024-08-27,False,False,False,0.7793427230046949,0.21439749608763695,0.006259780907668232,0.0,Shoulder,Tuesday,August
2024-08-28 00:00:00,40,286,0,0,326,79,172,3,0,254,25.4,93,51,9.2,580,False,0,119,458,3,0,2024-08-28,False,False,False,0.7896551724137931,0.20517241379310344,0.005172413793103448,0.0,Off-Peak,Wednesday,August
2024-08-28 01:00:00,42,247,0,0,289,77,167,5,0,249,25.5,91,3,12.8,538,False,1,119,414,5,0,2024-08-28,False,False,False,0.7695167286245354,0.2211895910780669,0.00929368029739777,0.0,Off-Peak,Wednesday,August
2024-08-28 02:00:00,47,255,0,0,302,85,153,7,0,245,25.5,88,3,14.5,547,False,2,132,408,7,0,2024-08-28,False,False,False,0.7458866544789763,0.2413162705667276,0.012797074954296161,0.0,Off-Peak,Wednesday,August
2024-08-28 03:00:00,51,262,0,0,313,94,165,11,0,270,25.7,86,3,15.9,583,False,3,145,427,11,0,2024-08-28,False,False,False,0.7324185248713551,0.24871355060034306,0.018867924528301886,0.0,Off-Peak,Wednesday,August
2024-08-28 04:00:00,59,393,0,0,452,98,182,14,0,294,25.9,84,3,16.9,746,False,4,157,575,14,0,2024-08-28,False,False,False,0.7707774798927614,0.21045576407506703,0.01876675603217158,0.0,Off-Peak,Wednesday,August
2024-08-28 05:00:00,65,424,2,0,491,115,263,16,0,394,25.9,83,3,15.8,885,False,5,180,687,18,0,2024-08-28,False,False,False,0.7762711864406779,0.2033898305084746,0.020338983050847456,0.0,Shoulder,Wednesday,August
2024-08-28 06:00:00,78,445,3,0,526,128,354,22,3,507,25.9,84,3,15.2,1033,False,6,206,799,25,3,2024-08-28,False,False,False,0.7734753146176185,0.1994191674733785,0.02420135527589545,0.002904162633107454,Shoulder,Wednesday,August
2024-08-28 07:00:00,80,422,4,2,508,139,392,25,5,561,25.7,85,3,14.7,1069,False,7,219,814,29,7,2024-08-28,False,False,False,0.7614593077642656,0.2048643592142189,0.027128157156220765,0.006548175865294668,Peak,Wednesday,August
2024-08-28 08:00:00,89,450,10,5,554,125,375,27,3,530,26.0,85,3,13.5,1084,False,8,214,825,37,8,2024-08-28,False,False,False,0.761070110701107,0.1974169741697417,0.03413284132841329,0.007380073800738007,Peak,Wednesday,August
2024-08-28 09:00:00,78,435,12,3,528,117,347,31,4,499,25.5,86,2,6.8,1027,False,9,195,782,43,7,2024-08-28,False,False,False,0.7614410905550146,0.189873417721519,0.04186952288218111,0.006815968841285297,Shoulder,Wednesday,August
2024-08-28 10:00:00,81,429,12,1,523,104,328,34,1,467,27.1,80,3,8.4,990,False,10,185,757,46,2,2024-08-28,False,False,False,0.7646464646464647,0.18686868686868688,0.046464646464646465,0.00202020202020202,Shoulder,Wednesday,August
2024-08-28 11:00:00,83,383,11,1,478,115,333,35,2,485,28.2,75,3,8.6,963,False,11,198,716,46,3,2024-08-28,False,False,False,0.7435098650051921,0.205607476635514,0.04776739356178609,0.003115264797507788,Peak,Wednesday,August
2024-08-28 12:00:00,90,376,15,4,485,128,387,36,2,553,29.1,71,3,7.2,1038,False,12,218,763,51,6,2024-08-28,False,False,False,0.7350674373795761,0.21001926782273603,0.049132947976878616,0.005780346820809248,Peak,Wednesday,August
2024-08-28 13:00:00,82,368,15,3,468,117,396,40,4,557,29.7,69,3,7.4,1025,False,13,199,764,55,7,2024-08-28,False,False,False,0.7453658536585366,0.19414634146341464,0.05365853658536585,0.006829268292682927,Peak,Wednesday,August
2024-08-28 14:00:00,80,357,10,3,450,106,355,43,2,506,29.9,66,3,9.5,956,False,14,186,712,53,5,2024-08-28,False,False,False,0.7447698744769874,0.19456066945606695,0.05543933054393305,0.005230125523012552,Peak,Wednesday,August
2024-08-28 15:00:00,86,364,9,2,461,123,343,44,4,514,30.4,63,3,9.5,975,False,15,209,707,53,6,2024-08-28,False,False,False,0.7251282051282051,0.21435897435897436,0.05435897435897436,0.006153846153846154,Peak,Wednesday,August
2024-08-28 16:00:00,92,386,8,1,487,145,394,41,3,583,29.9,66,3,9.0,1070,False,16,237,780,49,4,2024-08-28,False,False,False,0.7289719626168224,0.22149532710280373,0.04579439252336449,0.003738317757009346,Peak,Wednesday,August
2024-08-28 17:00:00,90,388,7,2,487,130,433,33,2,598,29.5,68,3,7.2,1085,False,17,220,821,40,4,2024-08-28,False,False,False,0.7566820276497696,0.20276497695852536,0.03686635944700461,0.003686635944700461,Peak,Wednesday,August
2024-08-28 18:00:00,81,335,5,1,422,119,470,30,1,620,28.9,70,3,6.1,1042,False,18,200,805,35,2,2024-08-28,False,False,False,0.772552783109405,0.19193857965451055,0.03358925143953935,0.0019193857965451055,Peak,Wednesday,August
2024-08-28 19:00:00,73,298,1,1,373,105,457,22,1,585,28.0,78,3,3.8,958,False,19,178,755,23,2,2024-08-28,False,False,False,0.7881002087682673,0.18580375782881003,0.024008350730688934,0.0020876826722338203,Peak,Wednesday,August
2024-08-28 20:00:00,64,294,2,0,360,97,366,21,0,484,27.2,80,3,4.7,844,False,20,161,660,23,0,2024-08-28,False,False,False,0.7819905213270142,0.19075829383886256,0.027251184834123223,0.0,Shoulder,Wednesday,August
2024-08-28 21:00:00,51,278,0,0,329,94,333,15,0,442,25.4,84,61,16.9,771,False,21,145,611,15,0,2024-08-28,False,False,False,0.7924773022049286,0.1880674448767834,0.019455252918287938,0.0,Shoulder,Wednesday,August
2024-08-28 22:00:00,48,267,0,0,315,86,296,10,0,392,24.0,84,51,9.8,707,False,22,134,563,10,0,2024-08-28,False,False,False,0.7963224893917963,0.18953323903818953,0.014144271570014143,0.0,Shoulder,Wednesday,August
2024-08-28 23:00:00,40,256,0,0,296,82,284,8,0,374,23.7,85,3,8.7,670,False,23,122,540,8,0,2024-08-28,False,False,False,0.8059701492537313,0.18208955223880596,0.011940298507462687,0.0,Shoulder,Wednesday,August
2024-08-29 00:00:00,66,215,0,0,281,82,176,8,0,266,24.0,85,51,11.2,547,False,0,148,391,8,0,2024-08-29,False,False,False,0.7148080438756855,0.27056672760511885,0.014625228519195612,0.0,Off-Peak,Thursday,August
2024-08-29 01:00:00,60,241,0,0,301,80,169,11,0,260,24.1,87,3,6.8,561,False,1,140,410,11,0,2024-08-29,False,False,False,0.7308377896613191,0.24955436720142601,0.0196078431372549,0.0,Off-Peak,Thursday,August
2024-08-29 02:00:00,58,253,0,0,311,88,157,12,0,257,23.9,89,3,4.8,568,False,2,146,410,12,0,2024-08-29,False,False,False,0.721830985915493,0.25704225352112675,0.02112676056338028,0.0,Off-Peak,Thursday,August
2024-08-29 03:00:00,69,274,0,0,343,97,250,17,0,364,23.5,90,3,4.4,707,False,3,166,524,17,0,2024-08-29,False,False,False,0.7411598302687411,0.2347949080622348,0.024045261669024046,0.0,Off-Peak,Thursday,August
2024-08-29 04:00:00,76,307,3,0,386,101,283,18,0,402,24.2,85,3,2.4,788,False,4,177,590,21,0,2024-08-29,False,False,False,0.748730964467005,0.22461928934010153,0.0266497461928934,0.0,Off-Peak,Thursday,August
2024-08-29 05:00:00,90,326,6,0,422,118,409,22,0,549,23.0,92,3,2.5,971,False,5,208,735,28,0,2024-08-29,False,False,False,0.756951596292482,0.21421215242018538,0.028836251287332648,0.0,Shoulder,Thursday,August
2024-08-29 06:00:00,101,380,8,1,490,134,436,23,1,594,22.8,94,3,2.5,1084,False,6,235,816,31,2,2024-08-29,False,False,False,0.7527675276752768,0.21678966789667897,0.02859778597785978,0.0018450184501845018,Shoulder,Thursday,August
2024-08-29 07:00:00,100,389,10,5,504,142,422,29,4,597,23.4,91,3,4.5,1101,False,7,242,811,39,9,2024-08-29,False,False,False,0.7366030881017257,0.2198001816530427,0.035422343324250684,0.008174386920980926,Peak,Thursday,August
2024-08-29 08:00:00,99,399,13,2,513,128,410,32,4,574,24.1,90,3,6.1,1087,False,8,227,809,45,6,2024-08-29,False,False,False,0.7442502299908004,0.20883164673413063,0.04139834406623735,0.005519779208831647,Peak,Thursday,August
2024-08-29 09:00:00,95,435,15,4,549,120,357,38,7,522,25.6,88,3,7.5,1071,False,9,215,792,53,11,2024-08-29,False,False,False,0.7394957983193278,0.20074696545284781,0.04948646125116713,0.01027077497665733,Shoulder,Thursday,August
2024-08-29 10:00:00,91,453,17,1,562,107,339,44,3,493,27.2,80,3,4.0,1055,False,10,198,792,61,4,2024-08-29,False,False,False,0.7507109004739336,0.1876777251184834,0.05781990521327014,0.0037914691943127963,Shoulder,Thursday,August
2024-08-29 11:00:00,89,460,19,3,571,118,345,49,4,516,28.8,76,3,7.1,1087,False,11,207,805,68,7,2024-08-29,False,False,False,0.7405703771849126,0.19043238270469182,0.062557497700092,0.006439742410303588,Peak,Thursday,August
2024-08-29 12:00:00,98,449,20,1,568,134,376,38,1,549,29.8,73,3,9.7,1117,False,12,232,825,58,2,2024-08-29,False,False,False,0.738585496866607,0.20769919427036707,0.051924798567591766,0.0017905102954341987,Peak,Thursday,August
2024-08-29 13:00:00,96,431,21,4,552,130,364,37,5,536,30.3,69,3,11.9,1088,False,13,226,795,58,9,2024-08-29,False,False,False,0.7306985294117647,0.20772058823529413,0.05330882352941176,0.008272058823529412,Peak,Thursday,August
2024-08-29 14:00:00,84,416,23,2,525,109,328,27,1,465,30.4,66,2,11.3,990,False,14,193,744,50,3,2024-08-29,False,False,False,0.7515151515151515,0.19494949494949496,0.050505050505050504,0.0030303030303030303,Peak,Thursday,August
2024-08-29 15:00:00,87,433,22,3,545,124,354,27,2,507,30.6,64,3,10.7,1052,False,15,211,787,49,5,2024-08-29,False,False,False,0.7480988593155894,0.2005703422053232,0.04657794676806084,0.004752851711026616,Peak,Thursday,August
2024-08-29 16:00:00,95,452,17,2,566,145,439,36,4,624,30.3,64,3,11.4,1190,False,16,240,891,53,6,2024-08-29,False,False,False,0.7487394957983193,0.20168067226890757,0.04453781512605042,0.005042016806722689,Peak,Thursday,August
2024-08-29 17:00:00,98,441,14,3,556,132,422,45,4,603,29.9,64,3,10.1,1159,False,17,230,863,59,7,2024-08-29,False,False,False,0.7446074201898188,0.1984469370146678,0.05090595340811044,0.0060396893874029335,Peak,Thursday,August
2024-08-29 18:00:00,97,425,9,1,532,120,414,41,1,576,29.2,67,3,8.4,1108,False,18,217,839,50,2,2024-08-29,False,False,False,0.7572202166064982,0.19584837545126355,0.04512635379061372,0.0018050541516245488,Peak,Thursday,August
2024-08-29 19:00:00,88,344,6,3,441,116,384,40,2,542,28.1,75,2,5.4,983,False,19,204,728,46,5,2024-08-29,False,False,False,0.7405900305188199,0.20752797558494404,0.04679552390640895,0.00508646998982706,Peak,Thursday,August
2024-08-29 20:00:00,74,303,2,0,379,98,362,37,0,497,27.4,79,3,5.4,876,False,20,172,665,39,0,2024-08-29,False,False,False,0.7591324200913242,0.1963470319634703,0.04452054794520548,0.0,Shoulder,Thursday,August
2024-08-29 21:00:00,65,251,0,0,316,95,348,36,0,479,27.3,80,3,7.5,795,False,21,160,599,36,0,2024-08-29,False,False,False,0.7534591194968554,0.20125786163522014,0.045283018867924525,0.0,Shoulder,Thursday,August
2024-08-29 22:00:00,62,217,0,0,279,87,289,28,0,404,26.9,81,3,7.9,683,False,22,149,506,28,0,2024-08-29,False,False,False,0.7408491947291361,0.21815519765739386,0.040995607613469986,0.0,Shoulder,Thursday,August
2024-08-29 23:00:00,58,206,0,0,264,83,258,27,0,368,26.6,81,3,8.7,632,False,23,141,464,27,0,2024-08-29,False,False,False,0.7341772151898734,0.2231012658227848,0.04272151898734177,0.0,Shoulder,Thursday,August
2024-08-30 00:00:00,45,223,0,0,268,94,178,11,0,283,26.3,78,3,10.1,551,False,0,139,401,11,0,2024-08-30,False,False,False,0.7277676950998185,0.25226860254083483,0.019963702359346643,0.0,Off-Peak,Friday,August
2024-08-30 01:00:00,56,245,0,0,301,92,173,12,0,277,25.9,79,3,7.2,578,False,1,148,418,12,0,2024-08-30,False,False,False,0.7231833910034602,0.2560553633217993,0.020761245674740483,0.0,Off-Peak,Friday,August
2024-08-30 02:00:00,67,272,0,0,339,95,159,15,0,269,25.2,82,3,4.8,608,False,2,162,431,15,0,2024-08-30,False,False,False,0.7088815789473685,0.26644736842105265,0.024671052631578948,0.0,Off-Peak,Friday,August
2024-08-30 03:00:00,70,316,4,0,390,97,252,18,0,367,25.2,83,3,6.9,757,False,3,167,568,22,0,2024-08-30,False,False,False,0.750330250990753,0.22060766182298547,0.02906208718626156,0.0,Off-Peak,Friday,August
2024-08-30 04:00:00,74,334,6,0,414,103,285,21,0,409,24.7,87,3,4.7,823,False,4,177,619,27,0,2024-08-30,False,False,False,0.7521263669501823,0.21506682867557717,0.032806804374240585,0.0,Off-Peak,Friday,August
2024-08-30 05:00:00,83,365,7,0,455,110,421,27,0,558,24.7,86,3,5.8,1013,False,5,193,786,34,0,2024-08-30,False,False,False,0.7759131293188549,0.19052319842053306,0.03356367226061204,0.0,Shoulder,Friday,August
2024-08-30 06:00:00,86,400,8,2,496,123,448,36,3,610,24.6,86,3,5.8,1106,False,6,209,848,44,5,2024-08-30,False,False,False,0.7667269439421338,0.18896925858951175,0.039783001808318265,0.0045207956600361665,Shoulder,Friday,August
2024-08-30 07:00:00,88,413,10,4,515,144,434,33,6,617,24.8,86,3,7.2,1132,False,7,232,847,43,10,2024-08-30,False,False,False,0.7482332155477032,0.2049469964664311,0.037985865724381625,0.0088339222614841,Peak,Friday,August
2024-08-30 08:00:00,92,421,14,1,528,117,412,32,5,566,25.5,87,3,7.6,1094,False,8,209,833,46,6,2024-08-30,False,False,False,0.7614259597806216,0.1910420475319927,0.04204753199268738,0.005484460694698354,Peak,Friday,August
2024-08-30 09:00:00,94,436,16,7,553,114,359,39,4,516,26.4,84,2,6.8,1069,False,9,208,795,55,11,2024-08-30,False,False,False,0.7436856875584659,0.19457436856875585,0.05144995322731525,0.01028999064546305,Shoulder,Friday,August
2024-08-30 10:00:00,95,448,19,5,567,119,341,42,7,509,28.2,77,1,6.5,1076,False,10,214,789,61,12,2024-08-30,False,False,False,0.733271375464684,0.19888475836431227,0.056691449814126396,0.011152416356877323,Shoulder,Friday,August
2024-08-30 11:00:00,98,439,22,8,567,138,347,45,5,535,29.3,72,3,9.5,1102,False,11,236,786,67,13,2024-08-30,False,False,False,0.7132486388384754,0.21415607985480944,0.060798548094373864,0.011796733212341199,Peak,Friday,August
2024-08-30 12:00:00,97,430,26,2,555,156,378,56,4,594,29.8,70,3,12.4,1149,False,12,253,808,82,6,2024-08-30,False,False,False,0.7032201914708442,0.22019147084421237,0.07136640557006092,0.005221932114882507,Peak,Friday,August
2024-08-30 13:00:00,95,408,24,7,534,123,366,45,6,540,30.3,67,3,14.2,1074,False,13,218,774,69,13,2024-08-30,False,False,False,0.7206703910614525,0.20297951582867785,0.06424581005586592,0.012104283054003724,Peak,Friday,August
2024-08-30 14:00:00,90,424,21,1,536,141,330,40,3,514,30.4,66,3,15.6,1050,False,14,231,754,61,4,2024-08-30,False,False,False,0.7180952380952381,0.22,0.058095238095238096,0.0038095238095238095,Peak,Friday,August
2024-08-30 15:00:00,94,455,19,4,572,152,356,37,2,547,30.1,67,3,14.7,1119,False,15,246,811,56,6,2024-08-30,False,False,False,0.7247542448614834,0.21983914209115282,0.050044682752457555,0.005361930294906166,Peak,Friday,August
2024-08-30 16:00:00,96,465,16,1,578,170,451,54,3,678,30.3,65,3,14.7,1256,False,16,266,916,70,4,2024-08-30,False,False,False,0.7292993630573248,0.21178343949044587,0.05573248407643312,0.0031847133757961785,Peak,Friday,August
2024-08-30 17:00:00,87,431,14,2,534,189,434,65,3,691,29.8,69,3,14.7,1225,False,17,276,865,79,5,2024-08-30,False,False,False,0.7061224489795919,0.2253061224489796,0.06448979591836734,0.004081632653061225,Peak,Friday,August
2024-08-30 18:00:00,83,412,11,1,507,154,426,56,2,638,29.1,73,3,13.5,1145,False,18,237,838,67,3,2024-08-30,False,False,False,0.7318777292576419,0.20698689956331878,0.05851528384279476,0.0026200873362445414,Peak,Friday,August
2024-08-30 19:00:00,78,343,8,0,429,130,410,49,0,589,28.4,77,2,12.5,1018,False,19,208,753,57,0,2024-08-30,False,False,False,0.7396856581532416,0.2043222003929273,0.055992141453831044,0.0,Peak,Friday,August
2024-08-30 20:00:00,74,314,6,0,394,126,384,40,0,550,28.1,78,2,10.7,944,False,20,200,698,46,0,2024-08-30,False,False,False,0.739406779661017,0.211864406779661,0.048728813559322036,0.0,Shoulder,Friday,August
2024-08-30 21:00:00,65,287,3,0,355,109,358,37,0,504,27.2,80,3,7.3,859,False,21,174,645,40,0,2024-08-30,False,False,False,0.7508731082654249,0.20256111757857975,0.046565774155995346,0.0,Shoulder,Friday,August
2024-08-30 22:00:00,62,245,0,0,307,86,291,31,0,408,26.9,81,3,7.5,715,False,22,148,536,31,0,2024-08-30,False,False,False,0.7496503496503496,0.206993006993007,0.043356643356643354,0.0,Shoulder,Friday,August
2024-08-30 23:00:00,55,212,0,0,267,83,264,28,0,375,26.6,81,3,6.0,642,False,23,138,476,28,0,2024-08-30,False,False,False,0.7414330218068536,0.21495327102803738,0.04361370716510903,0.0,Shoulder,Friday,August
2024-08-31 00:00:00,57,237,0,0,294,318,287,7,0,612,25.9,87,3,5.8,906,True,0,375,524,7,0,2024-08-31,True,True,False,0.5783664459161147,0.4139072847682119,0.00772626931567329,0.0,Off-Peak,Saturday,August
2024-08-31 01:00:00,59,259,0,0,318,263,280,12,0,555,25.9,86,3,4.3,873,True,1,322,539,12,0,2024-08-31,True,True,False,0.6174112256586484,0.36884306987399773,0.013745704467353952,0.0,Off-Peak,Saturday,August
2024-08-31 02:00:00,67,244,0,0,311,96,268,11,0,375,25.7,87,3,4.4,686,True,2,163,512,11,0,2024-08-31,True,True,False,0.7463556851311953,0.23760932944606414,0.016034985422740525,0.0,Off-Peak,Saturday,August
2024-08-31 03:00:00,69,330,0,0,399,99,231,18,0,348,25.6,88,3,3.2,747,True,3,168,561,18,0,2024-08-31,True,True,False,0.751004016064257,0.2248995983935743,0.024096385542168676,0.0,Off-Peak,Saturday,August
2024-08-31 04:00:00,75,345,0,0,420,105,265,17,0,387,25.5,88,3,5.4,807,True,4,180,610,17,0,2024-08-31,True,True,False,0.7558859975216853,0.22304832713754646,0.021065675340768277,0.0,Off-Peak,Saturday,August
2024-08-31 05:00:00,88,376,1,0,465,112,270,23,0,405,25.4,91,3,3.6,870,True,5,200,646,24,0,2024-08-31,True,True,False,0.7425287356321839,0.22988505747126436,0.027586206896551724,0.0,Shoulder,Saturday,August
2024-08-31 06:00:00,89,405,4,0,498,125,287,22,2,436,25.1,93,3,4.0,934,True,6,214,692,26,2,2024-08-31,True,True,False,0.7408993576017131,0.2291220556745182,0.027837259100642397,0.0021413276231263384,Shoulder,Saturday,August
2024-08-31 07:00:00,92,416,5,3,516,135,361,30,2,528,25.4,93,3,5.6,1044,True,7,227,777,35,5,2024-08-31,True,True,False,0.7442528735632183,0.21743295019157088,0.033524904214559385,0.004789272030651341,Peak,Saturday,August
2024-08-31 08:00:00,94,427,9,4,534,172,425,31,3,631,26.3,91,3,6.9,1165,True,8,266,852,40,7,2024-08-31,True,True,False,0.7313304721030043,0.22832618025751072,0.034334763948497854,0.006008583690987125,Peak,Saturday,August
2024-08-31 09:00:00,97,411,10,2,520,268,469,39,6,782,25.1,92,51,4.1,1302,True,9,365,880,49,8,2024-08-31,True,True,False,0.6758832565284179,0.2803379416282642,0.03763440860215054,0.006144393241167435,Shoulder,Saturday,August
2024-08-31 10:00:00,100,451,13,2,566,287,548,45,5,885,27.2,87,51,4.3,1451,True,10,387,999,58,7,2024-08-31,True,True,True,0.6884906960716747,0.26671261199172985,0.03997243280496209,0.004824259131633356,Shoulder,Saturday,August
2024-08-31 11:00:00,106,443,14,1,564,319,576,48,4,947,28.9,80,51,4.1,1511,True,11,425,1019,62,5,2024-08-31,True,True,True,0.6743878226340172,0.2812706816677697,0.04103242885506287,0.0033090668431502318,Peak,Saturday,August
2024-08-31 12:00:00,98,434,15,3,550,324,617,39,3,983,29.5,78,51,0.7,1533,True,12,422,1051,54,6,2024-08-31,True,True,True,0.685583822570124,0.27527723418134376,0.03522504892367906,0.003913894324853229,Peak,Saturday,August
2024-08-31 13:00:00,95,401,16,2,514,336,629,36,3,1004,30.2,75,51,3.7,1518,True,13,431,1030,52,5,2024-08-31,True,True,True,0.6785243741765481,0.2839262187088274,0.034255599472990776,0.0032938076416337285,Peak,Saturday,August
2024-08-31 14:00:00,97,432,12,4,545,341,622,28,1,992,29.4,71,53,7.6,1537,True,14,438,1054,40,5,2024-08-31,True,True,True,0.6857514638906962,0.2849707221860768,0.026024723487312947,0.0032530904359141183,Peak,Saturday,August
2024-08-31 15:00:00,99,456,11,1,567,337,643,26,2,1008,28.4,77,3,5.5,1575,True,15,436,1099,37,3,2024-08-31,True,True,True,0.6977777777777778,0.2768253968253968,0.02349206349206349,0.0019047619047619048,Peak,Saturday,August
2024-08-31 16:00:00,108,464,8,2,582,328,675,37,1,1041,28.9,76,3,5.4,1623,True,16,436,1139,45,3,2024-08-31,True,True,True,0.7017868145409735,0.26863832409118915,0.027726432532347505,0.0018484288354898336,Peak,Saturday,August
2024-08-31 17:00:00,96,453,6,1,556,255,686,44,2,987,28.7,76,3,5.8,1543,True,17,351,1139,50,3,2024-08-31,True,True,True,0.7381723914452365,0.22747893713545042,0.03240440699935191,0.0019442644199611147,Peak,Saturday,August
2024-08-31 18:00:00,91,425,4,2,522,135,445,42,0,622,28.4,78,3,4.4,1144,True,18,226,870,46,2,2024-08-31,True,True,False,0.7604895104895105,0.19755244755244755,0.04020979020979021,0.0017482517482517483,Peak,Saturday,August
2024-08-31 19:00:00,90,407,3,1,501,112,439,39,0,590,27.6,85,3,3.1,1091,True,19,202,846,42,1,2024-08-31,True,True,False,0.775435380384968,0.1851512373968836,0.0384967919340055,0.0009165902841429881,Peak,Saturday,August
2024-08-31 20:00:00,89,313,2,0,404,106,431,38,0,575,27.0,87,3,2.5,979,True,20,195,744,40,0,2024-08-31,True,True,False,0.7599591419816139,0.19918283963227784,0.04085801838610827,0.0,Shoulder,Saturday,August
2024-08-31 21:00:00,86,282,0,0,368,94,424,35,0,553,27.0,88,3,4.1,921,True,21,180,706,35,0,2024-08-31,True,True,False,0.7665580890336591,0.19543973941368079,0.038002171552660155,0.0,Shoulder,Saturday,August
2024-08-31 22:00:00,85,234,0,0,319,98,417,29,0,544,26.9,86,3,6.5,863,True,22,183,651,29,0,2024-08-31,True,True,False,0.7543453070683661,0.21205098493626884,0.03360370799536501,0.0,Shoulder,Saturday,August
2024-08-31 23:00:00,81,216,0,0,297,92,419,26,0,537,26.3,91,3,3.9,834,True,23,173,635,26,0,2024-08-31,True,True,False,0.7613908872901679,0.20743405275779375,0.03117505995203837,0.0,Shoulder,Saturday,August
2024-09-01 00:00:00,223,491,10,1,725,241,370,12,2,625,26.4,90,3,6.0,1350,True,0,464,861,22,3,2024-09-01,False,True,False,0.6377777777777778,0.3437037037037037,0.016296296296296295,0.0022222222222222222,Off-Peak,Sunday,September
2024-09-01 01:00:00,220,489,10,1,720,233,388,11,2,634,26.2,92,3,7.1,1354,True,1,453,877,21,3,2024-09-01,False,True,False,0.6477104874446086,0.3345642540620384,0.0155096011816839,0.0022156573116691287,Off-Peak,Sunday,September
2024-09-01 02:00:00,219,487,11,1,718,238,397,11,2,648,26.0,92,3,4.7,1366,True,2,457,884,22,3,2024-09-01,False,True,False,0.6471449487554904,0.33455344070278187,0.016105417276720352,0.0021961932650073207,Off-Peak,Sunday,September
2024-09-01 03:00:00,220,489,10,1,720,241,396,13,2,652,25.8,92,3,4.8,1372,True,3,461,885,23,3,2024-09-01,False,True,False,0.6450437317784257,0.3360058309037901,0.016763848396501458,0.002186588921282799,Off-Peak,Sunday,September
2024-09-01 04:00:00,219,491,10,1,721,247,400,12,2,661,25.6,92,3,5.6,1382,True,4,466,891,22,3,2024-09-01,False,True,True,0.6447178002894356,0.33719247467438496,0.015918958031837915,0.002170767004341534,Off-Peak,Sunday,September
2024-09-01 05:00:00,219,493,9,1,722,249,402,14,2,667,25.4,93,3,3.9,1389,True,5,468,895,23,3,2024-09-01,False,True,True,0.6443484521238301,0.3369330453563715,0.01655867530597552,0.0021598272138228943,Shoulder,Sunday,September
2024-09-01 06:00:00,224,495,12,2,733,239,410,15,3,667,25.1,94,3,3.1,1400,True,6,463,905,27,5,2024-09-01,False,True,True,0.6464285714285715,0.33071428571428574,0.019285714285714285,0.0035714285714285713,Shoulder,Sunday,September
2024-09-01 07:00:00,221,497,11,1,730,244,406,21,3,674,25.0,94,3,3.3,1404,True,7,465,903,32,4,2024-09-01,False,True,True,0.6431623931623932,0.3311965811965812,0.022792022792022793,0.002849002849002849,Peak,Sunday,September
2024-09-01 08:00:00,223,501,12,2,738,244,401,24,4,673,25.7,93,3,4.7,1411,True,8,467,902,36,6,2024-09-01,False,True,True,0.6392629340892984,0.330970942593905,0.025513819985825654,0.004252303330970942,Peak,Sunday,September
2024-09-01 09:00:00,229,500,10,2,741,244,397,18,2,661,26.9,85,1,3.1,1402,True,9,473,897,28,4,2024-09-01,False,True,True,0.6398002853067047,0.33737517831669045,0.019971469329529243,0.0028530670470756064,Shoulder,Sunday,September
2024-09-01 10:00:00,221,511,10,1,743,240,398,15,2,655,28.6,80,2,1.6,1398,True,10,461,909,25,3,2024-09-01,False,True,True,0.6502145922746781,0.32975679542203146,0.0178826895565093,0.002145922746781116,Shoulder,Sunday,September
2024-09-01 11:00:00,219,498,9,1,727,242,397,12,3,654,28.9,80,53,10.9,1381,True,11,461,895,21,4,2024-09-01,False,True,True,0.6480811006517017,0.333816075307748,0.015206372194062274,0.002896451846488052,Peak,Sunday,September
2024-09-01 12:00:00,216,497,10,1,724,241,412,12,3,668,27.9,85,51,11.8,1392,True,12,457,909,22,4,2024-09-01,False,True,True,0.6530172413793104,0.32830459770114945,0.015804597701149427,0.0028735632183908046,Peak,Sunday,September
2024-09-01 13:00:00,218,495,13,1,727,239,400,12,2,653,28.4,82,3,12.1,1380,True,13,457,895,25,3,2024-09-01,False,True,True,0.6485507246376812,0.33115942028985507,0.018115942028985508,0.002173913043478261,Peak,Sunday,September
2024-09-01 14:00:00,215,494,11,1,721,240,403,13,2,658,28.8,80,3,13.2,1379,True,14,455,897,24,3,2024-09-01,False,True,True,0.6504713560551124,0.3299492385786802,0.01740391588107324,0.002175489485134155,Peak,Sunday,September
2024-09-01 15:00:00,219,495,10,2,726,246,399,17,3,665,29.0,79,3,11.3,1391,True,15,465,894,27,5,2024-09-01,False,True,True,0.6427030913012222,0.3342918763479511,0.019410496046010063,0.0035945363048166786,Peak,Sunday,September
2024-09-01 16:00:00,221,493,10,1,725,249,411,12,3,675,29.1,78,3,9.2,1400,True,16,470,904,22,4,2024-09-01,False,True,True,0.6457142857142857,0.3357142857142857,0.015714285714285715,0.002857142857142857,Peak,Sunday,September
2024-09-01 17:00:00,225,500,11,2,738,240,403,15,3,661,28.9,78,3,8.6,1399,True,17,465,903,26,5,2024-09-01,False,True,True,0.6454610436025733,0.33238027162258754,0.01858470335954253,0.0035739814152966403,Peak,Sunday,September
2024-09-01 18:00:00,231,499,10,1,741,242,401,10,3,656,28.5,79,3,5.9,1397,True,18,473,900,20,4,2024-09-01,False,True,True,0.6442376521116678,0.33858267716535434,0.014316392269148175,0.002863278453829635,Peak,Sunday,September
2024-09-01 19:00:00,229,504,9,1,743,239,397,14,2,652,27.7,84,3,2.6,1395,True,19,468,901,23,3,2024-09-01,False,True,True,0.6458781362007169,0.33548387096774196,0.016487455197132617,0.002150537634408602,Peak,Sunday,September
2024-09-01 20:00:00,215,498,10,1,724,235,389,12,2,638,26.9,89,3,4.1,1362,True,20,450,887,22,3,2024-09-01,False,True,False,0.6512481644640234,0.3303964757709251,0.016152716593245228,0.0022026431718061676,Shoulder,Sunday,September
2024-09-01 21:00:00,221,485,9,1,716,229,393,12,2,636,28.0,82,3,2.9,1352,True,21,450,878,21,3,2024-09-01,False,True,False,0.6494082840236687,0.3328402366863905,0.015532544378698224,0.0022189349112426036,Shoulder,Sunday,September
2024-09-01 22:00:00,221,487,9,1,718,230,391,10,2,633,28.0,81,3,1.5,1351,True,22,451,878,19,3,2024-09-01,False,True,False,0.6498889711324944,0.3338267949666913,0.014063656550703183,0.0022205773501110288,Shoulder,Sunday,September
2024-09-01 23:00:00,219,495,7,1,722,236,390,11,2,639,26.5,90,3,2.3,1361,True,23,455,885,18,3,2024-09-01,False,True,False,0.6502571638501102,0.334313005143277,0.01322556943423953,0.002204261572373255,Shoulder,Sunday,September
2024-09-02 00:00:00,159,449,10,2,620,177,299,6,3,485,26.3,90,3,3.6,1105,False,0,336,748,16,5,2024-09-02,False,False,False,0.676923076923077,0.3040723981900452,0.014479638009049774,0.004524886877828055,Off-Peak,Monday,September
2024-09-02 01:00:00,140,457,11,2,610,180,301,6,2,489,25.8,93,3,2.9,1099,False,1,320,758,17,4,2024-09-02,False,False,False,0.6897179253867152,0.2911737943585077,0.015468607825295723,0.003639672429481347,Off-Peak,Monday,September
2024-09-02 02:00:00,141,461,10,3,615,178,320,5,3,506,25.2,95,3,2.1,1121,False,2,319,781,15,6,2024-09-02,False,False,False,0.6966993755575379,0.28456735057983945,0.013380909901873328,0.0053523639607493305,Off-Peak,Monday,September
2024-09-02 03:00:00,139,470,7,2,618,169,317,4,3,493,25.2,92,3,4.0,1111,False,3,308,787,11,5,2024-09-02,False,False,False,0.7083708370837084,0.27722772277227725,0.009900990099009901,0.004500450045004501,Off-Peak,Monday,September
2024-09-02 04:00:00,146,473,8,2,629,176,303,5,1,485,25.1,94,3,5.6,1114,False,4,322,776,13,3,2024-09-02,False,False,False,0.696588868940754,0.289048473967684,0.011669658886894075,0.0026929982046678637,Off-Peak,Monday,September
2024-09-02 05:00:00,152,479,9,2,642,163,329,6,2,500,26.1,95,3,5.7,1142,False,5,315,808,15,4,2024-09-02,False,False,False,0.7075306479859895,0.27583187390542907,0.013134851138353765,0.0035026269702276708,Shoulder,Monday,September
2024-09-02 06:00:00,160,483,8,3,654,189,355,6,3,553,26.5,91,3,9.7,1207,False,6,349,838,14,6,2024-09-02,False,False,False,0.6942833471416736,0.2891466445733223,0.0115990057995029,0.004971002485501243,Shoulder,Monday,September
2024-09-02 07:00:00,172,487,16,2,677,191,392,12,6,601,26.1,91,51,7.6,1278,False,7,363,879,28,8,2024-09-02,False,False,False,0.687793427230047,0.284037558685446,0.02190923317683881,0.006259780907668232,Peak,Monday,September
2024-09-02 08:00:00,181,489,19,3,692,180,377,15,5,577,26.8,88,1,7.6,1269,False,8,361,866,34,8,2024-09-02,False,False,False,0.6824271079590228,0.2844759653270292,0.026792750197005517,0.006304176516942475,Peak,Monday,September
2024-09-02 09:00:00,194,491,15,2,702,152,389,12,4,557,27.0,85,53,12.4,1259,False,9,346,880,27,6,2024-09-02,False,False,False,0.698967434471803,0.2748212867355044,0.021445591739475776,0.004765687053216839,Shoulder,Monday,September
2024-09-02 10:00:00,197,500,12,1,710,149,370,9,3,531,27.7,84,51,9.0,1241,False,10,346,870,21,4,2024-09-02,False,False,False,0.7010475423045931,0.27880741337630943,0.016921837228041903,0.0032232070910556,Shoulder,Monday,September
2024-09-02 11:00:00,186,498,9,2,695,144,369,6,3,522,27.6,82,63,14.2,1217,False,11,330,867,15,5,2024-09-02,False,False,False,0.7124075595727198,0.27115858668857845,0.012325390304026294,0.004108463434675432,Peak,Monday,September
2024-09-02 12:00:00,154,493,10,1,658,138,341,6,3,488,27.9,84,53,9.4,1146,False,12,292,834,16,4,2024-09-02,False,False,False,0.7277486910994765,0.2547993019197208,0.013961605584642234,0.0034904013961605585,Peak,Monday,September
2024-09-02 13:00:00,148,487,9,1,645,149,312,5,5,471,29.1,80,3,6.5,1116,False,13,297,799,14,6,2024-09-02,False,False,False,0.7159498207885304,0.2661290322580645,0.012544802867383513,0.005376344086021506,Peak,Monday,September
2024-09-02 14:00:00,144,486,10,2,642,142,329,5,3,479,29.6,78,51,8.8,1121,False,14,286,815,15,5,2024-09-02,False,False,False,0.7270294380017841,0.25512934879571814,0.013380909901873328,0.0044603033006244425,Peak,Monday,September
2024-09-02 15:00:00,162,488,9,2,661,177,344,6,2,529,29.2,77,3,9.4,1190,False,15,339,832,15,4,2024-09-02,False,False,False,0.6991596638655462,0.2848739495798319,0.012605042016806723,0.0033613445378151263,Peak,Monday,September
2024-09-02 16:00:00,173,482,10,4,669,181,368,9,4,562,29.6,77,2,8.0,1231,False,16,354,850,19,8,2024-09-02,False,False,False,0.6904955320877335,0.2875710804224208,0.015434606011372868,0.006498781478472786,Peak,Monday,September
2024-09-02 17:00:00,181,489,15,3,688,199,372,10,5,586,29.7,75,1,6.4,1274,False,17,380,861,25,8,2024-09-02,False,False,False,0.6758241758241759,0.29827315541601257,0.019623233908948195,0.006279434850863423,Peak,Monday,September
2024-09-02 18:00:00,189,487,14,4,694,172,401,9,4,586,29.6,74,1,7.6,1280,False,18,361,888,23,8,2024-09-02,False,False,False,0.69375,0.28203125,0.01796875,0.00625,Peak,Monday,September
2024-09-02 19:00:00,178,491,16,2,687,161,399,6,2,568,28.6,79,3,7.6,1255,False,19,339,890,22,4,2024-09-02,False,False,False,0.7091633466135459,0.2701195219123506,0.01752988047808765,0.0031872509960159364,Peak,Monday,September
2024-09-02 20:00:00,171,481,10,1,663,163,378,5,2,548,27.9,84,3,10.0,1211,False,20,334,859,15,3,2024-09-02,False,False,False,0.7093311312964492,0.27580511973575556,0.012386457473162676,0.002477291494632535,Shoulder,Monday,September
2024-09-02 21:00:00,167,479,9,2,657,160,359,6,1,526,27.6,84,2,7.2,1183,False,21,327,838,15,3,2024-09-02,False,False,False,0.7083685545224007,0.2764158918005072,0.01267962806424345,0.00253592561284869,Shoulder,Monday,September
2024-09-02 22:00:00,153,474,9,1,637,178,321,6,2,507,27.0,88,2,4.0,1144,False,22,331,795,15,3,2024-09-02,False,False,False,0.6949300699300699,0.2893356643356643,0.013111888111888112,0.0026223776223776225,Shoulder,Monday,September
2024-09-02 23:00:00,148,471,11,2,632,172,299,4,2,477,26.6,89,3,3.6,1109,False,23,320,770,15,4,2024-09-02,False,False,False,0.6943192064923355,0.2885482416591524,0.013525698827772768,0.0036068530207394047,Shoulder,Monday,September
2024-09-03 00:00:00,209,540,19,3,771,241,421,4,4,670,26.3,90,3,5.1,1441,False,0,450,961,23,7,2024-09-03,False,False,True,0.6668979875086746,0.31228313671061764,0.015961138098542677,0.004857737682165163,Off-Peak,Tuesday,September
2024-09-03 01:00:00,221,539,6,1,767,244,420,7,2,673,25.7,93,3,4.1,1440,False,1,465,959,13,3,2024-09-03,False,False,True,0.6659722222222222,0.3229166666666667,0.009027777777777777,0.0020833333333333333,Off-Peak,Tuesday,September
2024-09-03 02:00:00,217,522,13,3,755,239,411,1,3,654,25.6,94,3,1.9,1409,False,2,456,933,14,6,2024-09-03,False,False,True,0.6621717530163236,0.32363378282469835,0.0099361249112846,0.0042583392476933995,Off-Peak,Tuesday,September
2024-09-03 03:00:00,209,499,9,2,719,236,403,4,3,646,25.4,94,3,1.9,1365,False,3,445,902,13,5,2024-09-03,False,False,False,0.6608058608058608,0.326007326007326,0.009523809523809525,0.003663003663003663,Off-Peak,Tuesday,September
2024-09-03 04:00:00,210,529,10,1,750,242,421,6,2,671,25.5,95,3,3.2,1421,False,4,452,950,16,3,2024-09-03,False,False,True,0.6685432793807178,0.31808585503166786,0.011259676284306826,0.00211118930330753,Off-Peak,Tuesday,September
2024-09-03 05:00:00,220,538,12,3,773,247,448,5,5,705,25.7,96,51,5.0,1478,False,5,467,986,17,8,2024-09-03,False,False,True,0.6671177266576455,0.3159675236806495,0.011502029769959404,0.005412719891745603,Shoulder,Tuesday,September
2024-09-03 06:00:00,219,564,21,4,808,251,452,8,5,716,24.6,97,63,11.5,1524,False,6,470,1016,29,9,2024-09-03,False,False,True,0.6666666666666666,0.3083989501312336,0.019028871391076115,0.005905511811023622,Shoulder,Tuesday,September
2024-09-03 07:00:00,220,562,19,3,804,256,469,12,6,743,25.3,93,51,4.8,1547,False,7,476,1031,31,9,2024-09-03,False,False,True,0.6664511958629605,0.3076923076923077,0.0200387847446671,0.005817711700064641,Peak,Tuesday,September
2024-09-03 08:00:00,229,559,21,1,810,263,458,9,8,738,25.9,91,3,1.6,1548,False,8,492,1017,30,9,2024-09-03,False,False,True,0.6569767441860465,0.3178294573643411,0.01937984496124031,0.005813953488372093,Peak,Tuesday,September
2024-09-03 09:00:00,222,560,14,4,800,268,448,9,2,727,26.2,90,53,4.3,1527,False,9,490,1008,23,6,2024-09-03,False,False,True,0.6601178781925344,0.320890635232482,0.015062213490504257,0.003929273084479371,Shoulder,Tuesday,September
2024-09-03 10:00:00,204,555,9,2,770,271,439,11,3,724,26.7,86,51,5.6,1494,False,10,475,994,20,5,2024-09-03,False,False,True,0.6653279785809906,0.3179384203480589,0.013386880856760375,0.0033467202141900937,Shoulder,Tuesday,September
2024-09-03 11:00:00,202,550,11,3,766,278,433,3,2,716,27.8,81,3,6.9,1482,False,11,480,983,14,5,2024-09-03,False,False,True,0.6632928475033738,0.32388663967611336,0.009446693657219974,0.0033738191632928477,Peak,Tuesday,September
2024-09-03 12:00:00,217,555,12,1,785,266,429,6,3,704,28.7,78,3,9.8,1489,False,12,483,984,18,4,2024-09-03,False,False,True,0.6608462055070518,0.3243787777031565,0.01208865010073875,0.002686366689053056,Peak,Tuesday,September
2024-09-03 13:00:00,229,567,9,1,806,259,411,3,3,676,29.5,75,3,12.5,1482,False,13,488,978,12,4,2024-09-03,False,False,True,0.659919028340081,0.3292847503373819,0.008097165991902834,0.002699055330634278,Peak,Tuesday,September
2024-09-03 14:00:00,221,548,7,3,779,255,427,3,4,689,29.4,73,51,11.9,1468,False,14,476,975,10,7,2024-09-03,False,False,True,0.6641689373297003,0.3242506811989101,0.006811989100817439,0.004768392370572207,Peak,Tuesday,September
2024-09-03 15:00:00,219,553,13,2,787,249,433,5,2,689,28.8,77,3,10.7,1476,False,15,468,986,18,4,2024-09-03,False,False,True,0.6680216802168022,0.3170731707317073,0.012195121951219513,0.0027100271002710027,Peak,Tuesday,September
2024-09-03 16:00:00,230,566,16,4,816,241,444,6,5,696,29.2,77,3,9.4,1512,False,16,471,1010,22,9,2024-09-03,False,False,True,0.667989417989418,0.3115079365079365,0.01455026455026455,0.005952380952380952,Peak,Tuesday,September
2024-09-03 17:00:00,229,563,11,2,805,248,416,15,7,686,29.2,77,3,5.5,1491,False,17,477,979,26,9,2024-09-03,False,False,True,0.6566063044936284,0.3199195171026157,0.017437961099932932,0.006036217303822937,Peak,Tuesday,September
2024-09-03 18:00:00,231,566,7,3,807,251,438,13,3,705,29.1,77,3,4.5,1512,False,18,482,1004,20,6,2024-09-03,False,False,True,0.6640211640211641,0.3187830687830688,0.013227513227513227,0.003968253968253968,Peak,Tuesday,September
2024-09-03 19:00:00,228,565,4,3,800,246,433,14,3,696,28.1,84,3,2.6,1496,False,19,474,998,18,6,2024-09-03,False,False,True,0.6671122994652406,0.31684491978609625,0.012032085561497326,0.004010695187165776,Peak,Tuesday,September
2024-09-03 20:00:00,222,531,5,1,759,239,441,2,4,686,27.0,88,3,3.6,1445,False,20,461,972,7,5,2024-09-03,False,False,True,0.6726643598615917,0.3190311418685121,0.004844290657439446,0.0034602076124567475,Shoulder,Tuesday,September
2024-09-03 21:00:00,219,523,13,1,756,235,447,10,2,694,26.4,89,3,3.6,1450,False,21,454,970,23,3,2024-09-03,False,False,True,0.6689655172413793,0.31310344827586206,0.015862068965517243,0.0020689655172413794,Shoulder,Tuesday,September
2024-09-03 22:00:00,218,511,11,2,742,215,450,6,2,673,25.9,92,3,4.4,1415,False,22,433,961,17,4,2024-09-03,False,False,True,0.6791519434628975,0.3060070671378092,0.012014134275618375,0.0028268551236749115,Shoulder,Tuesday,September
2024-09-03 23:00:00,221,501,6,1,729,207,411,7,3,628,25.6,91,3,4.0,1357,False,23,428,912,13,4,2024-09-03,False,False,False,0.6720707442888725,0.3154016212232867,0.009579955784819455,0.0029476787030213707,Shoulder,Tuesday,September
2024-09-04 00:00:00,189,499,10,1,699,199,387,9,2,597,25.0,94,3,3.6,1296,False,0,388,886,19,3,2024-09-04,False,False,False,0.683641975308642,0.2993827160493827,0.014660493827160493,0.0023148148148148147,Off-Peak,Wednesday,September
2024-09-04 01:00:00,183,502,9,1,695,189,395,11,1,596,24.8,94,3,3.6,1291,False,1,372,897,20,2,2024-09-04,False,False,False,0.6948102246320682,0.2881487219209915,0.015491866769945779,0.001549186676994578,Off-Peak,Wednesday,September
2024-09-04 02:00:00,170,470,12,1,653,191,387,10,3,591,24.3,96,3,4.2,1244,False,2,361,857,22,4,2024-09-04,False,False,False,0.6889067524115756,0.29019292604501606,0.017684887459807074,0.003215434083601286,Off-Peak,Wednesday,September
2024-09-04 03:00:00,177,499,9,1,686,199,390,9,2,600,24.1,96,3,3.3,1286,False,3,376,889,18,3,2024-09-04,False,False,False,0.6912908242612753,0.29237947122861585,0.013996889580093312,0.0023328149300155523,Off-Peak,Wednesday,September
2024-09-04 04:00:00,169,510,7,1,687,204,379,12,2,597,23.9,97,3,1.5,1284,False,4,373,889,19,3,2024-09-04,False,False,False,0.692367601246106,0.29049844236760125,0.014797507788161994,0.002336448598130841,Off-Peak,Wednesday,September
2024-09-04 05:00:00,172,523,10,1,706,209,400,9,4,622,24.2,94,3,0.0,1328,False,5,381,923,19,5,2024-09-04,False,False,False,0.6950301204819277,0.2868975903614458,0.01430722891566265,0.0037650602409638554,Shoulder,Wednesday,September
2024-09-04 06:00:00,188,433,12,2,635,210,413,12,1,636,24.5,92,3,2.0,1271,False,6,398,846,24,3,2024-09-04,False,False,False,0.6656176239181747,0.3131392604248623,0.01888276947285602,0.0023603461841070024,Shoulder,Wednesday,September
2024-09-04 07:00:00,190,539,13,1,743,215,422,10,1,648,24.8,92,51,2.6,1391,False,7,405,961,23,2,2024-09-04,False,False,True,0.6908698777857656,0.291157440690151,0.01653486700215672,0.0014378145219266715,Peak,Wednesday,September
2024-09-04 08:00:00,192,551,17,1,761,220,412,11,1,644,24.8,93,51,9.9,1405,False,8,412,963,28,2,2024-09-04,False,False,True,0.6854092526690392,0.29323843416370104,0.0199288256227758,0.0014234875444839859,Peak,Wednesday,September
2024-09-04 09:00:00,199,544,5,1,749,217,419,15,3,654,28.0,82,3,5.4,1403,False,9,416,963,20,4,2024-09-04,False,False,True,0.6863863150392017,0.2965074839629366,0.014255167498218105,0.002851033499643621,Shoulder,Wednesday,September
2024-09-04 10:00:00,203,537,16,1,757,194,409,12,2,617,29.1,76,3,6.2,1374,False,10,397,946,28,3,2024-09-04,False,False,True,0.6885007278020379,0.2889374090247453,0.020378457059679767,0.002183406113537118,Shoulder,Wednesday,September
2024-09-04 11:00:00,199,532,12,1,744,208,403,10,2,623,29.9,73,3,5.9,1367,False,11,407,935,22,3,2024-09-04,False,False,False,0.6839795171909291,0.29773226042428674,0.016093635698610095,0.0021945866861741038,Peak,Wednesday,September
2024-09-04 12:00:00,210,526,11,1,748,196,400,9,1,606,30.3,72,3,8.9,1354,False,12,406,926,20,2,2024-09-04,False,False,False,0.6838995568685377,0.2998522895125554,0.014771048744460856,0.0014771048744460858,Peak,Wednesday,September
2024-09-04 13:00:00,200,511,12,1,724,202,412,7,3,624,30.2,73,3,10.6,1348,False,13,402,923,19,4,2024-09-04,False,False,False,0.6847181008902077,0.29821958456973297,0.014094955489614243,0.002967359050445104,Peak,Wednesday,September
2024-09-04 14:00:00,189,517,16,1,723,207,419,12,4,642,29.6,77,2,11.3,1365,False,14,396,936,28,5,2024-09-04,False,False,False,0.6857142857142857,0.29010989010989013,0.020512820512820513,0.003663003663003663,Peak,Wednesday,September
2024-09-04 15:00:00,193,512,13,2,720,210,421,13,1,645,29.9,74,51,14.5,1365,False,15,403,933,26,3,2024-09-04,False,False,False,0.6835164835164835,0.29523809523809524,0.01904761904761905,0.002197802197802198,Peak,Wednesday,September
2024-09-04 16:00:00,209,520,9,2,740,209,428,6,1,644,29.0,79,55,9.8,1384,False,16,418,948,15,3,2024-09-04,False,False,True,0.684971098265896,0.3020231213872832,0.01083815028901734,0.002167630057803468,Peak,Wednesday,September
2024-09-04 17:00:00,220,525,5,1,751,211,350,13,5,579,28.4,78,2,12.7,1330,False,17,431,875,18,6,2024-09-04,False,False,False,0.6578947368421053,0.3240601503759398,0.013533834586466165,0.004511278195488722,Peak,Wednesday,September
2024-09-04 18:00:00,227,539,17,1,784,219,429,8,2,658,27.9,80,51,12.6,1442,False,18,446,968,25,3,2024-09-04,False,False,True,0.6712898751733704,0.3092926490984743,0.017337031900138695,0.0020804438280166435,Peak,Wednesday,September
2024-09-04 19:00:00,219,531,14,1,765,203,419,6,1,629,27.4,82,51,13.4,1394,False,19,422,950,20,2,2024-09-04,False,False,True,0.6814921090387375,0.30272596843615496,0.014347202295552367,0.0014347202295552368,Peak,Wednesday,September
2024-09-04 20:00:00,212,525,9,1,747,199,401,10,2,612,27.2,83,3,10.6,1359,False,20,411,926,19,3,2024-09-04,False,False,False,0.681383370125092,0.30242825607064017,0.013980868285504048,0.002207505518763797,Shoulder,Wednesday,September
2024-09-04 21:00:00,207,511,10,1,729,192,399,9,1,601,26.5,84,3,6.0,1330,False,21,399,910,19,2,2024-09-04,False,False,False,0.6842105263157895,0.3,0.014285714285714285,0.0015037593984962407,Shoulder,Wednesday,September
2024-09-04 22:00:00,214,503,12,1,730,179,397,19,3,598,26.7,84,51,8.2,1328,False,22,393,900,31,4,2024-09-04,False,False,False,0.677710843373494,0.29593373493975905,0.023343373493975902,0.0030120481927710845,Shoulder,Wednesday,September
2024-09-04 23:00:00,245,526,6,1,778,169,388,2,2,561,26.2,87,3,5.6,1339,False,23,414,914,8,3,2024-09-04,False,False,False,0.6825989544436146,0.30918595967139656,0.00597460791635549,0.0022404779686333084,Shoulder,Wednesday,September
2024-09-05 00:00:00,149,455,4,2,610,166,371,5,2,544,25.6,94,3,4.2,1154,False,0,315,826,9,4,2024-09-05,False,False,False,0.7157712305025996,0.2729636048526863,0.00779896013864818,0.0034662045060658577,Off-Peak,Thursday,September
2024-09-05 01:00:00,151,459,3,2,615,156,218,3,1,378,25.9,93,51,4.8,993,False,1,307,677,6,3,2024-09-05,False,False,False,0.6817724068479355,0.30916414904330314,0.006042296072507553,0.0030211480362537764,Off-Peak,Thursday,September
2024-09-05 02:00:00,140,449,1,1,591,188,399,4,1,592,25.9,93,3,8.0,1183,False,2,328,848,5,2,2024-09-05,False,False,False,0.716821639898563,0.2772612003381234,0.00422654268808115,0.0016906170752324597,Off-Peak,Thursday,September
2024-09-05 03:00:00,143,455,4,2,604,155,351,1,1,508,26.2,91,3,9.1,1112,False,3,298,806,5,3,2024-09-05,False,False,False,0.7248201438848921,0.26798561151079137,0.0044964028776978415,0.002697841726618705,Off-Peak,Thursday,September
2024-09-05 04:00:00,154,466,1,1,622,158,344,1,1,504,26.0,92,3,7.6,1126,False,4,312,810,2,2,2024-09-05,False,False,False,0.7193605683836589,0.27708703374777977,0.0017761989342806395,0.0017761989342806395,Off-Peak,Thursday,September
2024-09-05 05:00:00,164,461,12,1,638,172,342,3,1,518,25.9,92,3,10.1,1156,False,5,336,803,15,2,2024-09-05,False,False,False,0.6946366782006921,0.2906574394463668,0.012975778546712802,0.0017301038062283738,Shoulder,Thursday,September
2024-09-05 06:00:00,159,463,9,2,633,189,375,2,1,567,25.7,93,3,7.0,1200,False,6,348,838,11,3,2024-09-05,False,False,False,0.6983333333333334,0.29,0.009166666666666667,0.0025,Shoulder,Thursday,September
2024-09-05 07:00:00,163,469,11,1,644,198,366,1,2,567,25.3,94,3,7.0,1211,False,7,361,835,12,3,2024-09-05,False,False,False,0.6895127993393889,0.2981007431874484,0.00990916597853014,0.002477291494632535,Peak,Thursday,September
2024-09-05 08:00:00,166,461,13,2,642,200,388,1,1,590,26.3,92,3,6.2,1232,False,8,366,849,14,3,2024-09-05,False,False,False,0.6891233766233766,0.29707792207792205,0.011363636363636364,0.002435064935064935,Peak,Thursday,September
2024-09-05 09:00:00,170,459,5,1,635,198,375,3,0,576,27.6,85,3,4.1,1211,False,9,368,834,8,1,2024-09-05,False,False,False,0.6886870355078447,0.30388109000825764,0.006606110652353427,0.0008257638315441783,Shoulder,Thursday,September
2024-09-05 10:00:00,174,455,3,4,636,195,368,2,1,566,28.9,80,51,4.1,1202,False,10,369,823,5,5,2024-09-05,False,False,False,0.6846921797004991,0.3069883527454243,0.004159733777038269,0.004159733777038269,Shoulder,Thursday,September
2024-09-05 11:00:00,179,453,7,3,642,176,355,2,1,534,30.1,72,51,7.1,1176,False,11,355,808,9,4,2024-09-05,False,False,False,0.6870748299319728,0.3018707482993197,0.007653061224489796,0.003401360544217687,Peak,Thursday,September
2024-09-05 12:00:00,155,458,11,2,626,158,310,2,2,472,30.1,72,51,10.4,1098,False,12,313,768,13,4,2024-09-05,False,False,False,0.6994535519125683,0.28506375227686703,0.011839708561020037,0.0036429872495446266,Peak,Thursday,September
2024-09-05 13:00:00,151,459,2,1,613,165,348,2,1,516,30.2,71,51,9.8,1129,False,13,316,807,4,2,2024-09-05,False,False,False,0.7147918511957484,0.27989371124889284,0.00354295837023915,0.001771479185119575,Peak,Thursday,September
2024-09-05 14:00:00,162,456,1,1,620,135,368,6,1,510,30.3,70,51,9.5,1130,False,14,297,824,7,2,2024-09-05,False,False,False,0.7292035398230089,0.2628318584070796,0.006194690265486726,0.0017699115044247787,Peak,Thursday,September
2024-09-05 15:00:00,172,469,3,2,646,169,310,1,0,480,30.2,69,3,9.3,1126,False,15,341,779,4,2,2024-09-05,False,False,False,0.6918294849023091,0.302841918294849,0.003552397868561279,0.0017761989342806395,Peak,Thursday,September
2024-09-05 16:00:00,169,479,1,3,652,186,333,3,0,522,29.9,69,3,9.7,1174,False,16,355,812,4,3,2024-09-05,False,False,False,0.6916524701873935,0.3023850085178876,0.0034071550255536627,0.002555366269165247,Peak,Thursday,September
2024-09-05 17:00:00,167,483,4,1,655,190,354,4,1,549,29.9,68,3,4.8,1204,False,17,357,837,8,2,2024-09-05,False,False,False,0.6951827242524917,0.29651162790697677,0.006644518272425249,0.0016611295681063123,Peak,Thursday,September
2024-09-05 18:00:00,179,488,4,1,672,197,362,13,2,574,29.2,73,3,5.4,1246,False,18,376,850,17,3,2024-09-05,False,False,False,0.6821829855537721,0.3017656500802568,0.013643659711075442,0.002407704654895666,Peak,Thursday,September
2024-09-05 19:00:00,166,480,1,3,650,165,343,1,1,510,28.4,80,1,3.4,1160,False,19,331,823,2,4,2024-09-05,False,False,False,0.7094827586206897,0.2853448275862069,0.0017241379310344827,0.0034482758620689655,Peak,Thursday,September
2024-09-05 20:00:00,164,475,3,1,643,166,366,3,0,535,27.9,81,2,5.1,1178,False,20,330,841,6,1,2024-09-05,False,False,False,0.7139219015280136,0.2801358234295416,0.0050933786078098476,0.0008488964346349745,Shoulder,Thursday,September
2024-09-05 21:00:00,153,469,2,1,625,164,399,3,1,567,27.7,85,3,4.6,1192,False,21,317,868,5,2,2024-09-05,False,False,False,0.7281879194630873,0.26593959731543626,0.0041946308724832215,0.0016778523489932886,Shoulder,Thursday,September
2024-09-05 22:00:00,149,460,6,1,616,155,345,8,0,508,27.8,85,3,3.5,1124,False,22,304,805,14,1,2024-09-05,False,False,False,0.7161921708185054,0.2704626334519573,0.012455516014234875,0.0008896797153024911,Shoulder,Thursday,September
2024-09-05 23:00:00,156,456,2,2,616,180,324,12,2,518,27.4,87,3,3.2,1134,False,23,336,780,14,4,2024-09-05,False,False,False,0.6878306878306878,0.2962962962962963,0.012345679012345678,0.003527336860670194,Shoulder,Thursday,September
2024-09-06 00:00:00,179,533,13,1,726,187,312,9,3,511,26.8,90,51,3.9,1237,False,0,366,845,22,4,2024-09-06,False,False,False,0.683104284559418,0.29587712206952305,0.01778496362166532,0.0032336297493936943,Off-Peak,Friday,September
2024-09-06 01:00:00,180,536,12,1,729,192,233,9,2,436,27.2,87,51,7.6,1165,False,1,372,769,21,3,2024-09-06,False,False,False,0.6600858369098712,0.31931330472103003,0.018025751072961373,0.002575107296137339,Off-Peak,Friday,September
2024-09-06 02:00:00,166,537,11,1,715,107,376,7,2,492,26.9,87,3,12.5,1207,False,2,273,913,18,3,2024-09-06,False,False,False,0.7564208782104391,0.22618061309030654,0.014913007456503728,0.0024855012427506215,Off-Peak,Friday,September
2024-09-06 03:00:00,167,543,9,1,720,132,335,7,3,477,26.6,88,3,8.8,1197,False,3,299,878,16,4,2024-09-06,False,False,False,0.733500417710944,0.24979114452798662,0.013366750208855471,0.003341687552213868,Off-Peak,Friday,September
2024-09-06 04:00:00,182,547,12,2,743,178,377,10,2,567,25.8,93,3,4.7,1310,False,4,360,924,22,4,2024-09-06,False,False,False,0.7053435114503817,0.2748091603053435,0.016793893129770993,0.0030534351145038168,Off-Peak,Friday,September
2024-09-06 05:00:00,176,539,10,1,726,158,288,6,1,453,25.9,93,3,4.7,1179,False,5,334,827,16,2,2024-09-06,False,False,False,0.7014418999151824,0.28329092451229854,0.013570822731128074,0.0016963528413910093,Shoulder,Friday,September
2024-09-06 06:00:00,189,549,9,1,748,188,366,8,3,565,25.6,94,3,4.4,1313,False,6,377,915,17,4,2024-09-06,False,False,False,0.6968773800456969,0.2871287128712871,0.012947448591012947,0.0030464584920030465,Shoulder,Friday,September
2024-09-06 07:00:00,188,543,21,1,753,199,372,1,2,574,26.1,91,3,4.1,1327,False,7,387,915,22,3,2024-09-06,False,False,False,0.6895252449133383,0.29163526752072344,0.016578749058025623,0.002260738507912585,Peak,Friday,September
2024-09-06 08:00:00,183,548,19,1,751,267,366,8,3,644,26.6,91,3,2.3,1395,False,8,450,914,27,4,2024-09-06,False,False,True,0.6551971326164875,0.3225806451612903,0.01935483870967742,0.002867383512544803,Peak,Friday,September
2024-09-06 09:00:00,189,529,21,1,740,165,211,3,3,382,27.9,83,51,7.1,1122,False,9,354,740,24,4,2024-09-06,False,False,False,0.6595365418894831,0.3155080213903743,0.0213903743315508,0.0035650623885918,Shoulder,Friday,September
2024-09-06 10:00:00,190,524,14,1,729,256,254,10,1,521,28.5,78,3,10.7,1250,False,10,446,778,24,2,2024-09-06,False,False,False,0.6224,0.3568,0.0192,0.0016,Shoulder,Friday,September
2024-09-06 11:00:00,184,504,9,1,698,187,512,12,5,716,29.2,75,51,11.3,1414,False,11,371,1016,21,6,2024-09-06,False,False,True,0.7185289957567186,0.2623762376237624,0.01485148514851485,0.004243281471004243,Peak,Friday,September
2024-09-06 12:00:00,163,504,10,1,678,276,446,6,12,740,29.8,73,3,11.0,1418,False,12,439,950,16,13,2024-09-06,False,False,True,0.6699576868829337,0.30959097320169254,0.011283497884344146,0.009167842031029619,Peak,Friday,September
2024-09-06 13:00:00,146,527,11,1,685,272,558,8,5,843,30.3,71,3,11.2,1528,False,13,418,1085,19,6,2024-09-06,False,False,True,0.7100785340314136,0.27356020942408377,0.012434554973821989,0.003926701570680628,Peak,Friday,September
2024-09-06 14:00:00,168,531,13,1,713,221,479,4,1,705,30.6,69,3,11.2,1418,False,14,389,1010,17,2,2024-09-06,False,False,True,0.7122708039492243,0.2743300423131171,0.011988716502115656,0.0014104372355430183,Peak,Friday,September
2024-09-06 15:00:00,192,538,9,1,740,265,314,15,1,595,30.0,72,3,11.9,1335,False,15,457,852,24,2,2024-09-06,False,False,False,0.6382022471910113,0.3423220973782772,0.017977528089887642,0.00149812734082397,Peak,Friday,September
2024-09-06 16:00:00,210,547,16,1,774,171,388,14,3,576,29.8,72,3,10.8,1350,False,16,381,935,30,4,2024-09-06,False,False,False,0.6925925925925925,0.2822222222222222,0.022222222222222223,0.002962962962962963,Peak,Friday,September
2024-09-06 17:00:00,209,550,12,1,772,154,373,17,1,545,29.7,73,3,12.5,1317,False,17,363,923,29,2,2024-09-06,False,False,False,0.70083523158694,0.275626423690205,0.02201974183750949,0.0015186028853454822,Peak,Friday,September
2024-09-06 18:00:00,201,567,9,1,778,204,409,6,3,622,29.1,77,3,12.5,1400,False,18,405,976,15,4,2024-09-06,False,False,True,0.6971428571428572,0.2892857142857143,0.010714285714285714,0.002857142857142857,Peak,Friday,September
2024-09-06 19:00:00,199,570,11,1,781,195,336,5,3,539,28.6,79,1,11.8,1320,False,19,394,906,16,4,2024-09-06,False,False,False,0.6863636363636364,0.29848484848484846,0.012121212121212121,0.0030303030303030303,Peak,Friday,September
2024-09-06 20:00:00,189,569,10,1,769,169,356,8,1,534,28.2,80,1,11.8,1303,False,20,358,925,18,2,2024-09-06,False,False,False,0.7099002302379125,0.2747505755947813,0.013814274750575594,0.0015349194167306216,Shoulder,Friday,September
2024-09-06 21:00:00,190,535,12,1,738,161,354,4,5,524,28.5,80,3,10.0,1262,False,21,351,889,16,6,2024-09-06,False,False,False,0.7044374009508716,0.27812995245641836,0.012678288431061807,0.004754358161648178,Shoulder,Friday,September
2024-09-06 22:00:00,188,512,10,1,711,198,241,8,4,451,28.2,82,3,10.1,1162,False,22,386,753,18,5,2024-09-06,False,False,False,0.6480206540447504,0.33218588640275387,0.01549053356282272,0.004302925989672977,Shoulder,Friday,September
2024-09-06 23:00:00,183,513,9,1,706,155,399,9,4,567,28.1,82,3,11.3,1273,False,23,338,912,18,5,2024-09-06,False,False,False,0.7164179104477612,0.2655145326001571,0.014139827179890024,0.003927729772191673,Shoulder,Friday,September
2024-09-07 00:00:00,210,520,15,2,747,192,354,9,2,557,27.5,85,3,8.0,1304,True,0,402,874,24,4,2024-09-07,False,False,False,0.6702453987730062,0.30828220858895705,0.018404907975460124,0.003067484662576687,Off-Peak,Saturday,September
2024-09-07 01:00:00,211,499,12,2,724,215,355,12,3,585,26.9,88,3,6.0,1309,True,1,426,854,24,5,2024-09-07,False,False,False,0.6524064171122995,0.3254392666157372,0.01833460656990069,0.0038197097020626434,Off-Peak,Saturday,September
2024-09-07 02:00:00,202,539,11,1,753,200,364,10,1,575,26.7,89,3,6.1,1328,True,2,402,903,21,2,2024-09-07,False,False,False,0.6799698795180723,0.30271084337349397,0.01581325301204819,0.0015060240963855422,Off-Peak,Saturday,September
2024-09-07 03:00:00,219,513,7,2,741,263,344,8,4,619,26.5,91,3,6.5,1360,True,3,482,857,15,6,2024-09-07,False,False,False,0.6301470588235294,0.35441176470588237,0.011029411764705883,0.004411764705882353,Off-Peak,Saturday,September
2024-09-07 04:00:00,220,538,12,1,771,166,366,12,1,545,26.3,92,3,4.7,1316,True,4,386,904,24,2,2024-09-07,False,False,False,0.6869300911854104,0.2933130699088146,0.0182370820668693,0.001519756838905775,Off-Peak,Saturday,September
2024-09-07 05:00:00,211,548,13,3,775,372,446,13,5,836,26.1,91,3,7.2,1611,True,5,583,994,26,8,2024-09-07,False,False,True,0.617008069522036,0.36188702669149597,0.016139044072004966,0.004965859714463066,Shoulder,Saturday,September
2024-09-07 06:00:00,220,555,12,2,789,342,354,13,6,715,25.1,96,63,8.0,1504,True,6,562,909,25,8,2024-09-07,False,False,True,0.6043882978723404,0.37367021276595747,0.016622340425531915,0.005319148936170213,Shoulder,Saturday,September
2024-09-07 07:00:00,220,549,10,4,783,292,455,16,7,770,25.0,96,55,6.9,1553,True,7,512,1004,26,11,2024-09-07,False,False,True,0.6464906632324533,0.3296844816484224,0.01674179008370895,0.0070830650354153256,Peak,Saturday,September
2024-09-07 08:00:00,225,602,15,2,844,233,418,14,1,666,25.3,93,53,2.7,1510,True,8,458,1020,29,3,2024-09-07,False,False,True,0.6754966887417219,0.3033112582781457,0.019205298013245033,0.001986754966887417,Peak,Saturday,September
2024-09-07 09:00:00,228,578,16,4,826,199,377,7,6,589,25.6,91,51,4.3,1415,True,9,427,955,23,10,2024-09-07,False,False,True,0.6749116607773852,0.3017667844522968,0.01625441696113074,0.007067137809187279,Shoulder,Saturday,September
2024-09-07 11:00:00,210,588,10,3,811,233,482,19,3,737,28.7,77,51,4.3,1548,True,11,443,1070,29,6,2024-09-07,False,False,True,0.6912144702842378,0.28617571059431524,0.018733850129198967,0.003875968992248062,Peak,Saturday,September
2024-09-07 12:00:00,206,566,3,2,777,106,339,2,1,448,28.8,76,51,9.5,1225,True,12,312,905,5,3,2024-09-07,False,False,False,0.7387755102040816,0.2546938775510204,0.004081632653061225,0.0024489795918367346,Peak,Saturday,September
2024-09-07 13:00:00,200,538,8,1,747,213,375,12,4,604,29.5,73,51,13.4,1351,True,13,413,913,20,5,2024-09-07,False,False,False,0.6757957068837898,0.30569948186528495,0.014803849000740192,0.003700962250185048,Peak,Saturday,September
2024-09-07 14:00:00,197,543,15,3,758,231,355,12,1,599,29.4,75,51,15.3,1357,True,14,428,898,27,4,2024-09-07,False,False,False,0.6617538688282977,0.3154016212232867,0.01989683124539425,0.0029476787030213707,Peak,Saturday,September
2024-09-07 15:00:00,217,550,11,3,781,233,467,11,0,711,29.6,75,3,12.8,1492,True,15,450,1017,22,3,2024-09-07,False,False,True,0.6816353887399463,0.30160857908847183,0.014745308310991957,0.0020107238605898124,Peak,Saturday,September
2024-09-07 16:00:00,216,589,17,6,828,201,489,22,1,713,29.5,75,3,12.7,1541,True,16,417,1078,39,7,2024-09-07,False,False,True,0.6995457495133031,0.27060350421804025,0.025308241401687217,0.004542504866969501,Peak,Saturday,September
2024-09-07 17:00:00,224,600,13,4,841,263,501,18,3,785,29.1,77,51,11.0,1626,True,17,487,1101,31,7,2024-09-07,False,False,True,0.6771217712177122,0.2995079950799508,0.019065190651906518,0.004305043050430504,Peak,Saturday,September
2024-09-07 18:00:00,231,595,16,5,847,293,444,15,1,753,28.9,77,3,9.9,1600,True,18,524,1039,31,6,2024-09-07,False,False,True,0.649375,0.3275,0.019375,0.00375,Peak,Saturday,September
2024-09-07 19:00:00,219,539,10,4,772,257,455,11,4,727,28.2,82,1,6.3,1499,True,19,476,994,21,8,2024-09-07,False,False,True,0.6631087391594396,0.31754503002001333,0.014009339559706471,0.00533689126084056,Peak,Saturday,September
2024-09-07 20:00:00,207,541,17,1,766,285,416,12,2,715,27.8,84,2,6.6,1481,True,20,492,957,29,3,2024-09-07,False,False,True,0.6461850101282917,0.3322079675894666,0.019581363943281565,0.002025658338960162,Shoulder,Saturday,September
2024-09-07 21:00:00,200,530,12,1,743,254,402,11,2,669,28.1,75,51,16.0,1412,True,21,454,932,23,3,2024-09-07,False,False,True,0.660056657223796,0.32152974504249293,0.016288951841359773,0.002124645892351275,Shoulder,Saturday,September
2024-09-07 22:00:00,204,529,8,3,744,283,573,7,3,866,27.1,86,51,4.7,1610,True,22,487,1102,15,6,2024-09-07,False,False,True,0.684472049689441,0.3024844720496894,0.009316770186335404,0.0037267080745341614,Shoulder,Saturday,September
2024-09-07 23:00:00,197,530,13,4,744,254,446,9,1,710,26.7,86,3,2.8,1454,True,23,451,976,22,5,2024-09-07,False,False,True,0.671251719394773,0.31017881705639616,0.015130674002751032,0.0034387895460797797,Shoulder,Saturday,September
2024-09-08 00:00:00,192,590,10,1,793,179,412,9,1,601,25.8,91,3,4.2,1394,True,0,371,1002,19,2,2024-09-08,False,False,True,0.7187948350071736,0.2661406025824964,0.013629842180774749,0.0014347202295552368,Off-Peak,Sunday,September
2024-09-08 01:00:00,169,578,9,1,757,120,399,12,2,533,25.2,93,3,8.0,1290,True,1,289,977,21,3,2024-09-08,False,False,False,0.7573643410852713,0.224031007751938,0.01627906976744186,0.002325581395348837,Off-Peak,Sunday,September
2024-09-08 02:00:00,158,579,12,2,751,214,314,14,1,543,24.9,93,3,8.3,1294,True,2,372,893,26,3,2024-09-08,False,False,False,0.6901081916537867,0.2874806800618238,0.02009273570324575,0.00231839258114374,Off-Peak,Sunday,September
2024-09-08 03:00:00,168,583,11,1,763,216,304,6,2,528,25.3,92,3,7.7,1291,True,3,384,887,17,3,2024-09-08,False,False,False,0.6870642912470952,0.2974438419829589,0.013168086754453912,0.0023237800154918666,Off-Peak,Sunday,September
2024-09-08 04:00:00,176,571,8,1,756,202,402,33,2,639,25.2,94,51,7.9,1395,True,4,378,973,41,3,2024-09-08,False,False,True,0.6974910394265234,0.2709677419354839,0.02939068100358423,0.002150537634408602,Off-Peak,Sunday,September
2024-09-08 05:00:00,188,577,14,2,781,238,423,9,2,672,24.8,94,51,8.3,1453,True,5,426,1000,23,4,2024-09-08,False,False,True,0.6882312456985548,0.29318651066758433,0.015829318651066758,0.0027529249827942187,Shoulder,Sunday,September
2024-09-08 07:00:00,198,596,15,3,812,168,467,12,1,648,24.6,95,3,6.1,1460,True,7,366,1063,27,4,2024-09-08,False,False,True,0.7280821917808219,0.25068493150684934,0.018493150684931507,0.0027397260273972603,Peak,Sunday,September
2024-09-08 08:00:00,204,601,12,1,818,200,533,1,3,737,25.2,94,3,6.3,1555,True,8,404,1134,13,4,2024-09-08,False,False,True,0.7292604501607717,0.2598070739549839,0.008360128617363344,0.002572347266881029,Peak,Sunday,September
2024-09-08 09:00:00,214,616,18,2,850,242,389,12,1,644,26.8,88,3,5.1,1494,True,9,456,1005,30,3,2024-09-08,False,False,True,0.6726907630522089,0.30522088353413657,0.020080321285140562,0.002008032128514056,Shoulder,Sunday,September
2024-09-08 10:00:00,199,599,21,3,822,273,472,11,2,758,28.0,84,3,3.5,1580,True,10,472,1071,32,5,2024-09-08,False,False,True,0.6778481012658227,0.29873417721518986,0.020253164556962026,0.0031645569620253164,Shoulder,Sunday,September
2024-09-08 11:00:00,195,581,12,1,789,183,465,3,1,652,27.4,86,63,8.5,1441,True,11,378,1046,15,2,2024-09-08,False,False,True,0.7258848022206801,0.2623178348369188,0.010409437890353921,0.0013879250520471894,Peak,Sunday,September
2024-09-08 12:00:00,189,579,10,1,779,333,455,3,1,792,28.5,78,51,6.1,1571,True,12,522,1034,13,2,2024-09-08,False,False,True,0.6581795035009548,0.33227243793761935,0.008274984086569064,0.001273074474856779,Peak,Sunday,September
2024-09-08 13:00:00,170,562,11,2,745,121,400,7,2,530,29.3,75,51,9.1,1275,True,13,291,962,18,4,2024-09-08,False,False,False,0.7545098039215686,0.22823529411764706,0.01411764705882353,0.003137254901960784,Peak,Sunday,September
2024-09-08 14:00:00,186,571,8,1,766,214,523,9,1,747,29.2,77,51,10.0,1513,True,14,400,1094,17,2,2024-09-08,False,False,True,0.7230667547918044,0.26437541308658297,0.011235955056179775,0.0013218770654329147,Peak,Sunday,September
2024-09-08 15:00:00,197,598,14,1,810,187,376,3,1,567,28.9,78,3,7.4,1377,True,15,384,974,17,2,2024-09-08,False,False,True,0.7073347857661583,0.2788671023965142,0.012345679012345678,0.0014524328249818446,Peak,Sunday,September
2024-09-08 16:00:00,200,593,16,3,812,200,466,4,3,673,28.9,76,3,6.2,1485,True,16,400,1059,20,6,2024-09-08,False,False,True,0.7131313131313132,0.26936026936026936,0.013468013468013467,0.00404040404040404,Peak,Sunday,September
2024-09-08 17:00:00,219,599,14,2,834,179,453,12,1,645,29.1,73,3,7.7,1479,True,17,398,1052,26,3,2024-09-08,False,False,True,0.711291413116971,0.2691007437457742,0.01757944557133198,0.002028397565922921,Peak,Sunday,September
2024-09-08 18:00:00,225,613,13,1,852,288,435,7,1,731,28.6,75,3,5.5,1583,True,18,513,1048,20,2,2024-09-08,False,False,True,0.6620341124447252,0.3240682248894504,0.012634238787113077,0.0012634238787113076,Peak,Sunday,September
2024-09-08 19:00:00,217,611,8,1,837,206,286,4,2,498,27.7,84,3,3.2,1335,True,19,423,897,12,3,2024-09-08,False,False,False,0.6719101123595506,0.31685393258426964,0.008988764044943821,0.0022471910112359553,Peak,Sunday,September
2024-09-08 20:00:00,199,618,14,2,833,184,399,9,1,593,27.4,83,3,2.5,1426,True,20,383,1017,23,3,2024-09-08,False,False,True,0.7131837307152875,0.26858345021037866,0.016129032258064516,0.0021037868162692847,Shoulder,Sunday,September
2024-09-08 21:00:00,197,590,8,3,798,222,394,6,1,623,25.9,91,3,2.4,1421,True,21,419,984,14,4,2024-09-08,False,False,True,0.6924700914848698,0.294862772695285,0.009852216748768473,0.0028149190710767065,Shoulder,Sunday,September
2024-09-08 22:00:00,177,587,15,2,781,192,402,21,3,618,25.6,92,3,4.7,1399,True,22,369,989,36,5,2024-09-08,False,False,True,0.7069335239456754,0.26375982844889206,0.02573266619013581,0.0035739814152966403,Shoulder,Sunday,September
2024-09-08 23:00:00,165,579,12,1,757,166,307,10,1,484,25.6,92,3,4.8,1241,True,23,331,886,22,2,2024-09-08,False,False,False,0.7139403706688154,0.26672038678485094,0.017727639000805803,0.0016116035455278,Shoulder,Sunday,September
2024-09-09 00:00:00,203,538,9,1,751,188,317,5,3,513,25.6,90,3,6.9,1264,False,0,391,855,14,4,2024-09-09,False,False,False,0.6764240506329114,0.30933544303797467,0.011075949367088608,0.0031645569620253164,Off-Peak,Monday,September
2024-09-09 01:00:00,188,537,11,1,737,120,354,3,4,481,25.0,91,53,10.5,1218,False,1,308,891,14,5,2024-09-09,False,False,False,0.7315270935960592,0.25287356321839083,0.011494252873563218,0.004105090311986864,Off-Peak,Monday,September
2024-09-09 02:00:00,179,530,12,2,723,110,343,7,1,461,24.8,93,51,9.8,1184,False,2,289,873,19,3,2024-09-09,False,False,False,0.737331081081081,0.24408783783783783,0.016047297297297296,0.002533783783783784,Off-Peak,Monday,September
2024-09-09 03:00:00,176,527,8,1,712,144,344,12,5,505,24.5,93,55,7.0,1217,False,3,320,871,20,6,2024-09-09,False,False,False,0.7156943303204601,0.2629416598192276,0.016433853738701727,0.0049301561216105174,Off-Peak,Monday,September
2024-09-09 04:00:00,159,514,14,1,688,123,548,8,2,681,24.4,94,2,7.4,1369,False,4,282,1062,22,3,2024-09-09,False,False,False,0.7757487216946677,0.20598977355734113,0.016070124178232285,0.002191380569758948,Off-Peak,Monday,September
2024-09-09 05:00:00,200,522,3,1,726,165,354,9,1,529,24.4,93,3,7.2,1255,False,5,365,876,12,2,2024-09-09,False,False,False,0.69800796812749,0.2908366533864542,0.009561752988047808,0.0015936254980079682,Shoulder,Monday,September
2024-09-09 06:00:00,213,539,2,1,755,167,340,12,1,520,23.9,96,3,3.2,1275,False,6,380,879,14,2,2024-09-09,False,False,False,0.6894117647058824,0.2980392156862745,0.010980392156862745,0.001568627450980392,Shoulder,Monday,September
2024-09-09 07:00:00,226,536,14,3,779,216,236,15,3,470,24.0,95,3,2.7,1249,False,7,442,772,29,6,2024-09-09,False,False,False,0.6180944755804644,0.35388310648518817,0.02321857485988791,0.004803843074459567,Peak,Monday,September
2024-09-09 08:00:00,217,558,15,1,791,160,383,12,2,557,24.7,92,3,4.8,1348,False,8,377,941,27,3,2024-09-09,False,False,False,0.6980712166172107,0.27967359050445106,0.020029673590504452,0.002225519287833828,Peak,Monday,September
2024-09-09 09:00:00,202,538,13,1,754,200,262,11,7,480,25.5,89,3,10.1,1234,False,9,402,800,24,8,2024-09-09,False,False,False,0.6482982171799028,0.32576985413290116,0.019448946515397084,0.006482982171799027,Shoulder,Monday,September
2024-09-09 10:00:00,199,538,9,1,747,115,321,15,4,455,26.6,85,3,11.8,1202,False,10,314,859,24,5,2024-09-09,False,False,False,0.7146422628951747,0.2612312811980033,0.019966722129783693,0.004159733777038269,Shoulder,Monday,September
2024-09-09 11:00:00,187,541,14,2,744,264,252,10,12,538,27.7,82,3,5.4,1282,False,11,451,793,24,14,2024-09-09,False,False,False,0.6185647425897036,0.35179407176287053,0.0187207488299532,0.0109204368174727,Peak,Monday,September
2024-09-09 12:00:00,180,491,12,1,684,150,255,11,1,417,29.2,75,1,4.3,1101,False,12,330,746,23,2,2024-09-09,False,False,False,0.6775658492279746,0.2997275204359673,0.02089009990917348,0.0018165304268846503,Peak,Monday,September
2024-09-09 13:00:00,176,524,10,2,712,187,181,15,3,386,29.9,71,3,9.3,1098,False,13,363,705,25,5,2024-09-09,False,False,False,0.6420765027322405,0.33060109289617484,0.022768670309653915,0.004553734061930784,Peak,Monday,September
2024-09-09 14:00:00,198,530,17,1,746,266,220,13,8,507,29.2,74,3,8.5,1253,False,14,464,750,30,9,2024-09-09,False,False,False,0.5985634477254589,0.37031125299281725,0.023942537909018357,0.007182761372705506,Peak,Monday,September
2024-09-09 15:00:00,187,529,19,2,737,224,246,11,2,483,29.5,73,2,10.0,1220,False,15,411,775,30,4,2024-09-09,False,False,False,0.6352459016393442,0.3368852459016393,0.02459016393442623,0.003278688524590164,Peak,Monday,September
2024-09-09 16:00:00,199,549,21,1,770,286,342,18,2,648,29.4,73,3,10.2,1418,False,16,485,891,39,3,2024-09-09,False,False,True,0.6283497884344147,0.34203102961918197,0.027503526093088856,0.0021156558533145277,Peak,Monday,September
2024-09-09 17:00:00,205,560,19,1,785,240,188,16,3,447,28.9,75,3,7.4,1232,False,17,445,748,35,4,2024-09-09,False,False,False,0.6071428571428571,0.3612012987012987,0.028409090909090908,0.003246753246753247,Peak,Monday,September
2024-09-09 18:00:00,197,554,15,3,769,357,436,14,1,808,28.6,76,3,3.1,1577,False,18,554,990,29,4,2024-09-09,False,False,True,0.6277742549143944,0.3512999365884591,0.018389346861128725,0.0025364616360177552,Peak,Monday,September
2024-09-09 19:00:00,190,547,12,1,750,263,342,15,1,621,28.0,81,3,1.8,1371,False,19,453,889,27,2,2024-09-09,False,False,False,0.6484318016046682,0.3304157549234136,0.019693654266958426,0.0014587892049598833,Peak,Monday,September
2024-09-09 20:00:00,198,530,11,1,740,322,427,10,2,761,26.3,88,51,4.0,1501,False,20,520,957,21,3,2024-09-09,False,False,True,0.6375749500333111,0.346435709526982,0.013990672884743505,0.001998667554963358,Shoulder,Monday,September
2024-09-09 21:00:00,189,497,16,2,704,263,435,9,1,708,26.9,86,55,2.3,1412,False,21,452,932,25,3,2024-09-09,False,False,True,0.660056657223796,0.32011331444759206,0.017705382436260624,0.002124645892351275,Shoulder,Monday,September
2024-09-09 22:00:00,200,514,13,1,728,364,324,11,3,702,26.2,93,51,5.2,1430,False,22,564,838,24,4,2024-09-09,False,False,True,0.586013986013986,0.3944055944055944,0.016783216783216783,0.002797202797202797,Shoulder,Monday,September
2024-09-09 23:00:00,196,512,10,1,719,222,354,10,4,590,25.3,93,61,6.4,1309,False,23,418,866,20,5,2024-09-09,False,False,False,0.6615737203972498,0.31932773109243695,0.015278838808250574,0.0038197097020626434,Shoulder,Monday,September
2024-09-10 00:00:00,208,631,15,1,855,221,422,10,2,655,25.2,94,61,3.3,1510,False,0,429,1053,25,3,2024-09-10,False,False,True,0.6973509933774834,0.28410596026490065,0.016556291390728478,0.001986754966887417,Off-Peak,Tuesday,September
2024-09-10 01:00:00,199,602,12,1,814,230,444,8,2,684,25.1,96,55,3.1,1498,False,1,429,1046,20,3,2024-09-10,False,False,True,0.69826435246996,0.2863818424566088,0.01335113484646195,0.0020026702269692926,Off-Peak,Tuesday,September
2024-09-10 02:00:00,201,614,9,1,825,217,444,11,1,673,25.1,96,61,4.2,1498,False,2,418,1058,20,2,2024-09-10,False,False,True,0.7062750333778371,0.27903871829105475,0.01335113484646195,0.0013351134846461949,Off-Peak,Tuesday,September
2024-09-10 03:00:00,190,627,4,1,822,233,444,10,0,687,24.3,98,63,6.9,1509,False,3,423,1071,14,1,2024-09-10,False,False,True,0.709741550695825,0.2803180914512923,0.00927766732935719,0.0006626905235255136,Off-Peak,Tuesday,September
2024-09-10 04:00:00,222,618,8,1,849,241,444,9,3,697,24.3,95,63,7.1,1546,False,4,463,1062,17,4,2024-09-10,False,False,True,0.6869340232858991,0.29948253557567917,0.010996119016817595,0.00258732212160414,Off-Peak,Tuesday,September
2024-09-10 05:00:00,219,632,12,1,864,231,444,9,4,688,23.7,98,63,10.1,1552,False,5,450,1076,21,5,2024-09-10,False,False,True,0.6932989690721649,0.28994845360824745,0.013530927835051547,0.0032216494845360823,Shoulder,Tuesday,September
2024-09-10 06:00:00,226,640,1,1,868,238,455,17,6,716,23.3,97,61,6.0,1584,False,6,464,1095,18,7,2024-09-10,False,False,True,0.6912878787878788,0.29292929292929293,0.011363636363636364,0.004419191919191919,Shoulder,Tuesday,September
2024-09-10 07:00:00,237,638,5,1,881,245,459,18,5,727,23.4,96,61,3.6,1608,False,7,482,1097,23,6,2024-09-10,False,False,True,0.6822139303482587,0.2997512437810945,0.014303482587064677,0.0037313432835820895,Peak,Tuesday,September
2024-09-10 08:00:00,241,651,12,2,906,247,468,16,2,733,23.7,96,55,4.5,1639,False,8,488,1119,28,4,2024-09-10,False,False,True,0.6827333740085418,0.29774252593044537,0.017083587553386213,0.0024405125076266015,Peak,Tuesday,September
2024-09-10 09:00:00,252,620,21,1,894,244,459,10,5,718,26.8,78,3,11.8,1612,False,9,496,1079,31,6,2024-09-10,False,False,True,0.6693548387096774,0.3076923076923077,0.019230769230769232,0.0037220843672456576,Shoulder,Tuesday,September
2024-09-10 10:00:00,244,619,17,1,881,243,449,13,7,712,27.0,75,3,10.4,1593,False,10,487,1068,30,8,2024-09-10,False,False,True,0.6704331450094162,0.30571249215317015,0.018832391713747645,0.005021971123666039,Shoulder,Tuesday,September
2024-09-10 11:00:00,237,639,21,2,899,237,443,11,5,696,28.1,70,3,8.4,1595,False,11,474,1082,32,7,2024-09-10,False,False,True,0.6783699059561129,0.29717868338557996,0.02006269592476489,0.00438871473354232,Peak,Tuesday,September
2024-09-10 12:00:00,228,622,20,1,871,240,439,11,4,694,27.8,72,51,7.4,1565,False,12,468,1061,31,5,2024-09-10,False,False,True,0.6779552715654952,0.2990415335463259,0.019808306709265176,0.003194888178913738,Peak,Tuesday,September
2024-09-10 13:00:00,199,641,15,1,856,236,428,11,2,677,27.8,74,51,8.4,1533,False,13,435,1069,26,3,2024-09-10,False,False,True,0.6973255055446836,0.2837573385518591,0.016960208741030658,0.0019569471624266144,Peak,Tuesday,September
2024-09-10 14:00:00,203,698,17,1,919,234,425,15,2,676,28.6,71,3,12.2,1595,False,14,437,1123,32,3,2024-09-10,False,False,True,0.7040752351097179,0.27398119122257053,0.02006269592476489,0.0018808777429467085,Peak,Tuesday,September
2024-09-10 15:00:00,209,639,6,2,856,239,420,14,1,674,28.7,71,3,10.5,1530,False,15,448,1059,20,3,2024-09-10,False,False,True,0.692156862745098,0.2928104575163399,0.013071895424836602,0.00196078431372549,Peak,Tuesday,September
2024-09-10 16:00:00,219,629,21,1,870,242,439,18,2,701,28.4,71,3,9.1,1571,False,16,461,1068,39,3,2024-09-10,False,False,True,0.67982176957352,0.2934436664544876,0.024824952259707194,0.0019096117122851686,Peak,Tuesday,September
2024-09-10 17:00:00,229,649,19,1,898,246,458,21,2,727,28.2,71,3,8.6,1625,False,17,475,1107,40,3,2024-09-10,False,False,True,0.6812307692307692,0.2923076923076923,0.024615384615384615,0.0018461538461538461,Peak,Tuesday,September
2024-09-10 18:00:00,230,651,16,1,898,257,463,18,3,741,27.8,72,3,7.0,1639,False,18,487,1114,34,4,2024-09-10,False,False,True,0.6796827333740085,0.29713239780353873,0.020744356314826115,0.0024405125076266015,Peak,Tuesday,September
2024-09-10 19:00:00,227,644,9,1,881,240,456,12,2,710,26.7,79,3,4.9,1591,False,19,467,1100,21,3,2024-09-10,False,False,True,0.6913890634820867,0.29352608422375864,0.013199245757385292,0.0018856065367693275,Peak,Tuesday,September
2024-09-10 20:00:00,236,639,11,2,888,231,451,11,1,694,26.3,81,3,6.6,1582,False,20,467,1090,22,3,2024-09-10,False,False,True,0.6890012642225032,0.2951959544879899,0.01390644753476612,0.0018963337547408343,Shoulder,Tuesday,September
2024-09-10 21:00:00,221,642,8,2,873,221,439,13,1,674,26.3,85,3,5.4,1547,False,21,442,1081,21,3,2024-09-10,False,False,True,0.6987718164188752,0.2857142857142857,0.013574660633484163,0.0019392372333548805,Shoulder,Tuesday,September
2024-09-10 22:00:00,231,638,13,1,883,205,425,10,2,642,26.3,86,3,6.8,1525,False,22,436,1063,23,3,2024-09-10,False,False,True,0.6970491803278689,0.28590163934426227,0.015081967213114755,0.0019672131147540984,Shoulder,Tuesday,September
2024-09-10 23:00:00,222,626,15,1,864,199,429,9,1,638,26.4,86,3,8.1,1502,False,23,421,1055,24,2,2024-09-10,False,False,True,0.7023968042609854,0.2802929427430093,0.015978695073235686,0.0013315579227696406,Shoulder,Tuesday,September
2024-09-11 00:00:00,166,572,4,2,744,166,379,6,3,554,26.6,85,3,7.3,1298,False,0,332,951,10,5,2024-09-11,False,False,False,0.7326656394453005,0.25577812018489987,0.007704160246533128,0.003852080123266564,Off-Peak,Wednesday,September
2024-09-11 01:00:00,168,568,9,1,746,165,360,7,3,535,26.4,85,3,8.1,1281,False,1,333,928,16,4,2024-09-11,False,False,False,0.7244340359094458,0.25995316159250587,0.01249024199843872,0.00312256049960968,Off-Peak,Wednesday,September
2024-09-11 02:00:00,167,549,10,1,727,154,357,12,1,524,26.4,84,3,10.1,1251,False,2,321,906,22,2,2024-09-11,False,False,False,0.7242206235011991,0.2565947242206235,0.017585931254996003,0.0015987210231814548,Off-Peak,Wednesday,September
2024-09-11 03:00:00,176,599,2,2,779,148,390,6,2,546,26.3,82,3,9.5,1325,False,3,324,989,8,4,2024-09-11,False,False,False,0.7464150943396226,0.24452830188679245,0.0060377358490566035,0.0030188679245283017,Off-Peak,Wednesday,September
2024-09-11 04:00:00,161,582,1,1,745,150,350,8,3,511,25.9,84,3,9.2,1256,False,4,311,932,9,4,2024-09-11,False,False,False,0.7420382165605095,0.24761146496815287,0.007165605095541401,0.0031847133757961785,Off-Peak,Wednesday,September
2024-09-11 05:00:00,168,597,7,1,773,184,381,10,6,581,25.6,88,2,7.9,1354,False,5,352,978,17,7,2024-09-11,False,False,False,0.7223042836041359,0.25997045790251105,0.012555391432791729,0.0051698670605613,Shoulder,Wednesday,September
2024-09-11 06:00:00,170,618,3,2,793,194,372,13,4,583,25.7,89,2,8.4,1376,False,6,364,990,16,6,2024-09-11,False,False,True,0.7194767441860465,0.26453488372093026,0.011627906976744186,0.00436046511627907,Shoulder,Wednesday,September
2024-09-11 07:00:00,189,626,15,1,831,201,399,15,5,620,25.2,90,3,8.7,1451,False,7,390,1025,30,6,2024-09-11,False,False,True,0.7064093728463129,0.2687801516195727,0.02067539627842867,0.004135079255685734,Peak,Wednesday,September
2024-09-11 08:00:00,191,597,17,1,806,199,412,6,3,620,25.6,89,3,10.4,1426,False,8,390,1009,23,4,2024-09-11,False,False,True,0.7075736325385694,0.27349228611500703,0.016129032258064516,0.002805049088359046,Peak,Wednesday,September
2024-09-11 09:00:00,186,589,19,1,795,187,375,8,2,572,26.9,88,3,4.7,1367,False,9,373,964,27,3,2024-09-11,False,False,False,0.7051938551572787,0.2728602779809802,0.019751280175566936,0.0021945866861741038,Shoulder,Wednesday,September
2024-09-11 10:00:00,184,593,13,1,791,184,375,9,2,570,28.7,76,3,6.6,1361,False,10,368,968,22,3,2024-09-11,False,False,False,0.7112417340191036,0.2703894195444526,0.016164584864070537,0.002204261572373255,Shoulder,Wednesday,September
2024-09-11 11:00:00,167,600,12,3,782,179,375,8,1,563,30.0,67,1,8.6,1345,False,11,346,975,20,4,2024-09-11,False,False,False,0.724907063197026,0.2572490706319703,0.01486988847583643,0.002973977695167286,Peak,Wednesday,September
2024-09-11 12:00:00,179,601,6,1,787,180,357,7,3,547,30.6,64,0,10.0,1334,False,12,359,958,13,4,2024-09-11,False,False,False,0.7181409295352323,0.2691154422788606,0.009745127436281859,0.0029985007496251873,Peak,Wednesday,September
2024-09-11 13:00:00,183,594,10,2,789,177,346,12,1,536,30.8,65,0,10.5,1325,False,13,360,940,22,3,2024-09-11,False,False,False,0.7094339622641509,0.27169811320754716,0.01660377358490566,0.0022641509433962265,Peak,Wednesday,September
2024-09-11 14:00:00,185,599,9,2,795,193,369,13,2,577,30.7,67,0,12.1,1372,False,14,378,968,22,4,2024-09-11,False,False,False,0.7055393586005831,0.2755102040816326,0.016034985422740525,0.0029154518950437317,Peak,Wednesday,September
2024-09-11 15:00:00,187,611,13,3,814,184,439,9,3,635,30.4,68,51,11.8,1449,False,15,371,1050,22,6,2024-09-11,False,False,True,0.7246376811594203,0.2560386473429952,0.01518288474810214,0.004140786749482402,Peak,Wednesday,September
2024-09-11 16:00:00,189,620,15,1,825,166,422,14,6,608,30.1,70,1,9.0,1433,False,16,355,1042,29,7,2024-09-11,False,False,True,0.7271458478715981,0.2477320307048151,0.020237264480111653,0.004884856943475227,Peak,Wednesday,September
2024-09-11 17:00:00,194,618,11,1,824,201,428,12,7,648,30.4,67,1,7.4,1472,False,17,395,1046,23,8,2024-09-11,False,False,True,0.7105978260869565,0.26834239130434784,0.015625,0.005434782608695652,Peak,Wednesday,September
2024-09-11 18:00:00,186,615,11,1,813,168,389,9,5,571,29.4,73,1,6.4,1384,False,18,354,1004,20,6,2024-09-11,False,False,True,0.7254335260115607,0.25578034682080925,0.014450867052023121,0.004335260115606936,Peak,Wednesday,September
2024-09-11 19:00:00,177,603,10,2,792,177,366,2,1,546,28.3,79,1,5.9,1338,False,19,354,969,12,3,2024-09-11,False,False,False,0.7242152466367713,0.2645739910313901,0.008968609865470852,0.002242152466367713,Peak,Wednesday,September
2024-09-11 20:00:00,169,599,9,1,778,158,352,5,1,516,27.7,82,1,5.9,1294,False,20,327,951,14,2,2024-09-11,False,False,False,0.7349304482225657,0.2527047913446677,0.010819165378670788,0.0015455950540958269,Shoulder,Wednesday,September
2024-09-11 21:00:00,172,597,5,2,776,179,346,8,3,536,28.6,76,3,10.6,1312,False,21,351,943,13,5,2024-09-11,False,False,False,0.71875,0.26753048780487804,0.009908536585365854,0.0038109756097560975,Shoulder,Wednesday,September
2024-09-11 22:00:00,168,598,8,1,775,242,322,7,4,575,28.5,76,3,7.9,1350,False,22,410,920,15,5,2024-09-11,False,False,False,0.6814814814814815,0.3037037037037037,0.011111111111111112,0.003703703703703704,Shoulder,Wednesday,September
2024-09-11 23:00:00,181,600,7,1,789,284,343,6,5,638,28.1,80,3,7.1,1427,False,23,465,943,13,6,2024-09-11,False,False,True,0.6608269096005606,0.3258584442887176,0.009110021023125438,0.004204625087596356,Shoulder,Wednesday,September
2024-09-12 00:00:00,138,523,2,2,665,121,299,4,4,428,27.2,86,3,10.1,1093,False,0,259,822,6,6,2024-09-12,False,False,False,0.7520585544373285,0.23696248856358645,0.0054894784995425435,0.0054894784995425435,Off-Peak,Thursday,September
2024-09-12 01:00:00,132,531,1,1,665,132,327,3,3,465,26.5,87,55,6.7,1130,False,1,264,858,4,4,2024-09-12,False,False,False,0.7592920353982301,0.2336283185840708,0.0035398230088495575,0.0035398230088495575,Off-Peak,Thursday,September
2024-09-12 02:00:00,137,538,1,2,678,125,344,0,2,471,25.4,95,63,2.9,1149,False,2,262,882,1,4,2024-09-12,False,False,False,0.7676240208877284,0.2280243690165361,0.0008703220191470844,0.0034812880765883376,Off-Peak,Thursday,September
2024-09-12 03:00:00,142,521,1,1,665,130,356,1,0,487,24.5,98,63,6.0,1152,False,3,272,877,2,1,2024-09-12,False,False,False,0.7612847222222222,0.2361111111111111,0.001736111111111111,0.0008680555555555555,Off-Peak,Thursday,September
2024-09-12 04:00:00,130,437,2,1,570,146,325,6,2,479,24.0,96,63,3.4,1049,False,4,276,762,8,3,2024-09-12,False,False,False,0.7264061010486177,0.2631077216396568,0.0076263107721639654,0.002859866539561487,Off-Peak,Thursday,September
2024-09-12 05:00:00,136,532,3,3,674,166,356,7,1,530,24.3,95,61,1.5,1204,False,5,302,888,10,4,2024-09-12,False,False,False,0.7375415282392026,0.25083056478405313,0.008305647840531562,0.0033222591362126247,Shoulder,Thursday,September
2024-09-12 06:00:00,147,533,2,1,683,158,347,4,6,515,24.4,96,51,0.4,1198,False,6,305,880,6,7,2024-09-12,False,False,False,0.7345575959933222,0.25459098497495825,0.005008347245409015,0.005843071786310518,Shoulder,Thursday,September
2024-09-12 07:00:00,150,532,5,2,689,161,344,2,4,511,24.4,97,51,7.4,1200,False,7,311,876,7,6,2024-09-12,False,False,False,0.73,0.25916666666666666,0.005833333333333334,0.005,Peak,Thursday,September
2024-09-12 08:00:00,152,528,3,1,684,144,362,2,1,509,24.8,95,51,6.2,1193,False,8,296,890,5,2,2024-09-12,False,False,False,0.7460184409052808,0.24811399832355407,0.004191114836546521,0.0016764459346186086,Peak,Thursday,September
2024-09-12 09:00:00,159,538,9,3,709,142,344,6,3,495,25.3,89,51,12.1,1204,False,9,301,882,15,6,2024-09-12,False,False,False,0.7325581395348837,0.25,0.012458471760797342,0.0049833887043189366,Shoulder,Thursday,September
2024-09-12 10:00:00,145,543,8,2,698,137,325,4,7,473,27.0,82,3,11.6,1171,False,10,282,868,12,9,2024-09-12,False,False,False,0.7412467976088813,0.2408198121263877,0.010247651579846286,0.007685738684884714,Shoulder,Thursday,September
2024-09-12 11:00:00,139,545,4,1,689,132,311,2,2,447,28.3,77,3,11.7,1136,False,11,271,856,6,3,2024-09-12,False,False,False,0.7535211267605634,0.238556338028169,0.00528169014084507,0.002640845070422535,Peak,Thursday,September
2024-09-12 12:00:00,147,532,1,1,681,147,299,1,3,450,29.0,76,51,11.2,1131,False,12,294,831,2,4,2024-09-12,False,False,False,0.7347480106100795,0.259946949602122,0.0017683465959328027,0.0035366931918656055,Peak,Thursday,September
2024-09-12 13:00:00,138,639,2,1,780,132,309,4,1,446,29.3,75,51,11.5,1226,False,13,270,948,6,2,2024-09-12,False,False,False,0.7732463295269169,0.22022838499184338,0.004893964110929853,0.0016313213703099511,Peak,Thursday,September
2024-09-12 14:00:00,132,528,1,3,664,138,314,2,5,459,29.8,73,51,11.9,1123,False,14,270,842,3,8,2024-09-12,False,False,False,0.7497773820124666,0.2404274265360641,0.0026714158504007124,0.007123775601068566,Peak,Thursday,September
2024-09-12 15:00:00,142,542,6,1,691,165,322,1,3,491,29.7,72,3,12.4,1182,False,15,307,864,7,4,2024-09-12,False,False,False,0.7309644670050761,0.25972927241962773,0.005922165820642978,0.00338409475465313,Peak,Thursday,September
2024-09-12 16:00:00,155,548,13,2,718,164,352,3,4,523,29.4,73,3,11.8,1241,False,16,319,900,16,6,2024-09-12,False,False,False,0.7252215954875101,0.2570507655116841,0.0128928283642224,0.004834810636583401,Peak,Thursday,September
2024-09-12 17:00:00,161,549,10,3,723,148,356,2,5,511,28.7,74,3,9.0,1234,False,17,309,905,12,8,2024-09-12,False,False,False,0.733387358184765,0.25040518638573744,0.009724473257698542,0.006482982171799027,Peak,Thursday,September
2024-09-12 18:00:00,158,539,6,1,704,177,311,3,4,495,28.1,77,3,7.1,1199,False,18,335,850,9,5,2024-09-12,False,False,False,0.7089241034195163,0.2793994995829858,0.007506255212677231,0.004170141784820684,Peak,Thursday,September
2024-09-12 19:00:00,155,512,3,1,671,127,341,1,7,476,27.7,79,3,9.2,1147,False,19,282,853,4,8,2024-09-12,False,False,False,0.7436791630340017,0.24585876198779424,0.0034873583260680036,0.006974716652136007,Peak,Thursday,September
2024-09-12 20:00:00,142,508,2,1,653,127,322,4,2,455,27.4,80,3,9.1,1108,False,20,269,830,6,3,2024-09-12,False,False,False,0.7490974729241877,0.2427797833935018,0.005415162454873646,0.002707581227436823,Shoulder,Thursday,September
2024-09-12 21:00:00,138,516,4,2,660,157,288,1,3,449,27.1,82,3,6.6,1109,False,21,295,804,5,5,2024-09-12,False,False,False,0.7249774571686204,0.2660054102795311,0.004508566275924256,0.004508566275924256,Shoulder,Thursday,September
2024-09-12 22:00:00,142,512,1,2,657,142,305,2,1,450,27.0,83,3,7.3,1107,False,22,284,817,3,3,2024-09-12,False,False,False,0.7380307136404698,0.2565492321589883,0.0027100271002710027,0.0027100271002710027,Shoulder,Thursday,September
2024-09-12 23:00:00,137,511,1,1,650,129,293,1,3,426,26.8,83,3,7.4,1076,False,23,266,804,2,4,2024-09-12,False,False,False,0.7472118959107806,0.24721189591078066,0.0018587360594795538,0.0037174721189591076,Shoulder,Thursday,September
2024-09-13 00:00:00,189,597,9,3,798,281,466,10,2,759,26.2,87,3,6.5,1557,False,0,470,1063,19,5,2024-09-13,False,False,True,0.682723185613359,0.3018625561978163,0.012202954399486191,0.0032113037893384713,Off-Peak,Friday,September
2024-09-13 01:00:00,201,610,10,2,823,270,438,7,3,718,26.0,88,3,7.3,1541,False,1,471,1048,17,5,2024-09-13,False,False,True,0.6800778715120052,0.3056456846203764,0.011031797534068787,0.003244646333549643,Off-Peak,Friday,September
2024-09-13 02:00:00,219,632,12,4,867,277,455,8,1,741,25.8,89,2,4.6,1608,False,2,496,1087,20,5,2024-09-13,False,False,True,0.6759950248756219,0.30845771144278605,0.012437810945273632,0.003109452736318408,Off-Peak,Friday,September
2024-09-13 03:00:00,206,622,4,3,835,269,489,8,1,767,25.7,89,3,6.8,1602,False,3,475,1111,12,4,2024-09-13,False,False,True,0.6935081148564295,0.2965043695380774,0.00749063670411985,0.0024968789013732834,Off-Peak,Friday,September
2024-09-13 04:00:00,198,618,9,3,828,298,522,6,0,826,25.4,91,3,8.7,1654,False,4,496,1140,15,3,2024-09-13,False,False,True,0.6892382103990327,0.2998790810157195,0.009068923821039904,0.0018137847642079807,Off-Peak,Friday,September
2024-09-13 05:00:00,217,633,8,2,860,289,523,10,2,824,25.2,89,2,6.9,1684,False,5,506,1156,18,4,2024-09-13,False,False,True,0.6864608076009501,0.3004750593824228,0.010688836104513063,0.0023752969121140144,Shoulder,Friday,September
2024-09-13 06:00:00,213,636,15,1,865,310,537,11,5,863,24.8,88,2,6.1,1728,False,6,523,1173,26,6,2024-09-13,False,False,True,0.6788194444444444,0.30266203703703703,0.015046296296296295,0.003472222222222222,Shoulder,Friday,September
2024-09-13 07:00:00,216,632,12,2,862,321,524,8,7,860,24.6,88,3,6.8,1722,False,7,537,1156,20,9,2024-09-13,False,False,True,0.6713124274099884,0.3118466898954704,0.011614401858304297,0.005226480836236934,Peak,Friday,September
2024-09-13 08:00:00,231,649,9,1,890,301,531,14,2,848,25.0,87,3,7.8,1738,False,8,532,1180,23,3,2024-09-13,False,False,True,0.6789413118527042,0.30609896432681244,0.013233601841196778,0.0017261219792865361,Peak,Friday,September
2024-09-13 09:00:00,220,639,14,2,875,299,532,11,1,843,26.6,90,51,5.5,1718,False,9,519,1171,25,3,2024-09-13,False,False,True,0.6816065192083819,0.3020954598370198,0.014551804423748545,0.0017462165308498253,Shoulder,Friday,September
2024-09-13 10:00:00,217,624,3,3,847,286,528,9,3,826,27.9,84,3,6.8,1673,False,10,503,1152,12,6,2024-09-13,False,False,True,0.6885833831440527,0.3006575014943216,0.007172743574417215,0.0035863717872086074,Shoulder,Friday,September
2024-09-13 11:00:00,219,615,12,2,848,266,512,2,5,785,29.0,73,51,7.7,1633,False,11,485,1127,14,7,2024-09-13,False,False,True,0.6901408450704225,0.2969993876301286,0.008573178199632579,0.004286589099816289,Peak,Friday,September
2024-09-13 12:00:00,203,628,7,1,839,247,498,6,2,753,29.8,68,3,8.0,1592,False,12,450,1126,13,3,2024-09-13,False,False,True,0.707286432160804,0.28266331658291455,0.008165829145728644,0.0018844221105527637,Peak,Friday,September
2024-09-13 13:00:00,197,630,6,3,836,278,501,9,3,791,30.0,66,3,9.5,1627,False,13,475,1131,15,6,2024-09-13,False,False,True,0.6951444376152428,0.29194837123540257,0.00921942224953903,0.0036877688998156115,Peak,Friday,September
2024-09-13 14:00:00,201,621,8,3,833,266,523,15,1,805,30.1,67,3,10.8,1638,False,14,467,1144,23,4,2024-09-13,False,False,True,0.6984126984126984,0.2851037851037851,0.014041514041514042,0.002442002442002442,Peak,Friday,September
2024-09-13 15:00:00,199,648,9,1,857,314,555,4,2,875,30.1,67,3,11.0,1732,False,15,513,1203,13,3,2024-09-13,False,False,True,0.6945727482678984,0.29618937644341803,0.007505773672055427,0.0017321016166281756,Peak,Friday,September
2024-09-13 16:00:00,216,632,5,1,854,288,573,11,4,876,30.0,65,3,11.1,1730,False,16,504,1205,16,5,2024-09-13,False,False,True,0.6965317919075145,0.29132947976878615,0.009248554913294798,0.002890173410404624,Peak,Friday,September
2024-09-13 17:00:00,223,635,12,3,873,310,524,14,6,854,29.3,68,3,10.5,1727,False,17,533,1159,26,9,2024-09-13,False,False,True,0.6711059640995947,0.30862767805442964,0.015055008685581933,0.0052113491603937466,Peak,Friday,September
2024-09-13 18:00:00,236,611,16,4,867,326,499,8,1,834,28.9,71,3,9.4,1701,False,18,562,1110,24,5,2024-09-13,False,False,True,0.6525573192239859,0.3303938859494415,0.014109347442680775,0.0029394473838918285,Peak,Friday,September
2024-09-13 19:00:00,231,627,13,2,873,277,481,7,1,766,28.1,75,2,8.3,1639,False,19,508,1108,20,3,2024-09-13,False,False,True,0.6760219646125687,0.3099450884685784,0.012202562538133009,0.0018303843807199512,Peak,Friday,September
2024-09-13 20:00:00,211,621,9,1,842,271,500,5,0,776,27.4,79,2,8.8,1618,False,20,482,1121,14,1,2024-09-13,False,False,True,0.6928306551297899,0.2978986402966625,0.00865265760197775,0.0006180469715698393,Shoulder,Friday,September
2024-09-13 21:00:00,203,617,7,2,829,289,482,4,3,778,26.8,80,3,5.0,1607,False,21,492,1099,11,5,2024-09-13,False,False,True,0.6838830118232732,0.3061605476042315,0.006845052893590542,0.0031113876789047915,Shoulder,Friday,September
2024-09-13 22:00:00,189,599,12,2,802,289,496,9,2,796,26.3,83,3,5.4,1598,False,22,478,1095,21,4,2024-09-13,False,False,True,0.6852315394242804,0.29912390488110135,0.013141426783479349,0.0025031289111389237,Shoulder,Friday,September
2024-09-13 23:00:00,176,583,8,1,768,300,538,6,1,845,25.9,85,3,4.2,1613,False,23,476,1121,14,2,2024-09-13,False,False,True,0.6949783013019218,0.29510229386236825,0.008679479231246125,0.0012399256044637321,Shoulder,Friday,September
2024-09-14 00:00:00,210,549,12,2,773,269,538,11,3,821,25.4,86,3,4.1,1594,True,0,479,1087,23,5,2024-09-14,False,False,True,0.6819322459222082,0.30050188205771644,0.014429109159347553,0.003136762860727729,Off-Peak,Saturday,September
2024-09-14 01:00:00,225,563,9,1,798,283,591,7,2,883,25.5,84,3,5.6,1681,True,1,508,1154,16,3,2024-09-14,False,False,True,0.6864961332540155,0.30220107079119574,0.009518143961927425,0.001784651992861392,Off-Peak,Saturday,September
2024-09-14 02:00:00,231,567,9,2,809,291,522,9,1,823,25.3,86,3,5.5,1632,True,2,522,1089,18,3,2024-09-14,False,False,True,0.6672794117647058,0.31985294117647056,0.011029411764705883,0.001838235294117647,Off-Peak,Saturday,September
2024-09-14 03:00:00,229,533,10,1,773,315,511,13,2,841,25.5,89,3,3.7,1614,True,3,544,1044,23,3,2024-09-14,False,False,True,0.6468401486988847,0.33705080545229243,0.014250309789343246,0.0018587360594795538,Off-Peak,Saturday,September
2024-09-14 04:00:00,228,586,11,2,827,328,533,19,1,881,25.5,89,51,5.6,1708,True,4,556,1119,30,3,2024-09-14,False,False,True,0.655152224824356,0.3255269320843091,0.01756440281030445,0.001756440281030445,Off-Peak,Saturday,September
2024-09-14 05:00:00,226,455,13,1,695,325,574,16,4,919,24.5,96,61,7.6,1614,True,5,551,1029,29,5,2024-09-14,False,False,True,0.637546468401487,0.34138785625774476,0.017967781908302356,0.0030978934324659233,Shoulder,Saturday,September
2024-09-14 06:00:00,247,490,18,1,756,354,586,26,7,973,24.5,96,51,3.9,1729,True,6,601,1076,44,8,2024-09-14,False,False,True,0.6223250433776749,0.3475997686524002,0.025448235974551765,0.004626951995373048,Shoulder,Saturday,September
2024-09-14 07:00:00,269,596,11,2,878,326,558,21,11,916,24.5,96,3,1.8,1794,True,7,595,1154,32,13,2024-09-14,False,False,True,0.6432552954292085,0.33166109253065773,0.017837235228539576,0.007246376811594203,Peak,Saturday,September
2024-09-14 08:00:00,275,570,9,1,855,329,567,24,8,928,25.2,94,3,3.7,1783,True,8,604,1137,33,9,2024-09-14,False,False,True,0.6376892877173304,0.3387549074593382,0.018508132361189006,0.005047672462142457,Peak,Saturday,September
2024-09-14 09:00:00,244,562,19,1,826,328,553,11,6,898,27.4,78,51,4.8,1724,True,9,572,1115,30,7,2024-09-14,False,False,True,0.6467517401392111,0.33178654292343385,0.01740139211136891,0.004060324825986079,Shoulder,Saturday,September
2024-09-14 10:00:00,247,634,12,3,896,352,528,17,3,900,27.9,76,51,4.5,1796,True,10,599,1162,29,6,2024-09-14,False,False,True,0.6469933184855234,0.33351893095768376,0.016146993318485525,0.0033407572383073497,Shoulder,Saturday,September
2024-09-14 11:00:00,236,613,9,1,859,328,520,14,4,866,28.4,75,3,6.7,1725,True,11,564,1133,23,5,2024-09-14,False,False,True,0.6568115942028986,0.3269565217391304,0.013333333333333334,0.002898550724637681,Peak,Saturday,September
2024-09-14 12:00:00,234,598,10,2,844,312,511,12,1,836,29.0,73,3,8.3,1680,True,12,546,1109,22,3,2024-09-14,False,False,True,0.6601190476190476,0.325,0.013095238095238096,0.0017857142857142857,Peak,Saturday,September
2024-09-14 13:00:00,231,587,18,1,837,328,499,11,2,840,29.4,73,3,11.6,1677,True,13,559,1086,29,3,2024-09-14,False,False,True,0.6475849731663685,0.3333333333333333,0.0172927847346452,0.0017889087656529517,Peak,Saturday,September
2024-09-14 14:00:00,236,590,16,1,843,311,451,12,3,777,29.5,73,3,12.1,1620,True,14,547,1041,28,4,2024-09-14,False,False,True,0.6425925925925926,0.3376543209876543,0.01728395061728395,0.0024691358024691358,Peak,Saturday,September
2024-09-14 15:00:00,244,523,17,1,785,299,497,13,1,810,29.3,74,3,9.8,1595,True,15,543,1020,30,2,2024-09-14,False,False,True,0.6394984326018809,0.3404388714733542,0.018808777429467086,0.0012539184952978057,Peak,Saturday,September
2024-09-14 16:00:00,257,563,15,3,838,244,542,17,9,812,29.6,72,1,9.8,1650,True,16,501,1105,32,12,2024-09-14,False,False,True,0.6696969696969697,0.30363636363636365,0.019393939393939394,0.007272727272727273,Peak,Saturday,September
2024-09-14 17:00:00,268,582,9,2,861,204,578,15,10,807,29.1,74,0,9.7,1668,True,17,472,1160,24,12,2024-09-14,False,False,True,0.6954436450839329,0.2829736211031175,0.014388489208633094,0.007194244604316547,Peak,Saturday,September
2024-09-14 18:00:00,263,608,14,1,886,358,528,19,8,913,28.6,76,0,7.5,1799,True,18,621,1136,33,9,2024-09-14,False,False,True,0.631461923290717,0.3451917732073374,0.018343524180100056,0.005002779321845469,Peak,Saturday,September
2024-09-14 19:00:00,233,592,11,2,838,362,527,17,5,911,27.8,79,3,5.9,1749,True,19,595,1119,28,7,2024-09-14,False,False,True,0.6397941680960549,0.3401943967981704,0.016009148084619784,0.004002287021154946,Peak,Saturday,September
2024-09-14 20:00:00,231,574,9,1,815,319,437,12,4,772,27.4,82,3,6.9,1587,True,20,550,1011,21,5,2024-09-14,False,False,True,0.6370510396975425,0.3465658475110271,0.013232514177693762,0.00315059861373661,Shoulder,Saturday,September
2024-09-14 21:00:00,237,561,15,1,814,299,492,7,1,799,27.9,78,3,9.4,1613,True,21,536,1053,22,2,2024-09-14,False,False,True,0.652820830750155,0.3323000619962802,0.013639181649101054,0.0012399256044637321,Shoulder,Saturday,September
2024-09-14 22:00:00,228,552,12,1,793,305,503,9,2,819,27.7,80,3,6.3,1612,True,22,533,1055,21,3,2024-09-14,False,False,True,0.6544665012406948,0.33064516129032256,0.013027295285359801,0.0018610421836228288,Shoulder,Saturday,September
2024-09-14 23:00:00,219,548,9,1,777,293,527,11,3,834,27.3,82,3,7.4,1611,True,23,512,1075,20,4,2024-09-14,False,False,True,0.6672873991309746,0.31781502172563625,0.012414649286157667,0.002482929857231533,Shoulder,Saturday,September
2024-09-15 00:00:00,233,566,9,2,810,239,488,7,3,737,26.6,87,3,4.1,1547,True,0,472,1054,16,5,2024-09-15,False,False,True,0.6813186813186813,0.30510665804783454,0.010342598577892695,0.003232062055591467,Off-Peak,Sunday,September
2024-09-15 01:00:00,242,566,4,3,815,298,497,0,2,797,26.1,91,3,4.7,1612,True,1,540,1063,4,5,2024-09-15,False,False,True,0.6594292803970223,0.3349875930521092,0.0024813895781637717,0.003101736972704715,Off-Peak,Sunday,September
2024-09-15 02:00:00,216,553,12,2,783,302,473,9,3,787,26.2,89,3,3.3,1570,True,2,518,1026,21,5,2024-09-15,False,False,True,0.6535031847133758,0.32993630573248406,0.01337579617834395,0.0031847133757961785,Off-Peak,Sunday,September
2024-09-15 03:00:00,267,562,9,1,839,289,489,4,1,783,25.5,91,3,3.7,1622,True,3,556,1051,13,2,2024-09-15,False,False,True,0.6479654747225647,0.34278668310727495,0.008014796547472256,0.0012330456226880395,Off-Peak,Sunday,September
2024-09-15 04:00:00,244,554,12,3,813,302,481,11,1,795,25.4,90,3,2.8,1608,True,4,546,1035,23,4,2024-09-15,False,False,True,0.6436567164179104,0.33955223880597013,0.014303482587064677,0.0024875621890547263,Off-Peak,Sunday,September
2024-09-15 05:00:00,165,577,4,1,747,311,493,14,5,823,25.5,87,3,2.5,1570,True,5,476,1070,18,6,2024-09-15,False,False,True,0.6815286624203821,0.30318471337579617,0.011464968152866241,0.003821656050955414,Shoulder,Sunday,September
2024-09-15 06:00:00,272,583,12,2,869,282,499,19,6,806,25.6,88,3,2.5,1675,True,6,554,1082,31,8,2024-09-15,False,False,True,0.6459701492537313,0.3307462686567164,0.018507462686567163,0.004776119402985075,Shoulder,Sunday,September
2024-09-15 07:00:00,244,571,9,4,828,311,489,22,11,833,25.1,91,3,4.9,1661,True,7,555,1060,31,15,2024-09-15,False,False,True,0.6381697772426249,0.3341360626128838,0.018663455749548464,0.009030704394942806,Peak,Sunday,September
2024-09-15 08:00:00,225,588,17,1,831,329,461,16,9,815,24.4,94,63,13.0,1646,True,8,554,1049,33,10,2024-09-15,False,False,True,0.6373025516403402,0.33657351154313486,0.020048602673147023,0.006075334143377886,Peak,Sunday,September
2024-09-15 09:00:00,216,592,18,1,827,319,438,14,3,774,27.3,82,61,11.0,1601,True,9,535,1030,32,4,2024-09-15,False,False,True,0.6433479075577764,0.33416614615865087,0.019987507807620236,0.0024984384759525295,Shoulder,Sunday,September
2024-09-15 10:00:00,246,563,19,3,831,298,449,14,2,763,26.6,84,63,10.3,1594,True,10,544,1012,33,5,2024-09-15,False,False,True,0.6348808030112923,0.34127979924717694,0.02070263488080301,0.003136762860727729,Shoulder,Sunday,September
2024-09-15 11:00:00,234,540,11,2,787,284,437,8,2,731,26.6,88,61,10.8,1518,True,11,518,977,19,4,2024-09-15,False,False,True,0.6436100131752306,0.3412384716732543,0.012516469038208168,0.002635046113306983,Peak,Sunday,September
2024-09-15 12:00:00,222,567,9,1,799,299,441,11,1,752,26.6,86,63,8.0,1551,True,12,521,1008,20,2,2024-09-15,False,False,True,0.6499032882011605,0.3359123146357189,0.012894906511927788,0.0012894906511927789,Peak,Sunday,September
2024-09-15 13:00:00,241,549,18,2,810,293,428,8,1,730,28.4,80,3,5.1,1540,True,13,534,977,26,3,2024-09-15,False,False,True,0.6344155844155844,0.34675324675324676,0.016883116883116882,0.001948051948051948,Peak,Sunday,September
2024-09-15 14:00:00,221,573,16,1,811,249,417,14,5,685,28.3,79,3,6.8,1496,True,14,470,990,30,6,2024-09-15,False,False,True,0.6617647058823529,0.3141711229946524,0.020053475935828877,0.004010695187165776,Peak,Sunday,September
2024-09-15 15:00:00,271,556,12,2,841,278,401,6,0,685,29.2,74,3,9.4,1526,True,15,549,957,18,2,2024-09-15,False,False,True,0.627129750982962,0.3597640891218873,0.011795543905635648,0.001310615989515072,Peak,Sunday,September
2024-09-15 16:00:00,253,583,17,1,854,297,437,21,10,765,29.5,72,3,7.8,1619,True,16,550,1020,38,11,2024-09-15,False,False,True,0.6300185299567634,0.339715873996294,0.02347127856701668,0.0067943174799258805,Peak,Sunday,September
2024-09-15 17:00:00,244,591,19,3,857,302,485,15,7,809,29.2,72,51,9.9,1666,True,17,546,1076,34,10,2024-09-15,False,False,True,0.6458583433373349,0.3277310924369748,0.02040816326530612,0.006002400960384154,Peak,Sunday,September
2024-09-15 18:00:00,251,596,16,1,864,299,475,19,4,797,28.6,76,1,8.5,1661,True,18,550,1071,35,5,2024-09-15,False,False,True,0.6447922937989163,0.33112582781456956,0.02107164358819988,0.0030102347983142685,Peak,Sunday,September
2024-09-15 19:00:00,233,588,11,1,833,289,467,8,3,767,27.7,80,1,5.7,1600,True,19,522,1055,19,4,2024-09-15,False,False,True,0.659375,0.32625,0.011875,0.0025,Peak,Sunday,September
2024-09-15 20:00:00,211,563,9,2,785,277,448,6,2,733,27.2,82,3,5.8,1518,True,20,488,1011,15,4,2024-09-15,False,False,True,0.66600790513834,0.3214756258234519,0.009881422924901186,0.002635046113306983,Shoulder,Sunday,September
2024-09-15 21:00:00,219,557,10,1,787,269,450,10,2,731,26.4,89,51,3.1,1518,True,21,488,1007,20,3,2024-09-15,False,False,True,0.663372859025033,0.3214756258234519,0.013175230566534914,0.001976284584980237,Shoulder,Sunday,September
2024-09-15 22:00:00,207,569,9,3,788,273,453,8,1,735,26.3,89,51,5.2,1523,True,22,480,1022,17,4,2024-09-15,False,False,True,0.6710439921208142,0.31516743269862113,0.011162179908076166,0.0026263952724885093,Shoulder,Sunday,September
2024-09-15 23:00:00,198,571,8,4,781,281,449,6,2,738,25.9,92,3,4.2,1519,True,23,479,1020,14,6,2024-09-15,False,False,True,0.6714944042132982,0.315339038841343,0.009216589861751152,0.003949967083607637,Shoulder,Sunday,September
2024-09-16 00:00:00,169,529,8,1,707,252,417,6,2,677,25.8,92,3,5.1,1384,False,0,421,946,14,3,2024-09-16,True,True,True,0.6835260115606936,0.3041907514450867,0.010115606936416185,0.002167630057803468,Off-Peak,Monday,September
2024-09-16 01:00:00,173,534,4,2,713,237,397,6,3,643,25.4,94,51,3.6,1356,False,1,410,931,10,5,2024-09-16,True,True,False,0.6865781710914455,0.3023598820058997,0.007374631268436578,0.003687315634218289,Off-Peak,Monday,September
2024-09-16 02:00:00,158,540,2,1,701,249,414,5,2,670,25.2,94,61,10.1,1371,False,2,407,954,7,3,2024-09-16,True,True,False,0.6958424507658644,0.29686360320933625,0.005105762217359592,0.002188183807439825,Off-Peak,Monday,September
2024-09-16 03:00:00,158,549,7,1,715,343,594,7,2,946,24.8,94,63,9.8,1661,False,3,501,1143,14,3,2024-09-16,True,True,True,0.6881396748946418,0.3016255267910897,0.008428657435279952,0.001806140878988561,Off-Peak,Monday,September
2024-09-16 04:00:00,179,552,6,2,739,229,379,6,2,616,25.0,93,53,8.7,1355,False,4,408,931,12,4,2024-09-16,True,True,False,0.6870848708487085,0.3011070110701107,0.008856088560885609,0.002952029520295203,Off-Peak,Monday,September
2024-09-16 05:00:00,182,559,5,2,748,206,325,4,2,537,25.0,93,51,12.6,1285,False,5,388,884,9,4,2024-09-16,True,True,False,0.6879377431906615,0.3019455252918288,0.007003891050583658,0.0031128404669260703,Shoulder,Monday,September
2024-09-16 06:00:00,174,560,3,1,738,239,385,5,2,631,25.4,89,51,12.2,1369,False,6,413,945,8,3,2024-09-16,True,True,False,0.6902848794740687,0.30168005843681517,0.005843681519357195,0.002191380569758948,Shoulder,Monday,September
2024-09-16 07:00:00,176,559,4,2,741,218,349,4,2,573,25.3,89,51,8.8,1314,False,7,394,908,8,4,2024-09-16,True,True,False,0.6910197869101978,0.2998477929984779,0.0060882800608828,0.0030441400304414,Peak,Monday,September
2024-09-16 08:00:00,182,571,8,1,762,272,459,7,2,740,26.0,90,3,9.2,1502,False,8,454,1030,15,3,2024-09-16,True,True,True,0.6857523302263648,0.3022636484687084,0.009986684420772303,0.0019973368841544607,Peak,Monday,September
2024-09-16 09:00:00,201,566,11,3,781,186,278,6,3,473,26.5,89,51,5.5,1254,False,9,387,844,17,6,2024-09-16,True,True,False,0.6730462519936204,0.30861244019138756,0.013556618819776715,0.004784688995215311,Shoulder,Monday,September
2024-09-16 10:00:00,188,549,12,2,751,321,557,9,2,889,27.4,84,51,4.3,1640,False,10,509,1106,21,4,2024-09-16,True,True,True,0.6743902439024391,0.3103658536585366,0.012804878048780487,0.0024390243902439024,Shoulder,Monday,September
2024-09-16 11:00:00,175,552,8,1,736,294,510,7,2,813,28.4,77,3,6.3,1549,False,11,469,1062,15,3,2024-09-16,True,True,True,0.6856036152356358,0.30277598450613297,0.009683666881859263,0.001936733376371853,Peak,Monday,September
2024-09-16 12:00:00,163,547,6,1,717,279,474,7,2,762,28.9,75,3,6.1,1479,False,12,442,1021,13,3,2024-09-16,True,True,True,0.6903313049357674,0.2988505747126437,0.00878972278566599,0.002028397565922921,Peak,Monday,September
2024-09-16 13:00:00,166,560,2,2,730,294,507,8,2,811,29.6,72,3,10.4,1541,False,13,460,1067,10,4,2024-09-16,True,True,True,0.6924075275794939,0.29850746268656714,0.006489292667099286,0.0025957170668397143,Peak,Monday,September
2024-09-16 14:00:00,176,549,12,1,738,197,306,5,2,510,30.2,72,51,13.2,1248,False,14,373,855,17,3,2024-09-16,True,True,False,0.6850961538461539,0.2988782051282051,0.013621794871794872,0.002403846153846154,Peak,Monday,September
2024-09-16 15:00:00,181,548,13,3,745,255,425,9,2,691,30.2,72,51,11.5,1436,False,15,436,973,22,5,2024-09-16,True,True,True,0.6775766016713092,0.30362116991643456,0.01532033426183844,0.003481894150417827,Peak,Monday,September
2024-09-16 16:00:00,160,541,8,1,710,296,506,10,5,817,30.3,72,3,8.0,1527,False,16,456,1047,18,6,2024-09-16,True,True,True,0.6856581532416502,0.29862475442043224,0.011787819253438114,0.003929273084479371,Peak,Monday,September
2024-09-16 17:00:00,183,563,6,1,753,170,255,5,2,432,29.9,73,3,9.8,1185,False,17,353,818,11,3,2024-09-16,True,True,False,0.6902953586497891,0.2978902953586498,0.009282700421940928,0.002531645569620253,Peak,Monday,September
2024-09-16 18:00:00,188,566,12,2,768,259,421,6,2,688,29.4,74,3,9.9,1456,False,18,447,987,18,4,2024-09-16,True,True,True,0.6778846153846154,0.3070054945054945,0.012362637362637362,0.0027472527472527475,Peak,Monday,September
2024-09-16 19:00:00,173,568,11,1,753,317,549,11,3,880,28.5,79,3,6.2,1633,False,19,490,1117,22,4,2024-09-16,True,True,True,0.6840171463563993,0.3000612369871402,0.013472137170851195,0.002449479485609308,Peak,Monday,September
2024-09-16 20:00:00,177,573,12,2,764,255,428,8,4,695,27.9,83,3,5.8,1459,False,20,432,1001,20,6,2024-09-16,True,True,True,0.6860863605209048,0.29609321453050036,0.013708019191226868,0.00411240575736806,Shoulder,Monday,September
2024-09-16 21:00:00,153,544,8,1,706,246,415,8,3,672,27.7,82,3,4.4,1378,False,21,399,959,16,4,2024-09-16,True,True,True,0.6959361393323658,0.2895500725689405,0.011611030478955007,0.002902757619738752,Shoulder,Monday,September
2024-09-16 22:00:00,168,536,6,1,711,184,288,5,2,479,27.9,81,3,5.9,1190,False,22,352,824,11,3,2024-09-16,True,True,False,0.692436974789916,0.2957983193277311,0.009243697478991597,0.0025210084033613447,Shoulder,Monday,September
2024-09-16 23:00:00,155,524,9,2,690,194,283,7,3,487,27.8,83,2,4.4,1177,False,23,349,807,16,5,2024-09-16,True,True,False,0.6856414613423959,0.2965165675446049,0.013593882752761258,0.004248088360237893,Shoulder,Monday,September
2024-09-17 00:00:00,171,433,14,2,620,291,438,11,2,742,27.8,83,1,5.4,1362,False,0,462,871,25,4,2024-09-17,False,False,False,0.6395007342143906,0.3392070484581498,0.018355359765051395,0.002936857562408223,Off-Peak,Tuesday,September
2024-09-17 01:00:00,149,362,8,1,520,214,295,8,2,519,26.7,91,51,7.5,1039,False,1,363,657,16,3,2024-09-17,False,False,False,0.6323387872954764,0.34937439846005774,0.015399422521655439,0.0028873917228103944,Off-Peak,Tuesday,September
2024-09-17 02:00:00,194,518,6,1,719,279,419,10,2,710,26.3,88,63,11.6,1429,False,2,473,937,16,3,2024-09-17,False,False,True,0.655703289013296,0.33100069979006297,0.01119664100769769,0.002099370188943317,Off-Peak,Tuesday,September
2024-09-17 03:00:00,252,696,12,2,962,336,518,13,2,869,26.5,88,51,14.5,1831,False,3,588,1214,25,4,2024-09-17,False,False,True,0.6630256690333152,0.3211359912616057,0.013653741125068269,0.002184598580010923,Off-Peak,Tuesday,September
2024-09-17 04:00:00,163,418,6,1,588,252,371,10,3,636,24.8,93,55,22.3,1224,False,4,415,789,16,4,2024-09-17,False,False,False,0.6446078431372549,0.33905228758169936,0.013071895424836602,0.0032679738562091504,Off-Peak,Tuesday,September
2024-09-17 05:00:00,141,346,8,2,497,255,371,9,2,637,25.3,92,53,14.3,1134,False,5,396,717,17,4,2024-09-17,False,False,False,0.6322751322751323,0.3492063492063492,0.014991181657848324,0.003527336860670194,Shoulder,Tuesday,September
2024-09-17 06:00:00,242,657,5,4,908,219,308,9,2,538,25.3,92,3,13.2,1446,False,6,461,965,14,6,2024-09-17,False,False,True,0.6673582295988935,0.3188105117565698,0.009681881051175657,0.004149377593360996,Shoulder,Tuesday,September
2024-09-17 07:00:00,148,351,9,2,510,305,462,12,2,781,25.7,91,3,11.6,1291,False,7,453,813,21,4,2024-09-17,False,False,False,0.6297443841982959,0.3508907823392719,0.016266460108443067,0.003098373353989156,Peak,Tuesday,September
2024-09-17 08:00:00,241,661,12,1,915,224,325,8,2,559,25.7,94,51,11.4,1474,False,8,465,986,20,3,2024-09-17,False,False,True,0.6689280868385346,0.31546811397557667,0.013568521031207599,0.0020352781546811396,Peak,Tuesday,September
2024-09-17 09:00:00,140,336,15,2,493,207,292,7,2,508,25.3,91,51,11.0,1001,False,9,347,628,22,4,2024-09-17,False,False,False,0.6273726273726273,0.34665334665334663,0.02197802197802198,0.003996003996003996,Shoulder,Tuesday,September
2024-09-17 10:00:00,177,450,12,3,642,230,331,9,3,573,25.4,92,55,13.9,1215,False,10,407,781,21,6,2024-09-17,False,False,False,0.642798353909465,0.33497942386831275,0.01728395061728395,0.0049382716049382715,Shoulder,Tuesday,September
2024-09-17 11:00:00,231,635,13,1,880,208,295,7,2,512,27.5,81,51,16.0,1392,False,11,439,930,20,3,2024-09-17,False,False,True,0.6681034482758621,0.31537356321839083,0.014367816091954023,0.0021551724137931034,Peak,Tuesday,September
2024-09-17 12:00:00,225,597,10,2,834,306,464,14,3,787,28.0,80,51,16.0,1621,False,12,531,1061,24,5,2024-09-17,False,False,True,0.6545342381246144,0.32757557063541026,0.014805675508945095,0.0030845157310302285,Peak,Tuesday,September
2024-09-17 13:00:00,175,455,6,2,638,339,525,13,2,879,29.0,79,51,15.0,1517,False,13,514,980,19,4,2024-09-17,False,False,True,0.6460118655240606,0.33882663150955833,0.012524719841793012,0.0026367831245880024,Peak,Tuesday,September
2024-09-17 14:00:00,234,641,5,1,881,258,383,10,2,653,29.1,77,51,20.5,1534,False,14,492,1024,15,3,2024-09-17,False,False,True,0.6675358539765319,0.32073011734028684,0.009778357235984355,0.001955671447196871,Peak,Tuesday,September
2024-09-17 15:00:00,187,485,13,2,687,250,367,10,3,630,28.6,78,53,22.7,1317,False,15,437,852,23,5,2024-09-17,False,False,False,0.6469248291571754,0.33181473044798787,0.017463933181473046,0.0037965072133637054,Peak,Tuesday,September
2024-09-17 16:00:00,231,628,12,4,875,321,494,15,3,833,28.1,80,53,21.3,1708,False,16,552,1122,27,7,2024-09-17,False,False,True,0.6569086651053864,0.3231850117096019,0.015807962529274005,0.004098360655737705,Peak,Tuesday,September
2024-09-17 17:00:00,134,322,15,1,472,216,305,9,2,532,28.4,78,51,18.4,1004,False,17,350,627,24,3,2024-09-17,False,False,False,0.6245019920318725,0.34860557768924305,0.02390438247011952,0.00298804780876494,Peak,Tuesday,September
2024-09-17 18:00:00,227,597,17,3,844,284,428,13,2,727,28.1,79,3,18.3,1571,False,18,511,1025,30,5,2024-09-17,False,False,True,0.6524506683640993,0.3252705283259071,0.019096117122851686,0.003182686187141948,Peak,Tuesday,September
2024-09-17 19:00:00,195,499,13,2,709,282,427,12,2,723,26.8,80,51,20.0,1432,False,19,477,926,25,4,2024-09-17,False,False,True,0.6466480446927374,0.3331005586592179,0.017458100558659217,0.002793296089385475,Peak,Tuesday,September
2024-09-17 20:00:00,230,608,11,1,850,180,243,6,2,431,25.9,89,61,17.3,1281,False,20,410,851,17,3,2024-09-17,False,False,False,0.6643247462919594,0.3200624512099922,0.01327088212334114,0.00234192037470726,Shoulder,Tuesday,September
2024-09-17 21:00:00,164,424,9,2,599,259,382,13,2,656,25.6,88,53,20.6,1255,False,21,423,806,22,4,2024-09-17,False,False,False,0.6422310756972112,0.33705179282868525,0.01752988047808765,0.0031872509960159364,Shoulder,Tuesday,September
2024-09-17 22:00:00,130,293,6,1,430,196,268,8,2,474,25.3,91,51,14.0,904,False,22,326,561,14,3,2024-09-17,False,False,False,0.620575221238938,0.3606194690265487,0.015486725663716814,0.00331858407079646,Shoulder,Tuesday,September
2024-09-17 23:00:00,209,551,12,2,774,349,545,16,4,914,25.4,93,51,12.7,1688,False,23,558,1096,28,6,2024-09-17,False,False,True,0.6492890995260664,0.3305687203791469,0.016587677725118485,0.0035545023696682463,Shoulder,Tuesday,September
2024-09-18 00:00:00,253,793,9,1,1056,359,660,14,1,1034,25.5,93,51,9.2,2090,False,0,612,1453,23,2,2024-09-18,False,False,True,0.6952153110047847,0.29282296650717704,0.011004784688995215,0.0009569377990430622,Off-Peak,Wednesday,September
2024-09-18 01:00:00,192,584,10,1,787,267,470,10,1,748,25.3,95,3,11.2,1535,False,1,459,1054,20,2,2024-09-18,False,False,True,0.6866449511400652,0.2990228013029316,0.013029315960912053,0.0013029315960912053,Off-Peak,Wednesday,September
2024-09-18 02:00:00,172,513,11,1,697,322,588,13,1,924,25.5,94,3,10.0,1621,False,2,494,1101,24,2,2024-09-18,False,False,True,0.6792103639728563,0.30475015422578655,0.014805675508945095,0.0012338062924120913,Off-Peak,Wednesday,September
2024-09-18 03:00:00,139,379,9,2,529,251,448,10,1,710,25.5,94,3,11.6,1239,False,3,390,827,19,3,2024-09-18,False,False,False,0.6674737691686844,0.31476997578692495,0.01533494753833737,0.002421307506053269,Off-Peak,Wednesday,September
2024-09-18 04:00:00,202,607,7,1,817,206,346,8,1,561,25.5,93,3,11.9,1378,False,4,408,953,15,2,2024-09-18,False,False,True,0.6915820029027576,0.2960812772133527,0.01088534107402032,0.001451378809869376,Off-Peak,Wednesday,September
2024-09-18 05:00:00,222,675,10,1,908,327,614,13,1,955,24.9,93,51,12.7,1863,False,5,549,1289,23,2,2024-09-18,False,False,True,0.6918947933440687,0.2946859903381642,0.012345679012345678,0.0010735373054213634,Shoulder,Wednesday,September
2024-09-18 06:00:00,159,458,12,1,630,227,390,8,1,626,25.1,90,51,13.3,1256,False,6,386,848,20,2,2024-09-18,False,False,False,0.6751592356687898,0.3073248407643312,0.01592356687898089,0.0015923566878980893,Shoulder,Wednesday,September
2024-09-18 07:00:00,193,599,10,2,804,278,492,11,2,783,25.4,89,3,11.5,1587,False,7,471,1091,21,4,2024-09-18,False,False,True,0.6874606175173283,0.29678638941398866,0.013232514177693762,0.002520478890989288,Peak,Wednesday,September
2024-09-18 08:00:00,163,459,9,1,632,219,360,8,2,589,25.8,90,3,10.0,1221,False,8,382,819,17,3,2024-09-18,False,False,False,0.6707616707616708,0.31285831285831284,0.013923013923013924,0.002457002457002457,Peak,Wednesday,September
2024-09-18 09:00:00,152,443,11,1,607,181,286,7,2,476,24.3,94,53,12.1,1083,False,9,333,729,18,3,2024-09-18,False,False,False,0.6731301939058172,0.3074792243767313,0.01662049861495845,0.002770083102493075,Shoulder,Wednesday,September
2024-09-18 10:00:00,211,641,12,1,865,268,473,11,2,754,25.9,87,51,7.8,1619,False,10,479,1114,23,3,2024-09-18,False,False,True,0.6880790611488573,0.2958616429894997,0.014206300185299567,0.0018529956763434219,Shoulder,Wednesday,September
2024-09-18 11:00:00,219,681,18,1,919,331,602,16,2,951,28.3,78,51,9.2,1870,False,11,550,1283,34,3,2024-09-18,False,False,True,0.686096256684492,0.29411764705882354,0.01818181818181818,0.0016042780748663102,Peak,Wednesday,September
2024-09-18 12:00:00,214,666,16,1,897,329,607,14,2,952,29.3,72,3,14.4,1849,False,12,543,1273,30,3,2024-09-18,False,False,True,0.6884802595997837,0.29367225527312063,0.016224986479177934,0.0016224986479177934,Peak,Wednesday,September
2024-09-18 13:00:00,196,592,13,1,802,213,354,7,2,576,29.6,69,3,15.5,1378,False,13,409,946,20,3,2024-09-18,False,False,True,0.6865021770682148,0.29680696661828737,0.01451378809869376,0.0021770682148040637,Peak,Wednesday,September
2024-09-18 14:00:00,201,612,9,2,824,291,523,15,3,832,29.8,72,51,15.4,1656,False,14,492,1135,24,5,2024-09-18,False,False,True,0.6853864734299517,0.2971014492753623,0.014492753623188406,0.0030193236714975845,Peak,Wednesday,September
2024-09-18 15:00:00,232,730,8,2,972,281,503,12,2,798,29.9,71,0,12.4,1770,False,15,513,1233,20,4,2024-09-18,False,False,True,0.6966101694915254,0.28983050847457625,0.011299435028248588,0.0022598870056497176,Peak,Wednesday,September
2024-09-18 16:00:00,252,804,15,1,1072,246,423,11,2,682,30.2,69,2,10.9,1754,False,16,498,1227,26,3,2024-09-18,False,False,True,0.6995438996579247,0.2839224629418472,0.014823261117445839,0.0017103762827822121,Peak,Wednesday,September
2024-09-18 17:00:00,148,434,13,2,597,308,564,14,2,888,29.9,70,3,9.8,1485,False,17,456,998,27,4,2024-09-18,False,False,True,0.672053872053872,0.30707070707070705,0.01818181818181818,0.0026936026936026937,Peak,Wednesday,September
2024-09-18 18:00:00,160,439,9,1,609,197,320,7,2,526,29.3,71,3,8.6,1135,False,18,357,759,16,3,2024-09-18,False,False,False,0.6687224669603524,0.3145374449339207,0.014096916299559472,0.0026431718061674008,Peak,Wednesday,September
2024-09-18 19:00:00,134,353,6,2,495,201,326,8,2,537,28.3,76,3,10.1,1032,False,19,335,679,14,4,2024-09-18,False,False,False,0.6579457364341085,0.3246124031007752,0.013565891472868217,0.003875968992248062,Peak,Wednesday,September
2024-09-18 20:00:00,219,662,10,2,893,316,572,16,2,906,27.9,79,2,10.5,1799,False,20,535,1234,26,4,2024-09-18,False,False,True,0.6859366314619233,0.2973874374652585,0.014452473596442469,0.0022234574763757642,Shoulder,Wednesday,September
2024-09-18 21:00:00,216,659,12,1,888,307,548,14,2,871,28.5,71,3,9.2,1759,False,21,523,1207,26,3,2024-09-18,False,False,True,0.6861853325753269,0.29732802728823193,0.014781125639567936,0.0017055144968732233,Shoulder,Wednesday,September
2024-09-18 22:00:00,174,496,9,1,680,180,277,7,2,466,27.7,78,3,9.7,1146,False,22,354,773,16,3,2024-09-18,False,False,False,0.6745200698080279,0.3089005235602094,0.013961605584642234,0.002617801047120419,Shoulder,Wednesday,September
2024-09-18 23:00:00,210,624,5,1,840,233,395,13,3,644,25.4,84,3,13.8,1484,False,23,443,1019,18,4,2024-09-18,False,False,True,0.6866576819407008,0.29851752021563344,0.012129380053908356,0.0026954177897574125,Shoulder,Wednesday,September
2024-09-19 00:00:00,116,333,1,1,451,194,375,2,1,572,25.8,82,3,11.5,1023,False,0,310,708,3,2,2024-09-19,False,False,False,0.6920821114369502,0.30303030303030304,0.002932551319648094,0.0019550342130987292,Off-Peak,Thursday,September
2024-09-19 01:00:00,121,339,2,2,464,218,438,3,1,660,25.9,84,3,10.0,1124,False,1,339,777,5,3,2024-09-19,False,False,False,0.6912811387900356,0.3016014234875445,0.004448398576512456,0.0026690391459074734,Off-Peak,Thursday,September
2024-09-19 02:00:00,128,372,2,1,503,205,413,2,1,621,25.1,87,3,12.5,1124,False,2,333,785,4,2,2024-09-19,False,False,False,0.6983985765124555,0.29626334519572955,0.0035587188612099642,0.0017793594306049821,Off-Peak,Thursday,September
2024-09-19 03:00:00,187,606,1,1,795,193,373,2,1,569,24.7,89,3,9.7,1364,False,3,380,979,3,2,2024-09-19,False,False,False,0.717741935483871,0.2785923753665689,0.0021994134897360706,0.001466275659824047,Off-Peak,Thursday,September
2024-09-19 04:00:00,218,721,1,1,941,177,326,3,2,508,24.5,90,3,9.7,1449,False,4,395,1047,4,3,2024-09-19,False,False,True,0.722567287784679,0.2726017943409248,0.0027605244996549345,0.002070393374741201,Off-Peak,Thursday,September
2024-09-19 05:00:00,172,545,3,3,723,271,582,3,2,858,24.7,90,3,8.5,1581,False,5,443,1127,6,5,2024-09-19,False,False,True,0.7128399746995573,0.280202403542062,0.003795066413662239,0.0031625553447185324,Shoulder,Thursday,September
2024-09-19 06:00:00,141,421,2,1,565,260,555,3,2,820,24.5,91,3,5.7,1385,False,6,401,976,5,3,2024-09-19,False,False,True,0.7046931407942238,0.2895306859205776,0.0036101083032490976,0.0021660649819494585,Shoulder,Thursday,September
2024-09-19 07:00:00,227,755,4,2,988,299,642,4,2,947,24.3,93,3,4.8,1935,False,7,526,1397,8,4,2024-09-19,False,False,True,0.7219638242894056,0.2718346253229974,0.004134366925064599,0.0020671834625322996,Peak,Thursday,September
2024-09-19 08:00:00,131,391,9,2,533,191,370,3,3,567,25.7,89,3,5.2,1100,False,8,322,761,12,5,2024-09-19,False,False,False,0.6918181818181818,0.2927272727272727,0.01090909090909091,0.004545454545454545,Peak,Thursday,September
2024-09-19 09:00:00,126,369,10,1,506,211,425,3,2,641,27.9,83,3,4.5,1147,False,9,337,794,13,3,2024-09-19,False,False,False,0.6922406277244987,0.2938099389712293,0.011333914559721011,0.0026155187445510027,Shoulder,Thursday,September
2024-09-19 10:00:00,233,775,12,1,1021,284,608,4,2,898,29.1,74,51,9.7,1919,False,10,517,1383,16,3,2024-09-19,False,False,True,0.7206878582595102,0.26941115164147994,0.008337675872850442,0.001563314226159458,Shoulder,Thursday,September
2024-09-19 11:00:00,121,347,13,2,483,231,477,4,2,714,29.8,69,3,11.8,1197,False,11,352,824,17,4,2024-09-19,False,False,False,0.6883876357560568,0.29406850459482037,0.014202172096908938,0.003341687552213868,Peak,Thursday,September
2024-09-19 12:00:00,197,636,4,1,838,269,556,4,2,831,30.2,65,3,13.2,1669,False,12,466,1192,8,3,2024-09-19,False,False,True,0.7142001198322349,0.2792091072498502,0.004793289394847214,0.0017974835230677051,Peak,Thursday,September
2024-09-19 13:00:00,124,365,2,1,492,249,525,4,2,780,30.6,63,3,11.5,1272,False,13,373,890,6,3,2024-09-19,False,False,False,0.699685534591195,0.29323899371069184,0.0047169811320754715,0.0023584905660377358,Peak,Thursday,September
2024-09-19 14:00:00,125,355,6,3,489,248,520,5,2,775,30.8,62,3,11.0,1264,False,14,373,875,11,5,2024-09-19,False,False,False,0.692246835443038,0.2950949367088608,0.00870253164556962,0.003955696202531646,Peak,Thursday,September
2024-09-19 15:00:00,155,473,3,1,632,181,354,3,2,540,30.9,62,3,12.2,1172,False,15,336,827,6,3,2024-09-19,False,False,False,0.7056313993174061,0.28668941979522183,0.005119453924914676,0.002559726962457338,Peak,Thursday,September
2024-09-19 16:00:00,180,568,11,1,760,278,583,4,2,867,30.8,63,3,10.4,1627,False,16,458,1151,15,3,2024-09-19,False,False,True,0.7074370006146281,0.281499692685925,0.00921942224953903,0.0018438844499078057,Peak,Thursday,September
2024-09-19 17:00:00,150,438,12,2,602,275,571,5,2,853,30.6,65,3,8.4,1455,False,17,425,1009,17,4,2024-09-19,False,False,True,0.6934707903780069,0.2920962199312715,0.01168384879725086,0.0027491408934707906,Peak,Thursday,September
2024-09-19 18:00:00,154,460,10,1,625,152,281,3,2,438,29.7,70,3,5.6,1063,False,18,306,741,13,3,2024-09-19,False,False,False,0.6970837253057385,0.2878645343367827,0.012229539040451553,0.0028222013170272815,Peak,Thursday,September
2024-09-19 19:00:00,214,699,7,2,922,190,363,4,2,559,28.5,77,3,4.1,1481,False,19,404,1062,11,4,2024-09-19,False,False,True,0.7170830519918974,0.27278865631330185,0.007427413909520594,0.0027008777852802163,Peak,Thursday,September
2024-09-19 20:00:00,172,534,5,1,712,244,498,6,2,750,28.1,79,3,5.5,1462,False,20,416,1032,11,3,2024-09-19,False,False,True,0.7058823529411765,0.28454172366621067,0.007523939808481532,0.002051983584131327,Shoulder,Thursday,September
2024-09-19 21:00:00,272,926,3,1,1202,205,405,4,2,616,27.3,85,3,4.7,1818,False,21,477,1331,7,3,2024-09-19,False,False,True,0.7321232123212321,0.2623762376237624,0.0038503850385038503,0.0016501650165016502,Shoulder,Thursday,September
2024-09-19 22:00:00,197,640,2,2,841,223,454,5,2,684,27.2,86,3,4.3,1525,False,22,420,1094,7,4,2024-09-19,False,False,True,0.7173770491803279,0.2754098360655738,0.0045901639344262295,0.002622950819672131,Shoulder,Thursday,September
2024-09-19 23:00:00,233,755,1,1,990,142,253,3,2,400,27.0,86,3,4.2,1390,False,23,375,1008,4,3,2024-09-19,False,False,True,0.7251798561151079,0.2697841726618705,0.0028776978417266188,0.002158273381294964,Shoulder,Thursday,September
2024-09-20 00:00:00,173,437,10,2,622,264,380,8,0,652,26.4,90,3,4.3,1274,False,0,437,817,18,2,2024-09-20,False,False,False,0.641287284144427,0.34301412872841447,0.0141287284144427,0.0015698587127158557,Off-Peak,Friday,September
2024-09-20 01:00:00,161,390,11,0,562,291,437,10,1,739,26.3,90,3,4.0,1301,False,1,452,827,21,1,2024-09-20,False,False,False,0.6356648731744812,0.3474250576479631,0.01614142966948501,0.0007686395080707148,Off-Peak,Friday,September
2024-09-20 02:00:00,232,628,9,0,869,283,420,10,1,714,26.3,90,3,3.7,1583,False,2,515,1048,19,1,2024-09-20,False,False,True,0.6620341124447252,0.32533164876816173,0.012002526847757423,0.0006317119393556538,Off-Peak,Friday,September
2024-09-20 03:00:00,174,429,13,1,617,233,331,9,1,574,26.0,90,3,4.7,1191,False,3,407,760,22,2,2024-09-20,False,False,False,0.6381192275398825,0.3417296389588581,0.018471872376154493,0.0016792611251049538,Off-Peak,Friday,September
2024-09-20 04:00:00,253,692,4,0,949,322,492,11,1,826,25.4,95,51,4.3,1775,False,4,575,1184,15,1,2024-09-20,False,False,True,0.6670422535211268,0.323943661971831,0.008450704225352112,0.0005633802816901409,Off-Peak,Friday,September
2024-09-20 05:00:00,201,529,10,1,741,242,345,9,1,597,25.5,95,51,3.6,1338,False,5,443,874,19,2,2024-09-20,False,False,False,0.6532137518684604,0.3310911808669656,0.014200298953662182,0.0014947683109118087,Shoulder,Friday,September
2024-09-20 06:00:00,225,605,9,1,840,268,390,10,2,670,25.3,93,51,8.0,1510,False,6,493,995,19,3,2024-09-20,False,False,True,0.6589403973509934,0.3264900662251656,0.012582781456953643,0.001986754966887417,Shoulder,Friday,September
2024-09-20 07:00:00,294,823,11,0,1128,241,344,8,1,594,25.6,91,3,6.7,1722,False,7,535,1167,19,1,2024-09-20,False,False,True,0.6777003484320557,0.31068524970963995,0.011033681765389082,0.0005807200929152149,Peak,Friday,September
2024-09-20 08:00:00,180,441,14,2,637,395,622,16,1,1034,26.5,90,3,6.5,1671,False,8,575,1063,30,3,2024-09-20,False,False,True,0.6361460203470976,0.3441053261520048,0.017953321364452424,0.0017953321364452424,Peak,Friday,September
2024-09-20 09:00:00,183,474,12,1,670,329,509,13,1,852,28.3,78,51,2.6,1522,False,9,512,983,25,2,2024-09-20,False,False,True,0.6458607095926413,0.3363994743758213,0.0164257555847569,0.001314060446780552,Shoulder,Friday,September
2024-09-20 10:00:00,173,424,10,0,607,334,517,13,1,865,29.2,76,3,4.5,1472,False,10,507,941,23,1,2024-09-20,False,False,True,0.639266304347826,0.344429347826087,0.015625,0.0006793478260869565,Shoulder,Friday,September
2024-09-20 11:00:00,206,543,12,2,763,272,399,12,1,684,30.1,73,3,7.6,1447,False,11,478,942,24,3,2024-09-20,False,False,True,0.6510020732550104,0.33033863165169314,0.0165860400829302,0.002073255010366275,Peak,Friday,September
2024-09-20 12:00:00,204,534,9,1,748,387,613,16,1,1017,30.6,70,3,10.7,1765,False,12,591,1147,25,2,2024-09-20,False,False,True,0.6498583569405099,0.3348441926345609,0.014164305949008499,0.0011331444759206798,Peak,Friday,September
2024-09-20 13:00:00,175,444,12,1,632,279,409,10,1,699,30.4,72,3,11.3,1331,False,13,454,853,22,2,2024-09-20,False,False,False,0.6408715251690458,0.3410969196093163,0.01652892561983471,0.0015026296018031556,Peak,Friday,September
2024-09-20 14:00:00,215,571,17,0,803,339,527,14,1,881,30.5,69,3,9.0,1684,False,14,554,1098,31,1,2024-09-20,False,False,True,0.6520190023752969,0.32897862232779096,0.01840855106888361,0.0005938242280285036,Peak,Friday,September
2024-09-20 15:00:00,246,661,15,1,923,259,380,10,1,650,30.7,67,3,8.4,1573,False,15,505,1041,25,2,2024-09-20,False,False,True,0.6617927527018436,0.3210425937698665,0.01589319771137953,0.0012714558169103624,Peak,Friday,September
2024-09-20 16:00:00,185,469,10,1,665,290,432,11,1,734,30.7,67,3,7.4,1399,False,16,475,901,21,2,2024-09-20,False,False,True,0.6440314510364546,0.33952823445318087,0.01501072194424589,0.0014295925661186562,Peak,Friday,September
2024-09-20 17:00:00,231,625,13,1,870,244,344,8,1,597,30.6,68,3,6.7,1467,False,17,475,969,21,2,2024-09-20,False,False,True,0.6605316973415133,0.3237900477164281,0.014314928425357873,0.0013633265167007499,Peak,Friday,September
2024-09-20 18:00:00,323,916,17,1,1257,335,515,14,1,865,29.9,71,3,6.8,2122,False,18,658,1431,31,2,2024-09-20,False,False,True,0.674363807728558,0.3100848256361923,0.014608859566446749,0.000942507068803016,Peak,Friday,September
2024-09-20 19:00:00,174,418,12,0,604,222,304,8,2,536,28.8,76,1,4.3,1140,False,19,396,722,20,2,2024-09-20,False,False,False,0.6333333333333333,0.3473684210526316,0.017543859649122806,0.0017543859649122807,Peak,Friday,September
2024-09-20 20:00:00,222,593,10,2,827,294,438,12,2,746,28.4,77,3,10.8,1573,False,20,516,1031,22,4,2024-09-20,False,False,True,0.6554354736172918,0.32803560076287347,0.013986013986013986,0.0025429116338207248,Shoulder,Friday,September
2024-09-20 21:00:00,211,546,14,1,772,425,691,19,2,1137,28.3,76,3,8.8,1909,False,21,636,1237,33,3,2024-09-20,False,False,True,0.6479832372970141,0.33315872184389733,0.017286537454164485,0.001571503404924044,Shoulder,Friday,September
2024-09-20 22:00:00,380,1132,12,0,1524,369,578,17,3,967,27.7,78,3,5.3,2491,False,22,749,1710,29,3,2024-09-20,False,False,True,0.6864712966680048,0.30068245684464073,0.011641910879164994,0.0012043356081894822,Shoulder,Friday,September
2024-09-20 23:00:00,179,447,6,2,634,318,477,14,2,811,27.2,85,51,2.2,1445,False,23,497,924,20,4,2024-09-20,False,False,True,0.639446366782007,0.3439446366782007,0.01384083044982699,0.002768166089965398,Shoulder,Friday,September
2024-09-21 00:00:00,189,496,10,2,697,272,437,10,2,721,26.8,87,61,3.7,1418,True,0,461,933,20,4,2024-09-21,False,False,True,0.657968970380818,0.3251057827926657,0.014104372355430184,0.0028208744710860366,Off-Peak,Saturday,September
2024-09-21 01:00:00,219,605,9,1,834,259,418,11,3,691,26.6,90,51,5.0,1525,True,1,478,1023,20,4,2024-09-21,False,False,True,0.6708196721311476,0.31344262295081965,0.013114754098360656,0.002622950819672131,Off-Peak,Saturday,September
2024-09-21 02:00:00,217,580,12,1,810,240,379,8,2,629,26.0,93,3,3.7,1439,True,2,457,959,20,3,2024-09-21,False,False,True,0.6664350243224462,0.31758165392633775,0.01389854065323141,0.0020847810979847115,Off-Peak,Saturday,September
2024-09-21 03:00:00,219,593,11,2,825,231,371,8,2,612,25.9,96,51,2.0,1437,True,3,450,964,19,4,2024-09-21,False,False,True,0.6708420320111343,0.31315240083507306,0.013221990257480862,0.0027835768963117608,Off-Peak,Saturday,September
2024-09-21 04:00:00,260,714,9,1,984,218,335,8,2,563,25.8,96,51,3.2,1547,True,4,478,1049,17,3,2024-09-21,False,False,True,0.6780866192630899,0.3089851325145443,0.01098901098901099,0.0019392372333548805,Off-Peak,Saturday,September
2024-09-21 05:00:00,147,352,8,1,508,297,497,12,3,809,25.5,96,51,2.3,1317,True,5,444,849,20,4,2024-09-21,False,False,False,0.6446469248291572,0.33712984054669703,0.015186028853454821,0.0030372057706909645,Shoulder,Saturday,September
2024-09-21 06:00:00,160,398,9,3,570,364,634,13,2,1013,25.7,96,51,3.6,1583,True,6,524,1032,22,5,2024-09-21,False,False,True,0.6519267214150347,0.3310170562223626,0.013897662665824383,0.003158559696778269,Shoulder,Saturday,September
2024-09-21 07:00:00,196,508,16,1,721,210,315,7,2,534,25.7,92,3,4.3,1255,True,7,406,823,23,3,2024-09-21,False,False,False,0.6557768924302789,0.32350597609561754,0.018326693227091632,0.002390438247011952,Peak,Saturday,September
2024-09-21 08:00:00,213,564,21,2,800,262,417,9,2,690,26.6,87,3,8.0,1490,True,8,475,981,30,4,2024-09-21,False,False,True,0.6583892617449665,0.3187919463087248,0.020134228187919462,0.0026845637583892616,Peak,Saturday,September
2024-09-21 09:00:00,217,589,22,2,830,323,553,14,4,894,28.1,72,3,11.2,1724,True,9,540,1142,36,6,2024-09-21,False,False,True,0.6624129930394431,0.31322505800464034,0.02088167053364269,0.0034802784222737818,Shoulder,Saturday,September
2024-09-21 10:00:00,146,350,18,1,515,334,581,13,3,931,28.4,70,3,9.9,1446,True,10,480,931,31,4,2024-09-21,False,False,True,0.6438450899031812,0.33195020746887965,0.021438450899031812,0.0027662517289073307,Shoulder,Saturday,September
2024-09-21 11:00:00,266,742,15,1,1024,323,542,12,3,880,28.9,68,3,8.7,1904,True,11,589,1284,27,4,2024-09-21,False,False,True,0.6743697478991597,0.30934873949579833,0.014180672268907563,0.0021008403361344537,Peak,Saturday,September
2024-09-21 12:00:00,164,406,12,2,584,253,401,10,2,666,29.8,65,3,11.4,1250,True,12,417,807,22,4,2024-09-21,False,False,False,0.6456,0.3336,0.0176,0.0032,Peak,Saturday,September
2024-09-21 13:00:00,215,584,9,2,810,262,418,9,2,691,30.1,63,3,10.5,1501,True,13,477,1002,18,4,2024-09-21,False,False,True,0.6675549633577615,0.31778814123917387,0.011992005329780146,0.002664890073284477,Peak,Saturday,September
2024-09-21 14:00:00,231,627,19,3,880,239,374,9,2,624,30.6,60,3,10.0,1504,True,14,470,1001,28,5,2024-09-21,False,False,True,0.6655585106382979,0.3125,0.018617021276595744,0.003324468085106383,Peak,Saturday,September
2024-09-21 15:00:00,185,475,17,2,679,256,411,11,2,680,30.7,58,3,10.4,1359,True,15,441,886,28,4,2024-09-21,False,False,False,0.6519499632082414,0.32450331125827814,0.020603384841795438,0.0029433406916850625,Peak,Saturday,September
2024-09-21 16:00:00,175,446,22,1,644,321,547,13,3,884,30.2,61,3,10.2,1528,True,16,496,993,35,4,2024-09-21,False,False,True,0.649869109947644,0.32460732984293195,0.022905759162303665,0.002617801047120419,Peak,Saturday,September
2024-09-21 17:00:00,155,379,21,1,556,242,385,9,2,638,29.9,63,3,7.4,1194,True,17,397,764,30,3,2024-09-21,False,False,False,0.6398659966499163,0.3324958123953099,0.02512562814070352,0.002512562814070352,Peak,Saturday,September
2024-09-21 18:00:00,166,417,19,3,605,190,288,9,4,491,29.4,68,3,5.0,1096,True,18,356,705,28,7,2024-09-21,False,False,False,0.6432481751824818,0.3248175182481752,0.025547445255474453,0.006386861313868613,Peak,Saturday,September
2024-09-21 19:00:00,270,762,15,1,1048,315,530,14,5,864,27.8,84,3,4.4,1912,True,19,585,1292,29,6,2024-09-21,False,False,True,0.6757322175732218,0.3059623430962343,0.015167364016736401,0.0031380753138075313,Peak,Saturday,September
2024-09-21 20:00:00,184,473,16,2,675,304,505,14,5,828,26.9,87,3,4.7,1503,True,20,488,978,30,7,2024-09-21,False,False,True,0.6506986027944112,0.32468396540252825,0.01996007984031936,0.004657351962741184,Shoulder,Saturday,September
2024-09-21 21:00:00,243,665,9,1,918,221,341,10,4,576,27.1,80,3,4.7,1494,True,21,464,1006,19,5,2024-09-21,False,False,True,0.6733601070950469,0.31057563587684067,0.012717536813922356,0.0033467202141900937,Shoulder,Saturday,September
2024-09-21 22:00:00,131,297,10,2,440,257,412,13,4,686,27.7,73,3,3.6,1126,True,22,388,709,23,6,2024-09-21,False,False,False,0.6296625222024866,0.34458259325044405,0.020426287744227355,0.0053285968028419185,Shoulder,Saturday,September
2024-09-21 23:00:00,236,631,13,1,881,248,390,11,3,652,26.4,84,3,2.1,1533,True,23,484,1021,24,4,2024-09-21,False,False,True,0.6660143509458578,0.3157208088714938,0.015655577299412915,0.002609262883235486,Shoulder,Saturday,September
2024-09-22 00:00:00,246,630,11,2,889,313,448,13,2,776,25.8,82,3,3.0,1665,True,0,559,1078,24,4,2024-09-22,False,False,True,0.6474474474474474,0.33573573573573573,0.014414414414414415,0.0024024024024024023,Off-Peak,Sunday,September
2024-09-22 01:00:00,234,596,12,1,843,210,272,9,3,494,25.2,84,3,2.5,1337,True,1,444,868,21,4,2024-09-22,False,False,False,0.6492146596858639,0.33208676140613314,0.015706806282722512,0.0029917726252804786,Off-Peak,Sunday,September
2024-09-22 02:00:00,239,617,9,1,866,213,285,7,2,507,24.9,83,3,4.0,1373,True,2,452,902,16,3,2024-09-22,False,False,False,0.6569555717407137,0.32920611798980337,0.011653313911143482,0.0021849963583394027,Off-Peak,Sunday,September
2024-09-22 03:00:00,197,472,11,3,683,387,592,15,3,997,24.6,85,3,4.3,1680,True,3,584,1064,26,6,2024-09-22,False,False,True,0.6333333333333333,0.3476190476190476,0.015476190476190477,0.0035714285714285713,Off-Peak,Sunday,September
2024-09-22 04:00:00,253,652,8,2,915,243,329,8,2,582,24.1,89,3,3.8,1497,True,4,496,981,16,4,2024-09-22,False,False,True,0.655310621242485,0.33132932531730125,0.01068804275217101,0.0026720106880427524,Off-Peak,Sunday,September
2024-09-22 05:00:00,246,628,10,1,885,247,347,9,2,605,23.8,89,3,3.4,1490,True,5,493,975,19,3,2024-09-22,False,False,True,0.6543624161073825,0.3308724832214765,0.012751677852348993,0.0020134228187919465,Shoulder,Sunday,September
2024-09-22 06:00:00,242,616,12,1,871,314,460,13,2,789,23.8,88,3,4.0,1660,True,6,556,1076,25,3,2024-09-22,False,False,True,0.6481927710843374,0.3349397590361446,0.015060240963855422,0.0018072289156626507,Shoulder,Sunday,September
2024-09-22 07:00:00,250,638,15,2,905,346,512,14,3,875,23.9,89,3,3.7,1780,True,7,596,1150,29,5,2024-09-22,False,False,True,0.6460674157303371,0.3348314606741573,0.016292134831460674,0.0028089887640449437,Peak,Sunday,September
2024-09-22 08:00:00,241,625,19,1,886,340,507,13,2,862,25.2,83,3,4.7,1748,True,8,581,1132,32,3,2024-09-22,False,False,True,0.6475972540045767,0.33237986270022885,0.018306636155606407,0.0017162471395881006,Peak,Sunday,September
2024-09-22 09:00:00,257,668,20,3,948,342,509,14,3,868,27.2,80,3,3.1,1816,True,9,599,1177,34,6,2024-09-22,False,False,True,0.6481277533039648,0.32984581497797355,0.018722466960352423,0.003303964757709251,Shoulder,Sunday,September
2024-09-22 10:00:00,243,618,21,1,883,351,523,15,3,892,28.8,71,3,2.1,1775,True,10,594,1141,36,4,2024-09-22,False,False,True,0.6428169014084507,0.3346478873239437,0.02028169014084507,0.0022535211267605635,Shoulder,Sunday,September
2024-09-22 11:00:00,240,590,19,2,851,276,391,11,3,681,29.5,70,3,4.0,1532,True,11,516,981,30,5,2024-09-22,False,False,True,0.6403394255874674,0.3368146214099217,0.0195822454308094,0.0032637075718015664,Peak,Sunday,September
2024-09-22 12:00:00,191,467,14,1,673,282,404,11,3,700,30.6,68,3,7.6,1373,True,12,473,871,25,4,2024-09-22,False,False,False,0.6343772760378733,0.3445010924981792,0.01820830298616169,0.0029133284777858705,Peak,Sunday,September
2024-09-22 13:00:00,237,599,11,1,848,275,391,11,3,680,30.7,67,3,8.1,1528,True,13,512,990,22,4,2024-09-22,False,False,True,0.6479057591623036,0.33507853403141363,0.014397905759162303,0.002617801047120419,Peak,Sunday,September
2024-09-22 14:00:00,159,361,10,3,533,262,364,10,2,638,31.3,63,3,7.9,1171,True,14,421,725,20,5,2024-09-22,False,False,False,0.6191289496157131,0.3595217762596072,0.017079419299743808,0.004269854824935952,Peak,Sunday,September
2024-09-22 15:00:00,199,480,12,1,692,289,417,12,3,721,31.1,65,3,9.6,1413,True,15,488,897,24,4,2024-09-22,False,False,True,0.6348195329087049,0.3453644727530078,0.016985138004246284,0.0028308563340410475,Peak,Sunday,September
2024-09-22 16:00:00,143,298,19,1,461,194,250,8,2,454,30.8,67,2,9.2,915,True,16,337,548,27,3,2024-09-22,False,False,False,0.5989071038251366,0.36830601092896176,0.029508196721311476,0.003278688524590164,Peak,Sunday,September
2024-09-22 17:00:00,248,633,21,1,903,205,271,7,2,485,29.9,70,2,8.3,1388,True,17,453,904,28,3,2024-09-22,False,False,True,0.6512968299711815,0.32636887608069165,0.020172910662824207,0.002161383285302594,Peak,Sunday,September
2024-09-22 18:00:00,175,415,18,2,610,296,425,13,2,736,29.5,72,3,5.5,1346,True,18,471,840,31,4,2024-09-22,False,False,False,0.6240713224368499,0.34992570579494797,0.023031203566121844,0.0029717682020802376,Peak,Sunday,September
2024-09-22 19:00:00,153,344,11,1,509,288,412,12,2,714,28.0,86,2,4.7,1223,True,19,441,756,23,3,2024-09-22,False,False,False,0.6181520850367948,0.3605887162714636,0.018806214227309895,0.0024529844644317253,Peak,Sunday,September
2024-09-22 20:00:00,214,525,9,3,751,289,421,13,3,726,27.2,87,3,5.5,1477,True,20,503,946,22,6,2024-09-22,False,False,True,0.6404874746106973,0.34055517941773866,0.014895057549085985,0.004062288422477996,Shoulder,Sunday,September
2024-09-22 21:00:00,251,637,5,1,894,271,384,14,5,674,28.0,83,3,5.9,1568,True,21,522,1021,19,6,2024-09-22,False,False,True,0.6511479591836735,0.33290816326530615,0.01211734693877551,0.003826530612244898,Shoulder,Sunday,September
2024-09-22 22:00:00,287,745,12,2,1046,359,537,18,5,919,27.4,84,3,5.2,1965,True,22,646,1282,30,7,2024-09-22,False,False,True,0.6524173027989821,0.3287531806615776,0.015267175572519083,0.0035623409669211198,Shoulder,Sunday,September
2024-09-22 23:00:00,152,338,8,2,500,199,254,10,4,467,27.0,84,3,6.3,967,True,23,351,592,18,6,2024-09-22,False,False,False,0.6122026887280249,0.36297828335056875,0.01861427094105481,0.0062047569803516025,Shoulder,Sunday,September
2024-09-23 00:00:00,163,442,3,1,609,148,216,9,1,374,26.6,84,3,7.1,983,False,0,311,658,12,2,2024-09-23,False,False,False,0.669379450661241,0.31637843336724314,0.012207527975584944,0.002034587995930824,Off-Peak,Monday,September
2024-09-23 01:00:00,201,588,4,1,794,261,454,13,1,729,26.3,84,3,7.3,1523,False,1,462,1042,17,2,2024-09-23,False,False,True,0.6841759684832567,0.30334865397242283,0.011162179908076166,0.0013131976362442547,Off-Peak,Monday,September
2024-09-23 02:00:00,124,310,6,1,441,172,267,9,1,449,26.2,84,3,6.5,890,False,2,296,577,15,2,2024-09-23,False,False,False,0.648314606741573,0.3325842696629214,0.016853932584269662,0.0022471910112359553,Off-Peak,Monday,September
2024-09-23 03:00:00,175,500,2,1,678,190,303,11,1,505,25.9,86,3,6.2,1183,False,3,365,803,13,2,2024-09-23,False,False,False,0.6787827557058326,0.30853761622992393,0.01098901098901099,0.0016906170752324597,Off-Peak,Monday,September
2024-09-23 04:00:00,122,304,7,2,435,235,402,11,1,649,25.7,89,3,7.4,1084,False,4,357,706,18,3,2024-09-23,False,False,False,0.6512915129151291,0.32933579335793356,0.016605166051660517,0.0027675276752767526,Off-Peak,Monday,September
2024-09-23 05:00:00,227,660,9,1,897,228,380,11,1,620,25.5,91,3,7.3,1517,False,5,455,1040,20,2,2024-09-23,False,False,True,0.6855636123928807,0.2999340804218853,0.013183915622940013,0.0013183915622940012,Shoulder,Monday,September
2024-09-23 06:00:00,172,474,10,1,657,216,351,11,1,579,25.4,92,3,7.9,1236,False,6,388,825,21,2,2024-09-23,False,False,False,0.6674757281553398,0.313915857605178,0.01699029126213592,0.0016181229773462784,Shoulder,Monday,September
2024-09-23 07:00:00,208,605,9,1,823,160,250,7,1,418,25.3,93,3,7.4,1241,False,7,368,855,16,2,2024-09-23,False,False,False,0.6889605157131345,0.29653505237711525,0.0128928283642224,0.0016116035455278,Peak,Monday,September
2024-09-23 08:00:00,207,607,12,1,827,202,330,12,1,545,26.2,91,3,7.7,1372,False,8,409,937,24,2,2024-09-23,False,False,False,0.6829446064139941,0.2981049562682216,0.01749271137026239,0.0014577259475218659,Peak,Monday,September
2024-09-23 09:00:00,189,536,14,2,741,223,377,12,1,613,27.7,85,3,7.1,1354,False,9,412,913,26,3,2024-09-23,False,False,False,0.6742983751846381,0.30428360413589367,0.019202363367799114,0.0022156573116691287,Shoulder,Monday,September
2024-09-23 10:00:00,170,462,19,1,652,170,262,8,1,441,29.3,77,3,7.6,1093,False,10,340,724,27,2,2024-09-23,False,False,False,0.6623970722781336,0.3110704483074108,0.024702653247941447,0.0018298261665141812,Shoulder,Monday,September
2024-09-23 11:00:00,144,360,19,1,524,211,349,12,3,575,30.7,71,51,5.9,1099,False,11,355,709,31,4,2024-09-23,False,False,False,0.6451319381255687,0.32302092811646954,0.028207461328480437,0.003639672429481347,Peak,Monday,September
2024-09-23 12:00:00,143,376,18,2,539,163,252,9,2,426,31.5,69,51,7.6,965,False,12,306,628,27,4,2024-09-23,False,False,False,0.6507772020725389,0.3170984455958549,0.027979274611398965,0.004145077720207254,Peak,Monday,September
2024-09-23 13:00:00,187,534,16,1,738,201,325,10,2,538,31.5,71,51,10.0,1276,False,13,388,859,26,3,2024-09-23,False,False,False,0.6731974921630094,0.30407523510971785,0.02037617554858934,0.0023510971786833857,Peak,Monday,September
2024-09-23 14:00:00,214,626,12,1,853,174,277,8,2,461,29.8,77,63,11.6,1314,False,14,388,903,20,3,2024-09-23,False,False,False,0.6872146118721462,0.2952815829528158,0.015220700152207,0.00228310502283105,Peak,Monday,September
2024-09-23 15:00:00,182,520,14,1,717,190,307,10,2,509,30.5,78,51,10.9,1226,False,15,372,827,24,3,2024-09-23,False,False,False,0.6745513866231647,0.3034257748776509,0.01957585644371941,0.0024469820554649264,Peak,Monday,September
2024-09-23 16:00:00,184,516,16,2,718,271,473,15,2,761,29.0,80,55,11.8,1479,False,16,455,989,31,4,2024-09-23,False,False,True,0.6686950642325896,0.3076402974983097,0.020960108181203516,0.002704530087897228,Peak,Monday,September
2024-09-23 17:00:00,238,704,19,1,962,218,360,12,2,592,29.3,78,3,10.1,1554,False,17,456,1064,31,3,2024-09-23,False,False,True,0.6846846846846847,0.29343629343629346,0.019948519948519948,0.0019305019305019305,Peak,Monday,September
2024-09-23 18:00:00,129,328,22,1,480,265,462,17,2,746,28.8,79,3,9.8,1226,False,18,394,790,39,3,2024-09-23,False,False,False,0.6443719412724307,0.32137030995106036,0.03181076672104405,0.0024469820554649264,Peak,Monday,September
2024-09-23 19:00:00,238,694,15,1,948,171,264,9,2,446,27.9,84,3,9.0,1394,False,19,409,958,24,3,2024-09-23,False,False,True,0.6872309899569584,0.2934002869440459,0.01721664275466284,0.002152080344332855,Peak,Monday,September
2024-09-23 20:00:00,185,519,12,2,718,139,202,7,2,350,27.3,88,3,9.9,1068,False,20,324,721,19,4,2024-09-23,False,False,False,0.6750936329588015,0.30337078651685395,0.017790262172284643,0.003745318352059925,Shoulder,Monday,September
2024-09-23 21:00:00,186,504,9,1,700,166,256,9,2,433,26.6,87,2,8.8,1133,False,21,352,760,18,3,2024-09-23,False,False,False,0.6707855251544572,0.3106796116504854,0.01588702559576346,0.00264783759929391,Shoulder,Monday,September
2024-09-23 22:00:00,153,419,10,1,583,193,309,11,2,515,26.5,88,1,8.6,1098,False,22,346,728,21,3,2024-09-23,False,False,False,0.663023679417122,0.3151183970856102,0.01912568306010929,0.00273224043715847,Shoulder,Monday,September
2024-09-23 23:00:00,155,414,3,1,573,342,633,22,2,999,26.1,89,3,8.4,1572,False,23,497,1047,25,3,2024-09-23,False,False,True,0.666030534351145,0.31615776081424934,0.015903307888040712,0.0019083969465648854,Shoulder,Monday,September
2024-09-24 00:00:00,147,461,10,2,620,235,448,12,1,696,25.6,89,3,10.1,1316,False,0,382,909,22,3,2024-09-24,False,False,False,0.6907294832826748,0.29027355623100304,0.016717325227963525,0.0022796352583586625,Off-Peak,Tuesday,September
2024-09-24 01:00:00,201,695,9,1,906,202,374,10,1,587,25.5,89,3,12.3,1493,False,1,403,1069,19,2,2024-09-24,False,False,True,0.7160080375083724,0.26992632283991963,0.012726054922973878,0.0013395847287340924,Off-Peak,Tuesday,September
2024-09-24 02:00:00,157,510,5,3,675,147,244,7,1,399,25.4,88,3,11.3,1074,False,2,304,754,12,4,2024-09-24,False,False,False,0.702048417132216,0.28305400372439476,0.0111731843575419,0.0037243947858473,Off-Peak,Tuesday,September
2024-09-24 03:00:00,205,724,1,1,931,241,469,12,1,723,25.5,87,3,12.0,1654,False,3,446,1193,13,2,2024-09-24,False,False,True,0.7212817412333736,0.26964933494558646,0.007859733978234583,0.0012091898428053204,Off-Peak,Tuesday,September
2024-09-24 04:00:00,134,412,8,1,555,256,494,13,1,764,25.2,89,3,10.5,1319,False,4,390,906,21,2,2024-09-24,False,False,False,0.6868840030326004,0.29567854435178165,0.01592115238817286,0.001516300227445034,Off-Peak,Tuesday,September
2024-09-24 05:00:00,213,739,7,2,961,207,387,10,1,605,25.0,91,3,10.0,1566,False,5,420,1126,17,3,2024-09-24,False,False,True,0.719029374201788,0.2681992337164751,0.010855683269476373,0.0019157088122605363,Shoulder,Tuesday,September
2024-09-24 06:00:00,194,664,12,3,873,173,311,9,1,494,24.8,91,3,9.0,1367,False,6,367,975,21,4,2024-09-24,False,False,False,0.7132406730065838,0.26847110460863205,0.015362106803218726,0.002926115581565472,Shoulder,Tuesday,September
2024-09-24 07:00:00,196,670,11,4,881,247,479,14,1,741,24.6,92,3,8.0,1622,False,7,443,1149,25,5,2024-09-24,False,False,True,0.7083847102342786,0.27311960542540076,0.015413070283600493,0.0030826140567200987,Peak,Tuesday,September
2024-09-24 08:00:00,175,589,10,2,776,146,246,7,1,400,25.1,91,3,6.8,1176,False,8,321,835,17,3,2024-09-24,False,False,False,0.7100340136054422,0.2729591836734694,0.01445578231292517,0.002551020408163265,Peak,Tuesday,September
2024-09-24 09:00:00,139,425,14,1,579,149,253,8,2,412,26.9,85,3,9.6,991,False,9,288,678,22,3,2024-09-24,False,False,False,0.6841574167507568,0.29061553985872857,0.022199798183652877,0.0030272452068617556,Shoulder,Tuesday,September
2024-09-24 10:00:00,183,603,18,2,806,224,429,11,1,665,28.1,81,2,9.7,1471,False,10,407,1032,29,3,2024-09-24,False,False,True,0.7015635622025833,0.27668252889191025,0.01971447994561523,0.0020394289598912306,Shoulder,Tuesday,September
2024-09-24 11:00:00,145,476,21,1,643,255,494,13,1,763,29.4,75,51,5.0,1406,False,11,400,970,34,2,2024-09-24,False,False,True,0.689900426742532,0.2844950213371266,0.02418207681365576,0.001422475106685633,Peak,Tuesday,September
2024-09-24 12:00:00,186,626,13,1,826,135,229,6,2,372,30.2,73,51,7.5,1198,False,12,321,855,19,3,2024-09-24,False,False,False,0.7136894824707847,0.2679465776293823,0.015859766277128547,0.0025041736227045075,Peak,Tuesday,September
2024-09-24 13:00:00,197,668,10,3,878,207,386,10,2,605,30.6,71,51,8.8,1483,False,13,404,1054,20,5,2024-09-24,False,False,True,0.7107215104517869,0.2724207687120701,0.013486176668914362,0.0033715441672285905,Peak,Tuesday,September
2024-09-24 14:00:00,116,332,15,2,465,144,237,6,2,389,29.0,76,63,11.2,854,False,14,260,569,21,4,2024-09-24,False,False,False,0.6662763466042154,0.3044496487119438,0.02459016393442623,0.00468384074941452,Peak,Tuesday,September
2024-09-24 15:00:00,209,734,17,1,961,135,215,7,2,359,29.8,77,51,10.9,1320,False,15,344,949,24,3,2024-09-24,False,False,False,0.718939393939394,0.2606060606060606,0.01818181818181818,0.0022727272727272726,Peak,Tuesday,September
2024-09-24 16:00:00,204,687,15,2,908,235,447,12,2,696,28.5,80,63,10.5,1604,False,16,439,1134,27,4,2024-09-24,False,False,True,0.7069825436408977,0.2736907730673317,0.01683291770573566,0.0024937655860349127,Peak,Tuesday,September
2024-09-24 17:00:00,121,375,12,3,511,216,408,11,2,637,28.4,78,53,9.8,1148,False,17,337,783,23,5,2024-09-24,False,False,False,0.6820557491289199,0.2935540069686411,0.02003484320557491,0.004355400696864111,Peak,Tuesday,September
2024-09-24 18:00:00,171,558,19,1,749,202,368,11,2,583,28.2,80,3,5.6,1332,False,18,373,926,30,3,2024-09-24,False,False,False,0.6951951951951952,0.28003003003003,0.02252252252252252,0.0022522522522522522,Peak,Tuesday,September
2024-09-24 19:00:00,194,677,11,1,883,223,421,14,2,660,27.0,90,3,3.9,1543,False,19,417,1098,25,3,2024-09-24,False,False,True,0.711600777705768,0.27025275437459495,0.016202203499675955,0.0019442644199611147,Peak,Tuesday,September
2024-09-24 20:00:00,183,606,9,3,801,233,447,15,2,697,26.5,91,3,3.9,1498,False,20,416,1053,24,5,2024-09-24,False,False,True,0.7029372496662216,0.27770360480640854,0.01602136181575434,0.0033377837116154874,Shoulder,Tuesday,September
2024-09-24 21:00:00,113,328,12,1,454,173,304,12,3,492,25.9,90,51,6.5,946,False,21,286,632,24,4,2024-09-24,False,False,False,0.6680761099365751,0.3023255813953488,0.02536997885835095,0.004228329809725159,Shoulder,Tuesday,September
2024-09-24 22:00:00,157,506,11,1,675,213,396,13,2,624,25.6,92,3,5.5,1299,False,22,370,902,24,3,2024-09-24,False,False,False,0.6943802925327175,0.2848344880677444,0.018475750577367205,0.0023094688221709007,Shoulder,Tuesday,September
2024-09-24 23:00:00,175,572,10,3,760,248,468,14,2,732,25.5,93,3,6.4,1492,False,23,423,1040,24,5,2024-09-24,False,False,True,0.6970509383378016,0.28351206434316356,0.0160857908847185,0.003351206434316354,Shoulder,Tuesday,September
2024-09-25 00:00:00,200,808,9,2,1019,186,407,12,0,605,25.4,92,3,6.0,1624,False,0,386,1215,21,2,2024-09-25,False,False,True,0.7481527093596059,0.2376847290640394,0.01293103448275862,0.0012315270935960591,Off-Peak,Wednesday,September
2024-09-25 01:00:00,181,700,7,1,889,234,541,17,0,792,25.3,91,3,7.7,1681,False,1,415,1241,24,1,2024-09-25,False,False,True,0.7382510410469958,0.24687685901249257,0.014277215942891136,0.000594883997620464,Off-Peak,Wednesday,September
2024-09-25 02:00:00,144,532,10,1,687,137,279,8,0,424,25.3,91,3,9.0,1111,False,2,281,811,18,1,2024-09-25,False,False,False,0.72997299729973,0.25292529252925294,0.016201620162016202,0.0009000900090009,Off-Peak,Wednesday,September
2024-09-25 03:00:00,163,607,9,2,781,171,371,11,0,553,25.4,91,3,9.5,1334,False,3,334,978,20,2,2024-09-25,False,False,False,0.7331334332833583,0.25037481259370314,0.014992503748125937,0.0014992503748125937,Off-Peak,Wednesday,September
2024-09-25 04:00:00,194,771,11,1,977,184,396,13,0,593,25.4,93,3,10.2,1570,False,4,378,1167,24,1,2024-09-25,False,False,True,0.743312101910828,0.24076433121019108,0.015286624203821656,0.0006369426751592356,Off-Peak,Wednesday,September
2024-09-25 05:00:00,121,415,6,2,544,196,443,14,1,654,25.3,93,3,9.9,1198,False,5,317,858,20,3,2024-09-25,False,False,False,0.7161936560934892,0.2646076794657763,0.01669449081803005,0.0025041736227045075,Shoulder,Wednesday,September
2024-09-25 06:00:00,139,503,11,1,654,195,428,15,1,639,25.2,93,3,10.2,1293,False,6,334,931,26,2,2024-09-25,False,False,False,0.720030935808198,0.25831399845320957,0.020108275328692964,0.0015467904098994587,Shoulder,Wednesday,September
2024-09-25 07:00:00,199,771,9,2,981,155,322,11,1,489,24.8,94,3,10.0,1470,False,7,354,1093,20,3,2024-09-25,False,False,True,0.7435374149659864,0.24081632653061225,0.013605442176870748,0.0020408163265306124,Peak,Wednesday,September
2024-09-25 08:00:00,153,582,10,3,748,175,377,12,1,565,25.3,91,3,8.5,1313,False,8,328,959,22,4,2024-09-25,False,False,False,0.7303884234577304,0.24980959634424982,0.016755521706016754,0.0030464584920030465,Peak,Wednesday,September
2024-09-25 09:00:00,161,607,7,1,776,214,494,15,1,724,27.2,84,3,7.1,1500,False,9,375,1101,22,2,2024-09-25,False,False,True,0.734,0.25,0.014666666666666666,0.0013333333333333333,Shoulder,Wednesday,September
2024-09-25 10:00:00,133,482,9,1,625,229,531,18,1,779,28.4,74,51,10.6,1404,False,10,362,1013,27,2,2024-09-25,False,False,True,0.7215099715099715,0.25783475783475784,0.019230769230769232,0.0014245014245014246,Shoulder,Wednesday,September
2024-09-25 11:00:00,111,375,11,3,500,198,444,14,2,658,29.0,74,51,6.7,1158,False,11,309,819,25,5,2024-09-25,False,False,False,0.7072538860103627,0.266839378238342,0.02158894645941278,0.004317789291882556,Peak,Wednesday,September
2024-09-25 12:00:00,197,770,13,1,981,190,419,16,1,626,29.7,72,51,5.1,1607,False,12,387,1189,29,2,2024-09-25,False,False,True,0.7398879900435594,0.24082140634723087,0.01804604853764779,0.0012445550715619166,Peak,Wednesday,September
2024-09-25 13:00:00,168,623,16,2,809,217,498,15,1,731,30.6,70,51,5.3,1540,False,13,385,1121,31,3,2024-09-25,False,False,True,0.727922077922078,0.25,0.02012987012987013,0.001948051948051948,Peak,Wednesday,September
2024-09-25 14:00:00,168,643,11,2,824,118,223,8,1,350,29.5,72,63,11.8,1174,False,14,286,866,19,3,2024-09-25,False,False,False,0.737649063032368,0.24361158432708688,0.016183986371379896,0.002555366269165247,Peak,Wednesday,September
2024-09-25 15:00:00,119,404,19,1,543,134,273,9,1,417,28.9,78,63,3.6,960,False,15,253,677,28,2,2024-09-25,False,False,False,0.7052083333333333,0.2635416666666667,0.029166666666666667,0.0020833333333333333,Peak,Wednesday,September
2024-09-25 16:00:00,211,823,15,1,1050,186,410,14,1,611,27.8,83,55,5.8,1661,False,16,397,1233,29,2,2024-09-25,False,False,True,0.7423239012642986,0.2390126429861529,0.017459361830222758,0.0012040939193257074,Peak,Wednesday,September
2024-09-25 17:00:00,187,733,13,2,935,133,260,8,1,402,27.6,84,51,7.0,1337,False,17,320,993,21,3,2024-09-25,False,False,False,0.7427075542258789,0.2393418100224383,0.015706806282722512,0.002243829468960359,Peak,Wednesday,September
2024-09-25 18:00:00,180,709,11,1,901,196,428,15,1,640,27.5,83,3,5.8,1541,False,18,376,1137,26,2,2024-09-25,False,False,True,0.7378325762491889,0.24399740428293315,0.016872160934458143,0.0012978585334198572,Peak,Wednesday,September
2024-09-25 19:00:00,137,498,12,1,648,173,366,12,1,552,26.7,86,3,6.1,1200,False,19,310,864,24,2,2024-09-25,False,False,False,0.72,0.25833333333333336,0.02,0.0016666666666666668,Peak,Wednesday,September
2024-09-25 20:00:00,155,584,10,1,750,180,391,13,1,585,26.0,89,3,6.5,1335,False,20,335,975,23,2,2024-09-25,False,False,False,0.7303370786516854,0.250936329588015,0.017228464419475654,0.00149812734082397,Shoulder,Wednesday,September
2024-09-25 21:00:00,135,503,11,2,651,199,444,15,1,659,25.8,89,51,15.5,1310,False,21,334,947,26,3,2024-09-25,False,False,False,0.7229007633587786,0.2549618320610687,0.01984732824427481,0.0022900763358778627,Shoulder,Wednesday,September
2024-09-25 22:00:00,145,517,8,1,671,215,482,17,1,715,25.3,89,3,13.9,1386,False,22,360,999,25,2,2024-09-25,False,False,True,0.7207792207792207,0.2597402597402597,0.018037518037518036,0.001443001443001443,Shoulder,Wednesday,September
2024-09-25 23:00:00,129,455,9,2,595,192,420,16,1,629,24.9,92,55,13.5,1224,False,23,321,875,25,3,2024-09-25,False,False,False,0.7148692810457516,0.2622549019607843,0.02042483660130719,0.0024509803921568627,Shoulder,Wednesday,September
2024-09-26 00:00:00,99,424,2,1,526,133,352,1,0,486,24.7,92,3,14.9,1012,False,0,232,776,3,1,2024-09-26,False,False,False,0.766798418972332,0.22924901185770752,0.0029644268774703555,0.0009881422924901185,Off-Peak,Thursday,September
2024-09-26 01:00:00,155,732,1,2,890,93,224,2,1,320,24.7,91,3,14.1,1210,False,1,248,956,3,3,2024-09-26,False,False,False,0.7900826446280992,0.2049586776859504,0.0024793388429752068,0.0024793388429752068,Off-Peak,Thursday,September
2024-09-26 02:00:00,119,526,3,1,649,112,271,2,1,386,24.4,93,3,13.0,1035,False,2,231,797,5,2,2024-09-26,False,False,False,0.770048309178744,0.22318840579710145,0.004830917874396135,0.001932367149758454,Off-Peak,Thursday,September
2024-09-26 03:00:00,114,473,1,0,588,98,224,2,1,325,24.2,93,3,11.9,913,False,3,212,697,3,1,2024-09-26,False,False,False,0.7634173055859803,0.2322015334063527,0.0032858707557502738,0.001095290251916758,Off-Peak,Thursday,September
2024-09-26 04:00:00,141,660,4,1,806,129,336,2,1,468,24.0,94,53,2.2,1274,False,4,270,996,6,2,2024-09-26,False,False,False,0.7817896389324961,0.2119309262166405,0.004709576138147566,0.0015698587127158557,Off-Peak,Thursday,September
2024-09-26 05:00:00,98,403,1,1,503,155,424,2,1,582,23.9,96,51,8.4,1085,False,5,253,827,3,2,2024-09-26,False,False,False,0.7622119815668202,0.23317972350230415,0.0027649769585253456,0.0018433179723502304,Shoulder,Thursday,September
2024-09-26 06:00:00,162,760,2,1,925,146,397,3,2,548,23.7,96,61,9.3,1473,False,6,308,1157,5,3,2024-09-26,False,False,True,0.7854718262050238,0.2090970807875085,0.0033944331296673455,0.002036659877800407,Shoulder,Thursday,September
2024-09-26 07:00:00,156,707,7,0,870,178,472,2,1,653,23.6,96,61,7.5,1523,False,7,334,1179,9,1,2024-09-26,False,False,True,0.7741300065659882,0.21930400525279053,0.005909389363099146,0.0006565988181221273,Peak,Thursday,September
2024-09-26 08:00:00,169,803,9,2,983,162,438,4,1,605,23.9,95,51,4.5,1588,False,8,331,1241,13,3,2024-09-26,False,False,True,0.7814861460957179,0.2084382871536524,0.00818639798488665,0.001889168765743073,Peak,Thursday,September
2024-09-26 09:00:00,126,550,11,0,687,136,359,3,1,499,24.4,94,61,4.4,1186,False,9,262,909,14,1,2024-09-26,False,False,False,0.7664418212478921,0.2209106239460371,0.011804384485666104,0.0008431703204047217,Shoulder,Thursday,September
2024-09-26 10:00:00,96,401,6,1,504,92,210,3,2,307,25.0,91,55,4.0,811,False,10,188,611,9,3,2024-09-26,False,False,False,0.7533908754623921,0.2318125770653514,0.011097410604192354,0.0036991368680641184,Shoulder,Thursday,September
2024-09-26 11:00:00,144,654,8,1,807,97,227,2,1,327,25.3,91,53,5.9,1134,False,11,241,881,10,2,2024-09-26,False,False,False,0.7768959435626103,0.21252204585537918,0.008818342151675485,0.001763668430335097,Peak,Thursday,September
2024-09-26 12:00:00,115,494,7,0,616,149,408,3,1,561,25.8,90,61,3.9,1177,False,12,264,902,10,1,2024-09-26,False,False,False,0.7663551401869159,0.22429906542056074,0.008496176720475786,0.0008496176720475786,Peak,Thursday,September
2024-09-26 13:00:00,105,441,12,2,560,96,227,2,1,326,26.6,85,53,6.8,886,False,13,201,668,14,3,2024-09-26,False,False,False,0.7539503386004515,0.22686230248307,0.01580135440180587,0.003386004514672686,Peak,Thursday,September
2024-09-26 14:00:00,165,789,5,1,960,160,426,6,1,593,27.1,83,51,7.5,1553,False,14,325,1215,11,2,2024-09-26,False,False,True,0.7823567289117836,0.20927237604636187,0.0070830650354153256,0.00128783000643915,Peak,Thursday,September
2024-09-26 15:00:00,160,741,3,1,905,140,366,2,1,509,27.0,81,3,6.0,1414,False,15,300,1107,5,2,2024-09-26,False,False,True,0.7828854314002829,0.21216407355021216,0.003536067892503536,0.0014144271570014145,Peak,Thursday,September
2024-09-26 16:00:00,163,770,12,1,946,165,437,4,1,607,27.8,77,3,6.2,1553,False,16,328,1207,16,2,2024-09-26,False,False,True,0.7772054088860271,0.2112041210560206,0.0103026400515132,0.00128783000643915,Peak,Thursday,September
2024-09-26 17:00:00,117,484,9,3,613,160,439,3,1,603,27.8,75,3,6.3,1216,False,17,277,923,12,4,2024-09-26,False,False,False,0.759046052631579,0.22779605263157895,0.009868421052631578,0.003289473684210526,Peak,Thursday,September
2024-09-26 18:00:00,129,572,3,0,704,143,377,3,1,524,27.5,76,3,5.4,1228,False,18,272,949,6,1,2024-09-26,False,False,False,0.7728013029315961,0.22149837133550487,0.004885993485342019,0.0008143322475570033,Peak,Thursday,September
2024-09-26 19:00:00,140,626,6,1,773,166,441,3,2,612,26.6,83,3,3.4,1385,False,19,306,1067,9,3,2024-09-26,False,False,True,0.7703971119133574,0.22093862815884477,0.006498194945848376,0.0021660649819494585,Peak,Thursday,September
2024-09-26 20:00:00,125,528,5,1,659,173,461,3,2,639,26.2,85,3,3.6,1298,False,20,298,989,8,3,2024-09-26,False,False,False,0.7619414483821263,0.2295839753466872,0.0061633281972265025,0.0023112480739599386,Shoulder,Thursday,September
2024-09-26 21:00:00,166,771,1,2,940,86,194,3,2,285,26.3,83,3,2.3,1225,False,21,252,965,4,4,2024-09-26,False,False,False,0.7877551020408163,0.2057142857142857,0.0032653061224489797,0.0032653061224489797,Shoulder,Thursday,September
2024-09-26 22:00:00,129,590,2,1,722,116,282,3,2,403,25.8,90,3,1.1,1125,False,22,245,872,5,3,2024-09-26,False,False,False,0.7751111111111111,0.21777777777777776,0.0044444444444444444,0.0026666666666666666,Shoulder,Thursday,September
2024-09-26 23:00:00,101,421,4,1,527,98,226,3,2,329,25.7,86,51,4.5,856,False,23,199,647,7,3,2024-09-26,False,False,False,0.7558411214953271,0.2324766355140187,0.008177570093457943,0.0035046728971962616,Shoulder,Thursday,September
2024-09-27 00:00:00,222,676,3,1,902,200,384,11,0,595,25.6,86,51,6.2,1497,False,0,422,1060,14,1,2024-09-27,False,False,True,0.7080828323313293,0.2818971275885104,0.009352037408149633,0.0006680026720106881,Off-Peak,Friday,September
2024-09-27 01:00:00,186,562,9,2,759,140,249,8,2,399,25.2,87,53,7.4,1158,False,1,326,811,17,4,2024-09-27,False,False,False,0.7003454231433506,0.2815198618307427,0.01468048359240069,0.0034542314335060447,Off-Peak,Friday,September
2024-09-27 02:00:00,159,452,1,0,612,203,391,12,1,607,24.8,88,51,7.2,1219,False,2,362,843,13,1,2024-09-27,False,False,False,0.6915504511894995,0.2969647251845775,0.01066447908121411,0.0008203445447087777,Off-Peak,Friday,September
2024-09-27 03:00:00,138,379,6,1,524,274,572,17,1,864,24.2,89,3,7.1,1388,False,3,412,951,23,2,2024-09-27,False,False,True,0.6851585014409222,0.2968299711815562,0.016570605187319884,0.001440922190201729,Off-Peak,Friday,September
2024-09-27 04:00:00,195,593,11,0,799,134,242,8,1,385,23.8,90,3,5.9,1184,False,4,329,835,19,1,2024-09-27,False,False,False,0.7052364864864865,0.2778716216216216,0.016047297297297296,0.0008445945945945946,Off-Peak,Friday,September
2024-09-27 05:00:00,226,705,3,1,935,143,250,8,1,402,23.6,89,3,7.7,1337,False,5,369,955,11,2,2024-09-27,False,False,False,0.7142857142857143,0.27599102468212416,0.008227374719521317,0.0014958863126402393,Shoulder,Friday,September
2024-09-27 06:00:00,235,739,8,2,984,245,498,17,2,762,23.8,87,3,7.1,1746,False,6,480,1237,25,4,2024-09-27,False,False,True,0.7084765177548683,0.27491408934707906,0.0143184421534937,0.002290950744558992,Shoulder,Friday,September
2024-09-27 07:00:00,219,664,14,1,898,252,507,17,1,777,23.9,87,3,5.9,1675,False,7,471,1171,31,2,2024-09-27,False,False,True,0.6991044776119403,0.28119402985074626,0.018507462686567163,0.0011940298507462687,Peak,Friday,September
2024-09-27 08:00:00,163,487,12,1,663,266,558,18,1,843,24.3,88,3,5.1,1506,False,8,429,1045,30,2,2024-09-27,False,False,True,0.6938911022576362,0.2848605577689243,0.0199203187250996,0.0013280212483399733,Peak,Friday,September
2024-09-27 09:00:00,232,726,15,0,973,216,425,13,1,655,24.6,87,2,8.6,1628,False,9,448,1151,28,1,2024-09-27,False,False,True,0.707002457002457,0.2751842751842752,0.0171990171990172,0.0006142506142506142,Shoulder,Friday,September
2024-09-27 10:00:00,191,573,12,1,777,260,534,19,1,814,27.1,76,3,5.9,1591,False,10,451,1107,31,2,2024-09-27,False,False,True,0.6957888120678818,0.2834695160276556,0.01948460087994972,0.001257071024512885,Shoulder,Friday,September
2024-09-27 11:00:00,194,569,10,1,774,185,353,13,1,552,28.5,70,3,5.5,1326,False,11,379,922,23,2,2024-09-27,False,False,False,0.6953242835595776,0.28582202111613875,0.017345399698340876,0.0015082956259426848,Peak,Friday,September
2024-09-27 12:00:00,205,627,9,0,841,197,390,14,1,602,30.1,64,3,4.0,1443,False,12,402,1017,23,1,2024-09-27,False,False,True,0.7047817047817048,0.2785862785862786,0.01593901593901594,0.000693000693000693,Peak,Friday,September
2024-09-27 13:00:00,166,481,8,1,656,261,527,18,1,807,30.7,62,3,5.6,1463,False,13,427,1008,26,2,2024-09-27,False,False,True,0.6889952153110048,0.291866028708134,0.0177717019822283,0.001367053998632946,Peak,Friday,September
2024-09-27 14:00:00,141,395,13,1,550,141,258,8,1,408,31.2,60,1,8.6,958,False,14,282,653,21,2,2024-09-27,False,False,False,0.6816283924843424,0.29436325678496866,0.021920668058455117,0.0020876826722338203,Peak,Friday,September
2024-09-27 15:00:00,173,506,15,2,696,161,298,10,1,470,30.9,61,2,10.8,1166,False,15,334,804,25,3,2024-09-27,False,False,False,0.6895368782161235,0.2864493996569468,0.02144082332761578,0.002572898799313894,Peak,Friday,September
2024-09-27 16:00:00,127,334,16,1,478,164,298,11,1,474,30.5,62,3,10.2,952,False,16,291,632,27,2,2024-09-27,False,False,False,0.6638655462184874,0.30567226890756305,0.028361344537815126,0.0021008403361344537,Peak,Friday,September
2024-09-27 17:00:00,164,470,18,0,652,232,472,16,1,721,30.3,63,2,8.6,1373,False,17,396,942,34,1,2024-09-27,False,False,False,0.6860888565185724,0.2884195193008012,0.024763292061179897,0.0007283321194464676,Peak,Friday,September
2024-09-27 18:00:00,245,781,20,2,1048,215,425,15,1,656,29.5,69,0,8.4,1704,False,18,460,1206,35,3,2024-09-27,False,False,True,0.7077464788732394,0.2699530516431925,0.020539906103286387,0.0017605633802816902,Peak,Friday,September
2024-09-27 19:00:00,183,545,15,1,744,140,246,8,2,396,28.4,74,0,8.8,1140,False,19,323,791,23,3,2024-09-27,False,False,False,0.6938596491228071,0.2833333333333333,0.02017543859649123,0.002631578947368421,Peak,Friday,September
2024-09-27 20:00:00,226,700,12,0,938,217,434,15,2,668,28.1,75,1,9.8,1606,False,20,443,1134,27,2,2024-09-27,False,False,True,0.7061021170610212,0.27584059775840597,0.016811955168119553,0.0012453300124533001,Shoulder,Friday,September
2024-09-27 21:00:00,140,383,9,2,534,143,252,11,2,408,27.7,71,2,10.4,942,False,21,283,635,20,4,2024-09-27,False,False,False,0.6740976645435244,0.30042462845010615,0.021231422505307854,0.004246284501061571,Shoulder,Friday,September
2024-09-27 22:00:00,155,437,2,1,595,200,383,14,2,599,27.3,73,0,10.3,1194,False,22,355,820,16,3,2024-09-27,False,False,False,0.6867671691792295,0.29731993299832493,0.01340033500837521,0.002512562814070352,Shoulder,Friday,September
2024-09-27 23:00:00,246,777,10,1,1034,265,554,19,2,840,26.9,76,2,9.9,1874,False,23,511,1331,29,3,2024-09-27,False,False,True,0.7102454642475987,0.2726787620064034,0.015474919957310566,0.0016008537886872999,Shoulder,Friday,September
2024-09-28 00:00:00,236,829,9,2,1076,160,308,7,0,475,26.3,78,3,10.6,1551,True,0,396,1137,16,2,2024-09-28,False,False,True,0.7330754352030948,0.2553191489361702,0.010315925209542231,0.0012894906511927789,Off-Peak,Saturday,September
2024-09-28 01:00:00,231,822,19,1,1073,193,377,11,0,581,25.7,82,1,9.3,1654,True,1,424,1199,30,1,2024-09-28,False,False,True,0.7249093107617895,0.25634824667472794,0.018137847642079808,0.0006045949214026602,Off-Peak,Saturday,September
2024-09-28 02:00:00,157,514,11,2,684,155,280,7,1,443,25.3,85,1,6.9,1127,True,2,312,794,18,3,2024-09-28,False,False,False,0.7045252883762201,0.27684117125110913,0.015971606033717833,0.0026619343389529724,Off-Peak,Saturday,September
2024-09-28 03:00:00,199,691,17,1,908,190,376,9,1,576,24.9,89,0,9.5,1484,True,3,389,1067,26,2,2024-09-28,False,False,True,0.7190026954177897,0.26212938005390835,0.01752021563342318,0.0013477088948787063,Off-Peak,Saturday,September
2024-09-28 04:00:00,182,612,12,1,807,229,479,12,1,721,25.0,91,3,8.3,1528,True,4,411,1091,24,2,2024-09-28,False,False,True,0.7140052356020943,0.26897905759162305,0.015706806282722512,0.0013089005235602095,Off-Peak,Saturday,September
2024-09-28 05:00:00,143,445,17,2,607,243,509,11,1,764,24.9,93,3,9.0,1371,True,5,386,954,28,3,2024-09-28,False,False,False,0.6958424507658644,0.2815463165572575,0.020423048869438368,0.002188183807439825,Shoulder,Saturday,September
2024-09-28 06:00:00,130,404,11,1,546,138,251,7,2,398,24.5,94,61,3.5,944,True,6,268,655,18,3,2024-09-28,False,False,False,0.6938559322033898,0.2838983050847458,0.019067796610169493,0.0031779661016949155,Shoulder,Saturday,September
2024-09-28 07:00:00,188,625,13,1,827,146,270,8,1,425,24.2,97,63,3.5,1252,True,7,334,895,21,2,2024-09-28,False,False,False,0.7148562300319489,0.26677316293929715,0.016773162939297124,0.001597444089456869,Peak,Saturday,September
2024-09-28 08:00:00,196,671,12,0,879,146,263,10,1,420,25.2,94,3,1.7,1299,True,8,342,934,22,1,2024-09-28,False,False,False,0.7190146266358738,0.2632794457274827,0.016936104695919937,0.0007698229407236335,Peak,Saturday,September
2024-09-28 09:00:00,222,798,17,1,1038,229,470,13,1,713,28.1,82,3,5.9,1751,True,9,451,1268,30,2,2024-09-28,False,False,True,0.7241576242147344,0.2575671045117076,0.017133066818960593,0.001142204454597373,Shoulder,Saturday,September
2024-09-28 10:00:00,175,584,19,2,780,231,474,12,1,718,29.7,73,3,7.6,1498,True,10,406,1058,31,3,2024-09-28,False,False,True,0.7062750333778371,0.27102803738317754,0.02069425901201602,0.0020026702269692926,Shoulder,Saturday,September
2024-09-28 11:00:00,228,816,17,1,1062,249,522,13,1,785,30.8,65,3,8.9,1847,True,11,477,1338,30,2,2024-09-28,False,False,True,0.7244179750947483,0.2582566323768273,0.016242555495397944,0.0010828370330265296,Peak,Saturday,September
2024-09-28 12:00:00,128,384,13,1,526,174,340,9,1,524,31.3,61,3,11.7,1050,True,12,302,724,22,2,2024-09-28,False,False,False,0.6895238095238095,0.2876190476190476,0.02095238095238095,0.0019047619047619048,Peak,Saturday,September
2024-09-28 13:00:00,200,690,19,2,911,216,440,12,1,669,30.7,65,51,13.6,1580,True,13,416,1130,31,3,2024-09-28,False,False,True,0.7151898734177216,0.26329113924050634,0.019620253164556962,0.0018987341772151898,Peak,Saturday,September
2024-09-28 14:00:00,185,612,15,1,813,206,406,11,1,624,30.1,72,51,11.2,1437,True,14,391,1018,26,2,2024-09-28,False,False,True,0.708420320111343,0.2720946416144746,0.018093249826026444,0.0013917884481558804,Peak,Saturday,September
2024-09-28 15:00:00,161,516,16,1,694,175,335,9,1,520,30.3,71,3,13.1,1214,True,15,336,851,25,2,2024-09-28,False,False,False,0.7009884678747941,0.27677100494233936,0.02059308072487644,0.0016474464579901153,Peak,Saturday,September
2024-09-28 16:00:00,231,813,12,2,1058,144,256,8,1,409,30.0,70,51,15.4,1467,True,16,375,1069,20,3,2024-09-28,False,False,True,0.7286980231765507,0.2556237218813906,0.013633265167007498,0.002044989775051125,Peak,Saturday,September
2024-09-28 17:00:00,224,813,18,1,1056,237,486,12,1,736,28.8,78,51,10.6,1792,True,17,461,1299,30,2,2024-09-28,False,False,True,0.7248883928571429,0.2572544642857143,0.016741071428571428,0.0011160714285714285,Peak,Saturday,September
2024-09-28 18:00:00,135,422,16,0,573,125,221,6,1,353,27.0,84,63,12.5,926,True,18,260,643,22,1,2024-09-28,False,False,False,0.6943844492440605,0.28077753779697623,0.023758099352051837,0.0010799136069114472,Peak,Saturday,September
2024-09-28 19:00:00,195,643,11,1,850,236,489,13,1,739,26.3,90,51,6.7,1589,True,19,431,1132,24,2,2024-09-28,False,False,True,0.7123977344241661,0.2712397734424166,0.015103838892385148,0.0012586532410320957,Peak,Saturday,September
2024-09-28 20:00:00,156,503,15,1,675,170,330,10,1,511,26.1,91,3,4.7,1186,True,20,326,833,25,2,2024-09-28,False,False,False,0.7023608768971332,0.2748735244519393,0.021079258010118045,0.0016863406408094434,Shoulder,Saturday,September
2024-09-28 21:00:00,139,420,10,3,572,179,339,11,1,530,26.9,87,3,6.6,1102,True,21,318,759,21,4,2024-09-28,False,False,False,0.6887477313974592,0.2885662431941924,0.019056261343012703,0.003629764065335753,Shoulder,Saturday,September
2024-09-28 22:00:00,192,615,12,1,820,142,252,9,1,404,26.8,89,3,9.5,1224,True,22,334,867,21,2,2024-09-28,False,False,False,0.7083333333333334,0.272875816993464,0.01715686274509804,0.0016339869281045752,Shoulder,Saturday,September
2024-09-28 23:00:00,145,445,15,2,607,210,418,12,1,641,26.7,90,51,6.9,1248,True,23,355,863,27,3,2024-09-28,False,False,False,0.6915064102564102,0.2844551282051282,0.021634615384615384,0.002403846153846154,Shoulder,Saturday,September
2024-09-29 00:00:00,231,661,13,1,906,284,544,15,1,844,26.2,93,3,4.7,1750,True,0,515,1205,28,2,2024-09-29,False,True,True,0.6885714285714286,0.29428571428571426,0.016,0.001142857142857143,Off-Peak,Sunday,September
2024-09-29 01:00:00,230,666,13,1,910,249,482,11,1,743,25.5,95,3,2.9,1653,True,1,479,1148,24,2,2024-09-29,False,True,True,0.6944948578342408,0.28977616454930427,0.014519056261343012,0.0012099213551119178,Off-Peak,Sunday,September
2024-09-29 02:00:00,135,349,7,1,492,243,455,12,1,711,25.0,96,3,2.1,1203,True,2,378,804,19,2,2024-09-29,False,True,False,0.6683291770573566,0.314214463840399,0.015793848711554447,0.0016625103906899418,Off-Peak,Sunday,September
2024-09-29 03:00:00,223,657,14,1,895,193,333,8,1,535,24.5,98,3,2.3,1430,True,3,416,990,22,2,2024-09-29,False,True,True,0.6923076923076923,0.2909090909090909,0.015384615384615385,0.0013986013986013986,Off-Peak,Sunday,September
2024-09-29 04:00:00,198,563,12,1,774,166,281,7,1,455,24.4,98,3,2.4,1229,True,4,364,844,19,2,2024-09-29,False,True,False,0.6867371847030106,0.29617575264442636,0.015459723352318959,0.0016273393002441008,Off-Peak,Sunday,September
2024-09-29 05:00:00,215,617,14,1,847,287,546,17,1,851,24.2,97,3,1.0,1698,True,5,502,1163,31,2,2024-09-29,False,True,True,0.6849234393404005,0.2956419316843345,0.018256772673733806,0.001177856301531213,Shoulder,Sunday,September
2024-09-29 06:00:00,186,510,11,1,708,224,418,10,1,653,24.2,97,3,1.1,1361,True,6,410,928,21,2,2024-09-29,False,True,False,0.6818515797207936,0.30124908155767816,0.015429831006612785,0.0014695077149155032,Shoulder,Sunday,September
2024-09-29 07:00:00,238,702,16,2,958,174,304,9,1,488,24.1,98,3,1.9,1446,True,7,412,1006,25,3,2024-09-29,False,True,True,0.6957123098201936,0.28492392807745504,0.017289073305670817,0.002074688796680498,Peak,Sunday,September
2024-09-29 08:00:00,161,425,9,2,597,243,457,13,1,714,25.2,97,3,2.0,1311,True,8,404,882,22,3,2024-09-29,False,True,False,0.6727688787185355,0.30816170861937453,0.016781083142639208,0.002288329519450801,Peak,Sunday,September
2024-09-29 09:00:00,237,687,16,2,942,228,423,12,2,665,28.0,84,3,4.4,1607,True,9,465,1110,28,4,2024-09-29,False,True,True,0.6907280647168638,0.2893590541381456,0.017423771001866834,0.002489110143123833,Shoulder,Sunday,September
2024-09-29 10:00:00,172,466,9,2,649,169,296,8,1,474,29.4,78,51,6.0,1123,True,10,341,762,17,3,2024-09-29,False,True,False,0.678539626001781,0.30365093499554763,0.015138023152270703,0.0026714158504007124,Shoulder,Sunday,September
2024-09-29 11:00:00,225,635,15,2,877,211,394,11,1,617,29.7,76,51,9.9,1494,True,11,436,1029,26,3,2024-09-29,False,True,True,0.6887550200803213,0.2918340026773762,0.01740294511378849,0.002008032128514056,Peak,Sunday,September
2024-09-29 12:00:00,246,719,14,2,981,231,429,11,2,673,30.2,72,51,8.8,1654,True,12,477,1148,25,4,2024-09-29,False,True,True,0.694074969770254,0.2883917775090689,0.015114873035066506,0.0024183796856106408,Peak,Sunday,September
2024-09-29 13:00:00,139,362,9,2,512,200,377,9,2,588,30.8,68,3,8.5,1100,True,13,339,739,18,4,2024-09-29,False,True,False,0.6718181818181819,0.30818181818181817,0.016363636363636365,0.0036363636363636364,Peak,Sunday,September
2024-09-29 14:00:00,155,416,9,2,582,228,427,13,2,670,30.6,69,3,9.8,1252,True,14,383,843,22,4,2024-09-29,False,True,False,0.6733226837060703,0.3059105431309904,0.01757188498402556,0.003194888178913738,Peak,Sunday,September
2024-09-29 15:00:00,180,491,11,2,684,242,457,13,2,714,30.0,71,51,12.1,1398,True,15,422,948,24,4,2024-09-29,False,True,True,0.6781115879828327,0.30185979971387694,0.017167381974248927,0.002861230329041488,Peak,Sunday,September
2024-09-29 16:00:00,160,428,9,2,599,176,308,8,2,494,29.3,74,51,10.7,1093,True,16,336,736,17,4,2024-09-29,False,True,False,0.6733760292772186,0.3074107959743824,0.01555352241537054,0.0036596523330283625,Peak,Sunday,September
2024-09-29 17:00:00,193,543,15,2,753,262,500,15,2,779,28.5,76,55,10.7,1532,True,17,455,1043,30,4,2024-09-29,False,True,True,0.6808093994778068,0.29699738903394257,0.0195822454308094,0.0026109660574412533,Peak,Sunday,September
2024-09-29 18:00:00,247,728,17,2,994,156,263,8,2,429,27.6,83,61,7.1,1423,True,18,403,991,25,4,2024-09-29,False,True,True,0.6964160224877021,0.2832044975404076,0.017568517217146872,0.0028109627547434997,Peak,Sunday,September
2024-09-29 19:00:00,178,476,12,2,668,286,560,16,2,864,26.5,90,51,3.3,1532,True,19,464,1036,28,4,2024-09-29,False,True,True,0.6762402088772846,0.3028720626631854,0.018276762402088774,0.0026109660574412533,Peak,Sunday,September
2024-09-29 20:00:00,179,481,12,3,675,190,335,10,2,537,25.9,95,3,3.3,1212,True,20,369,816,22,5,2024-09-29,False,True,False,0.6732673267326733,0.30445544554455445,0.018151815181518153,0.004125412541254125,Shoulder,Sunday,September
2024-09-29 21:00:00,158,412,12,3,585,250,478,14,2,744,26.5,93,3,3.1,1329,True,21,408,890,26,5,2024-09-29,False,True,False,0.6696764484574869,0.30699774266365687,0.019563581640331076,0.003762227238525207,Shoulder,Sunday,September
2024-09-29 22:00:00,247,723,17,2,989,213,393,13,2,621,25.9,96,3,3.0,1610,True,22,460,1116,30,4,2024-09-29,False,True,True,0.6931677018633541,0.2857142857142857,0.018633540372670808,0.002484472049689441,Shoulder,Sunday,September
2024-09-29 23:00:00,185,512,13,2,712,169,282,9,3,463,25.9,96,3,1.7,1175,True,23,354,794,22,5,2024-09-29,False,True,False,0.6757446808510639,0.30127659574468085,0.01872340425531915,0.00425531914893617,Shoulder,Sunday,September
2024-09-30 00:00:00,179,852,14,0,1045,134,347,6,2,489,25.4,99,3,2.0,1534,False,0,313,1199,20,2,2024-09-30,False,True,True,0.7816166883963495,0.20404172099087353,0.01303780964797914,0.001303780964797914,Off-Peak,Monday,September
2024-09-30 01:00:00,138,643,10,0,791,152,418,6,2,578,25.2,98,53,6.7,1369,False,1,290,1061,16,2,2024-09-30,False,True,False,0.775018261504748,0.21183345507669832,0.01168736303871439,0.0014609203798392988,Off-Peak,Monday,September
2024-09-30 02:00:00,150,711,10,1,872,161,436,8,3,608,24.8,97,61,5.8,1480,False,2,311,1147,18,4,2024-09-30,False,True,True,0.775,0.21013513513513513,0.012162162162162163,0.002702702702702703,Off-Peak,Monday,September
2024-09-30 03:00:00,106,465,7,1,579,151,405,5,2,563,24.6,97,51,1.7,1142,False,3,257,870,12,3,2024-09-30,False,True,False,0.7618213660245184,0.22504378283712784,0.010507880910683012,0.002626970227670753,Off-Peak,Monday,September
2024-09-30 04:00:00,159,721,10,1,891,169,453,6,2,630,24.6,97,3,1.3,1521,False,4,328,1174,16,3,2024-09-30,False,True,True,0.7718606180144642,0.21564760026298488,0.01051939513477975,0.0019723865877712033,Off-Peak,Monday,September
2024-09-30 05:00:00,151,710,12,2,875,148,396,6,3,553,24.6,97,3,3.5,1428,False,5,299,1106,18,5,2024-09-30,False,True,True,0.7745098039215687,0.20938375350140057,0.012605042016806723,0.0035014005602240898,Shoulder,Monday,September
2024-09-30 06:00:00,143,687,10,1,841,109,268,4,2,383,24.5,98,3,1.8,1224,False,6,252,955,14,3,2024-09-30,False,True,False,0.7802287581699346,0.20588235294117646,0.011437908496732025,0.0024509803921568627,Shoulder,Monday,September
2024-09-30 07:00:00,96,403,7,1,507,153,408,5,2,568,24.6,96,3,1.5,1075,False,7,249,811,12,3,2024-09-30,False,True,False,0.7544186046511628,0.23162790697674418,0.011162790697674419,0.0027906976744186047,Peak,Monday,September
2024-09-30 08:00:00,104,431,7,1,543,147,398,5,3,553,25.2,97,3,2.2,1096,False,8,251,829,12,4,2024-09-30,False,True,False,0.7563868613138686,0.229014598540146,0.010948905109489052,0.0036496350364963502,Peak,Monday,September
2024-09-30 09:00:00,147,693,9,1,850,119,299,4,2,424,26.7,86,3,6.3,1274,False,9,266,992,13,3,2024-09-30,False,True,False,0.7786499215070644,0.2087912087912088,0.01020408163265306,0.002354788069073783,Shoulder,Monday,September
2024-09-30 10:00:00,131,559,9,1,700,124,307,6,3,440,27.6,83,1,7.6,1140,False,10,255,866,15,4,2024-09-30,False,True,False,0.7596491228070176,0.2236842105263158,0.013157894736842105,0.0035087719298245615,Shoulder,Monday,September
2024-09-30 11:00:00,143,665,11,1,820,131,326,5,2,464,28.6,78,51,7.3,1284,False,11,274,991,16,3,2024-09-30,False,True,False,0.7718068535825545,0.21339563862928349,0.012461059190031152,0.002336448598130841,Peak,Monday,September
2024-09-30 12:00:00,159,757,12,1,929,159,421,7,3,590,29.3,74,51,11.2,1519,False,12,318,1178,19,4,2024-09-30,False,True,True,0.7755102040816326,0.20934825543120475,0.012508229098090849,0.0026333113890717576,Peak,Monday,September
2024-09-30 13:00:00,90,382,6,1,479,138,361,6,3,508,29.2,75,51,10.9,987,False,13,228,743,12,4,2024-09-30,False,True,False,0.7527862208713273,0.23100303951367782,0.0121580547112462,0.004052684903748734,Peak,Monday,September
2024-09-30 14:00:00,135,612,9,1,757,136,343,6,3,488,29.1,78,2,7.8,1245,False,14,271,955,15,4,2024-09-30,False,True,False,0.7670682730923695,0.2176706827309237,0.012048192771084338,0.00321285140562249,Peak,Monday,September
2024-09-30 15:00:00,115,503,9,1,628,131,344,6,3,484,29.4,76,51,5.5,1112,False,15,246,847,15,4,2024-09-30,False,True,False,0.7616906474820144,0.22122302158273383,0.013489208633093525,0.0035971223021582736,Peak,Monday,September
2024-09-30 16:00:00,163,780,12,1,956,127,318,5,2,452,29.8,72,2,7.2,1408,False,16,290,1098,17,3,2024-09-30,False,True,True,0.7798295454545454,0.2059659090909091,0.012073863636363636,0.002130681818181818,Peak,Monday,September
2024-09-30 17:00:00,115,485,8,1,609,124,316,5,2,447,29.2,75,3,8.9,1056,False,17,239,801,13,3,2024-09-30,False,True,False,0.7585227272727273,0.22632575757575757,0.01231060606060606,0.002840909090909091,Peak,Monday,September
2024-09-30 18:00:00,128,589,9,1,727,93,218,4,2,317,28.3,79,3,6.8,1044,False,18,221,807,13,3,2024-09-30,False,True,False,0.7729885057471264,0.21168582375478928,0.012452107279693486,0.0028735632183908046,Peak,Monday,September
2024-09-30 19:00:00,182,866,14,1,1063,163,442,8,4,617,27.6,82,3,4.7,1680,False,19,345,1308,22,5,2024-09-30,False,True,True,0.7785714285714286,0.20535714285714285,0.013095238095238096,0.002976190476190476,Peak,Monday,September
2024-09-30 20:00:00,152,691,12,1,856,130,334,6,4,474,27.0,86,3,5.8,1330,False,20,282,1025,18,5,2024-09-30,False,True,False,0.7706766917293233,0.21203007518796993,0.013533834586466165,0.0037593984962406013,Shoulder,Monday,September
2024-09-30 21:00:00,140,643,14,1,798,150,398,8,4,560,26.4,90,63,3.9,1358,False,21,290,1041,22,5,2024-09-30,False,True,False,0.7665684830633285,0.21354933726067746,0.016200294550810016,0.003681885125184094,Shoulder,Monday,September
2024-09-30 22:00:00,127,559,10,1,697,79,172,6,5,262,25.4,91,61,4.7,959,False,22,206,731,16,6,2024-09-30,False,True,False,0.762252346193952,0.21480709071949947,0.016684045881126174,0.006256517205422315,Shoulder,Monday,September
2024-09-30 23:00:00,80,315,6,1,402,123,296,8,3,430,25.3,93,51,6.2,832,False,23,203,611,14,4,2024-09-30,False,True,False,0.734375,0.2439903846153846,0.016826923076923076,0.004807692307692308,Shoulder,Monday,September
2024-10-01 00:00:00,135,480,3,1,619,103,100,7,1,211,25.0,94,3,5.9,830,False,0,238,580,10,2,2024-10-01,False,False,False,0.6987951807228916,0.28674698795180725,0.012048192771084338,0.0024096385542168677,Off-Peak,Tuesday,October
2024-10-01 01:00:00,106,285,5,0,396,88,126,3,0,217,25.0,95,3,7.0,613,False,1,194,411,8,0,2024-10-01,False,False,False,0.6704730831973899,0.3164763458401305,0.013050570962479609,0.0,Off-Peak,Tuesday,October
2024-10-01 02:00:00,93,295,5,0,393,98,106,3,2,209,24.5,97,3,3.5,602,False,2,191,401,8,2,2024-10-01,False,False,False,0.6661129568106312,0.31727574750830567,0.013289036544850499,0.0033222591362126247,Off-Peak,Tuesday,October
2024-10-01 03:00:00,133,243,7,3,386,82,160,3,0,245,24.9,96,3,9.6,631,False,3,215,403,10,3,2024-10-01,False,False,False,0.6386687797147385,0.34072900158478603,0.01584786053882726,0.004754358161648178,Off-Peak,Tuesday,October
2024-10-01 04:00:00,106,263,5,1,375,113,121,4,2,240,24.8,94,3,11.2,615,False,4,219,384,9,3,2024-10-01,False,False,False,0.624390243902439,0.35609756097560974,0.014634146341463415,0.004878048780487805,Off-Peak,Tuesday,October
2024-10-01 05:00:00,99,377,6,0,482,50,160,4,1,215,24.5,95,3,7.5,697,False,5,149,537,10,1,2024-10-01,False,False,False,0.7704447632711621,0.21377331420373027,0.014347202295552367,0.0014347202295552368,Shoulder,Tuesday,October
2024-10-01 06:00:00,115,433,4,0,552,90,139,4,1,234,24.3,96,3,7.4,786,False,6,205,572,8,1,2024-10-01,False,False,False,0.727735368956743,0.2608142493638677,0.010178117048346057,0.001272264631043257,Shoulder,Tuesday,October
2024-10-01 07:00:00,130,386,6,0,522,106,105,3,0,214,24.1,97,51,4.7,736,False,7,236,491,9,0,2024-10-01,False,False,False,0.6671195652173914,0.32065217391304346,0.012228260869565218,0.0,Peak,Tuesday,October
2024-10-01 08:00:00,168,345,6,2,521,85,120,3,1,209,25.1,93,53,3.8,730,False,8,253,465,9,3,2024-10-01,False,False,False,0.636986301369863,0.34657534246575344,0.012328767123287671,0.00410958904109589,Peak,Tuesday,October
2024-10-01 09:00:00,130,290,6,1,427,89,83,3,1,176,26.1,84,3,10.4,603,False,9,219,373,9,2,2024-10-01,False,False,False,0.6185737976782753,0.36318407960199006,0.014925373134328358,0.003316749585406302,Shoulder,Tuesday,October
2024-10-01 10:00:00,138,396,4,2,540,77,127,3,1,208,27.5,81,3,8.4,748,False,10,215,523,7,3,2024-10-01,False,False,False,0.6991978609625669,0.2874331550802139,0.009358288770053475,0.004010695187165776,Shoulder,Tuesday,October
2024-10-01 11:00:00,100,272,5,4,381,85,109,3,0,197,28.3,78,3,8.2,578,False,11,185,381,8,4,2024-10-01,False,False,False,0.6591695501730104,0.32006920415224915,0.01384083044982699,0.006920415224913495,Peak,Tuesday,October
2024-10-01 12:00:00,89,253,5,1,348,55,96,4,3,158,29.0,76,51,8.5,506,False,12,144,349,9,4,2024-10-01,False,False,False,0.6897233201581028,0.2845849802371542,0.017786561264822136,0.007905138339920948,Peak,Tuesday,October
2024-10-01 13:00:00,114,314,4,0,432,71,158,2,2,233,29.6,73,51,11.5,665,False,13,185,472,6,2,2024-10-01,False,False,False,0.7097744360902256,0.2781954887218045,0.009022556390977444,0.0030075187969924814,Peak,Tuesday,October
2024-10-01 14:00:00,116,207,5,0,328,70,146,3,0,219,29.3,73,3,13.4,547,False,14,186,353,8,0,2024-10-01,False,False,False,0.6453382084095064,0.340036563071298,0.014625228519195612,0.0,Peak,Tuesday,October
2024-10-01 15:00:00,88,258,4,1,351,95,147,3,1,246,29.3,73,3,12.8,597,False,15,183,405,7,2,2024-10-01,False,False,False,0.678391959798995,0.3065326633165829,0.011725293132328308,0.0033500837520938024,Peak,Tuesday,October
2024-10-01 16:00:00,110,458,5,0,573,74,147,2,2,225,29.4,73,3,10.6,798,False,16,184,605,7,2,2024-10-01,False,False,False,0.7581453634085213,0.23057644110275688,0.008771929824561403,0.002506265664160401,Peak,Tuesday,October
2024-10-01 17:00:00,121,232,8,1,362,74,93,3,1,171,29.0,73,3,10.2,533,False,17,195,325,11,2,2024-10-01,False,False,False,0.6097560975609756,0.36585365853658536,0.020637898686679174,0.00375234521575985,Peak,Tuesday,October
2024-10-01 18:00:00,121,261,4,1,387,77,113,4,0,194,28.5,76,3,9.8,581,False,18,198,374,8,1,2024-10-01,False,False,False,0.6437177280550774,0.3407917383820998,0.013769363166953529,0.0017211703958691911,Peak,Tuesday,October
2024-10-01 19:00:00,124,341,7,2,474,72,115,4,0,191,27.7,79,3,8.6,665,False,19,196,456,11,2,2024-10-01,False,False,False,0.6857142857142857,0.29473684210526313,0.016541353383458645,0.0030075187969924814,Peak,Tuesday,October
2024-10-01 20:00:00,120,343,4,1,468,88,81,4,1,174,27.4,80,3,10.0,642,False,20,208,424,8,2,2024-10-01,False,False,False,0.660436137071651,0.32398753894080995,0.012461059190031152,0.003115264797507788,Shoulder,Tuesday,October
2024-10-01 21:00:00,101,322,4,0,427,90,109,2,3,204,27.7,79,2,9.0,631,False,21,191,431,6,3,2024-10-01,False,False,False,0.6830427892234548,0.30269413629160064,0.009508716323296355,0.004754358161648178,Shoulder,Tuesday,October
2024-10-01 22:00:00,102,201,4,0,307,97,110,3,1,211,27.3,80,3,6.1,518,False,22,199,311,7,1,2024-10-01,False,False,False,0.6003861003861004,0.3841698841698842,0.013513513513513514,0.0019305019305019305,Shoulder,Tuesday,October
2024-10-01 23:00:00,85,385,6,1,477,94,126,2,2,224,26.8,84,3,5.1,701,False,23,179,511,8,3,2024-10-01,False,False,False,0.7289586305278174,0.2553495007132668,0.011412268188302425,0.0042796005706134095,Shoulder,Tuesday,October
2024-10-02 00:00:00,88,338,8,1,435,70,118,2,0,190,26.7,85,3,5.5,625,False,0,158,456,10,1,2024-10-02,False,False,False,0.7296,0.2528,0.016,0.0016,Off-Peak,Wednesday,October
2024-10-02 01:00:00,55,288,6,1,350,92,125,4,1,222,26.4,86,1,6.2,572,False,1,147,413,10,2,2024-10-02,False,False,False,0.722027972027972,0.256993006993007,0.017482517482517484,0.0034965034965034965,Off-Peak,Wednesday,October
2024-10-02 02:00:00,117,259,2,1,379,82,106,3,1,192,26.2,89,3,5.4,571,False,2,199,365,5,2,2024-10-02,False,False,False,0.6392294220665499,0.34851138353765326,0.008756567425569177,0.0035026269702276708,Off-Peak,Wednesday,October
2024-10-02 03:00:00,82,351,4,2,439,97,93,2,0,192,25.9,91,3,5.0,631,False,3,179,444,6,2,2024-10-02,False,False,False,0.7036450079239303,0.2836767036450079,0.009508716323296355,0.003169572107765452,Off-Peak,Wednesday,October
2024-10-02 04:00:00,99,294,7,0,400,83,140,3,0,226,25.9,91,3,4.7,626,False,4,182,434,10,0,2024-10-02,False,False,False,0.6932907348242812,0.29073482428115016,0.01597444089456869,0.0,Off-Peak,Wednesday,October
2024-10-02 05:00:00,86,210,5,2,303,60,121,4,3,188,25.7,91,3,4.8,491,False,5,146,331,9,5,2024-10-02,False,False,False,0.6741344195519349,0.2973523421588595,0.018329938900203666,0.010183299389002037,Shoulder,Wednesday,October
2024-10-02 06:00:00,84,245,4,0,333,89,81,2,1,173,25.5,91,3,4.8,506,False,6,173,326,6,1,2024-10-02,False,False,False,0.6442687747035574,0.34189723320158105,0.011857707509881422,0.001976284584980237,Shoulder,Wednesday,October
2024-10-02 07:00:00,93,438,6,1,538,103,129,3,2,237,25.6,87,3,5.9,775,False,7,196,567,9,3,2024-10-02,False,False,False,0.7316129032258064,0.25290322580645164,0.011612903225806452,0.003870967741935484,Peak,Wednesday,October
2024-10-02 08:00:00,90,294,4,1,389,86,125,6,2,219,26.3,86,3,6.4,608,False,8,176,419,10,3,2024-10-02,False,False,False,0.6891447368421053,0.2894736842105263,0.01644736842105263,0.004934210526315789,Peak,Wednesday,October
2024-10-02 09:00:00,85,408,4,2,499,98,106,2,1,207,27.9,81,3,0.4,706,False,9,183,514,6,3,2024-10-02,False,False,False,0.7280453257790368,0.25920679886685555,0.0084985835694051,0.00424929178470255,Shoulder,Wednesday,October
2024-10-02 10:00:00,89,321,3,0,413,68,150,5,0,223,29.2,76,3,2.2,636,False,10,157,471,8,0,2024-10-02,False,False,False,0.7405660377358491,0.2468553459119497,0.012578616352201259,0.0,Shoulder,Wednesday,October
2024-10-02 11:00:00,97,420,1,0,518,84,99,4,1,188,30.1,71,51,5.6,706,False,11,181,519,5,1,2024-10-02,False,False,False,0.7351274787535411,0.2563739376770538,0.007082152974504249,0.00141643059490085,Peak,Wednesday,October
2024-10-02 12:00:00,98,412,5,0,515,76,110,3,1,190,30.7,68,3,7.8,705,False,12,174,522,8,1,2024-10-02,False,False,False,0.7404255319148936,0.24680851063829787,0.011347517730496455,0.0014184397163120568,Peak,Wednesday,October
2024-10-02 13:00:00,88,284,4,1,377,98,131,5,2,236,30.7,68,3,10.0,613,False,13,186,415,9,3,2024-10-02,False,False,False,0.6769983686786297,0.3034257748776509,0.01468189233278956,0.004893964110929853,Peak,Wednesday,October
2024-10-02 14:00:00,101,204,4,0,309,87,115,4,3,209,29.9,72,3,8.6,518,False,14,188,319,8,3,2024-10-02,False,False,False,0.6158301158301158,0.36293436293436293,0.015444015444015444,0.005791505791505791,Peak,Wednesday,October
2024-10-02 15:00:00,81,216,4,0,301,96,82,3,0,181,30.2,68,3,7.2,482,False,15,177,298,7,0,2024-10-02,False,False,False,0.6182572614107884,0.36721991701244816,0.014522821576763486,0.0,Peak,Wednesday,October
2024-10-02 16:00:00,132,294,4,1,431,106,118,3,2,229,29.3,71,3,11.3,660,False,16,238,412,7,3,2024-10-02,False,False,False,0.6242424242424243,0.3606060606060606,0.010606060606060607,0.004545454545454545,Peak,Wednesday,October
2024-10-02 17:00:00,115,462,2,1,580,96,104,4,2,206,29.3,73,3,9.1,786,False,17,211,566,6,3,2024-10-02,False,False,False,0.7201017811704835,0.2684478371501272,0.007633587786259542,0.003816793893129771,Peak,Wednesday,October
2024-10-02 18:00:00,103,312,5,2,422,90,133,6,3,232,28.8,75,3,8.9,654,False,18,193,445,11,5,2024-10-02,False,False,False,0.6804281345565749,0.29510703363914376,0.016819571865443424,0.00764525993883792,Peak,Wednesday,October
2024-10-02 19:00:00,56,346,5,2,409,69,117,5,0,191,28.2,77,3,8.7,600,False,19,125,463,10,2,2024-10-02,False,False,False,0.7716666666666666,0.20833333333333334,0.016666666666666666,0.0033333333333333335,Peak,Wednesday,October
2024-10-02 20:00:00,97,427,6,0,530,85,116,7,1,209,27.6,79,3,11.5,739,False,20,182,543,13,1,2024-10-02,False,False,False,0.7347767253044655,0.2462787550744249,0.017591339648173207,0.0013531799729364006,Shoulder,Wednesday,October
2024-10-02 21:00:00,82,349,5,0,436,76,90,3,0,169,27.9,83,3,3.8,605,False,21,158,439,8,0,2024-10-02,False,False,False,0.7256198347107438,0.2611570247933884,0.013223140495867768,0.0,Shoulder,Wednesday,October
2024-10-02 22:00:00,71,344,7,1,423,81,108,3,0,192,26.0,93,63,8.9,615,False,22,152,452,10,1,2024-10-02,False,False,False,0.734959349593496,0.24715447154471545,0.016260162601626018,0.0016260162601626016,Shoulder,Wednesday,October
2024-10-02 23:00:00,81,378,6,1,466,80,136,5,2,223,25.9,95,2,5.7,689,False,23,161,514,11,3,2024-10-02,False,False,False,0.7460087082728593,0.23367198838896952,0.015965166908563134,0.0043541364296081275,Shoulder,Wednesday,October
2024-10-03 00:00:00,96,338,1,0,435,103,130,5,2,240,26.3,91,2,3.3,675,False,0,199,468,6,2,2024-10-03,False,False,False,0.6933333333333334,0.2948148148148148,0.008888888888888889,0.002962962962962963,Off-Peak,Thursday,October
2024-10-03 01:00:00,104,266,1,0,371,91,132,6,0,229,25.8,93,2,2.9,600,False,1,195,398,7,0,2024-10-03,False,False,False,0.6633333333333333,0.325,0.011666666666666667,0.0,Off-Peak,Thursday,October
2024-10-03 02:00:00,116,470,2,2,590,108,144,6,2,260,25.0,97,3,2.0,850,False,2,224,614,8,4,2024-10-03,False,False,False,0.7223529411764706,0.2635294117647059,0.009411764705882352,0.004705882352941176,Off-Peak,Thursday,October
2024-10-03 03:00:00,84,253,2,0,339,122,123,3,2,250,24.9,97,3,3.4,589,False,3,206,376,5,2,2024-10-03,False,False,False,0.6383701188455009,0.34974533106960953,0.008488964346349746,0.003395585738539898,Off-Peak,Thursday,October
2024-10-03 04:00:00,87,323,2,0,412,89,194,2,2,287,24.8,96,3,6.5,699,False,4,176,517,4,2,2024-10-03,False,False,False,0.7396280400572246,0.25178826895565093,0.005722460658082976,0.002861230329041488,Off-Peak,Thursday,October
2024-10-03 05:00:00,63,364,2,1,430,86,91,3,2,182,24.5,98,3,4.1,612,False,5,149,455,5,3,2024-10-03,False,False,False,0.7434640522875817,0.2434640522875817,0.008169934640522876,0.004901960784313725,Shoulder,Thursday,October
2024-10-03 06:00:00,82,457,2,3,544,124,103,6,2,235,24.1,97,63,8.0,779,False,6,206,560,8,5,2024-10-03,False,False,False,0.7188703465982028,0.2644415917843389,0.010269576379974325,0.006418485237483954,Shoulder,Thursday,October
2024-10-03 07:00:00,127,254,2,1,384,111,112,6,3,232,23.9,97,63,8.6,616,False,7,238,366,8,4,2024-10-03,False,False,False,0.5941558441558441,0.38636363636363635,0.012987012987012988,0.006493506493506494,Peak,Thursday,October
2024-10-03 08:00:00,89,437,4,1,531,87,77,4,1,169,24.4,95,51,3.1,700,False,8,176,514,8,2,2024-10-03,False,False,False,0.7342857142857143,0.25142857142857145,0.011428571428571429,0.002857142857142857,Peak,Thursday,October
2024-10-03 09:00:00,89,356,2,2,449,102,143,6,1,252,26.2,89,3,1.5,701,False,9,191,499,8,3,2024-10-03,False,False,False,0.7118402282453637,0.2724679029957204,0.011412268188302425,0.0042796005706134095,Shoulder,Thursday,October
2024-10-03 10:00:00,102,286,1,0,389,82,137,7,1,227,27.4,84,51,5.4,616,False,10,184,423,8,1,2024-10-03,False,False,False,0.6866883116883117,0.2987012987012987,0.012987012987012988,0.0016233766233766235,Shoulder,Thursday,October
2024-10-03 11:00:00,65,388,4,2,459,86,115,3,3,207,28.8,79,51,6.0,666,False,11,151,503,7,5,2024-10-03,False,False,False,0.7552552552552553,0.22672672672672672,0.010510510510510511,0.0075075075075075074,Peak,Thursday,October
2024-10-03 12:00:00,114,369,3,2,488,97,106,3,1,207,29.4,75,51,6.2,695,False,12,211,475,6,3,2024-10-03,False,False,False,0.6834532374100719,0.3035971223021583,0.008633093525179856,0.004316546762589928,Peak,Thursday,October
2024-10-03 13:00:00,120,312,3,0,435,59,81,5,0,145,29.6,74,51,7.3,580,False,13,179,393,8,0,2024-10-03,False,False,False,0.6775862068965517,0.3086206896551724,0.013793103448275862,0.0,Peak,Thursday,October
2024-10-03 14:00:00,103,359,2,0,464,64,100,5,2,171,28.6,75,53,5.9,635,False,14,167,459,7,2,2024-10-03,False,False,False,0.7228346456692913,0.262992125984252,0.011023622047244094,0.0031496062992125984,Peak,Thursday,October
2024-10-03 15:00:00,127,327,2,1,457,82,125,4,1,212,28.6,77,51,4.4,669,False,15,209,452,6,2,2024-10-03,False,False,False,0.6756352765321375,0.312406576980568,0.008968609865470852,0.0029895366218236174,Peak,Thursday,October
2024-10-03 16:00:00,70,363,5,1,439,73,104,5,0,182,29.2,75,3,7.0,621,False,16,143,467,10,1,2024-10-03,False,False,False,0.7520128824476651,0.23027375201288244,0.01610305958132045,0.001610305958132045,Peak,Thursday,October
2024-10-03 17:00:00,131,402,2,2,537,100,105,4,0,209,29.0,75,3,6.9,746,False,17,231,507,6,2,2024-10-03,False,False,False,0.6796246648793566,0.3096514745308311,0.00804289544235925,0.002680965147453083,Peak,Thursday,October
2024-10-03 18:00:00,81,467,5,2,555,75,126,4,0,205,28.2,78,3,4.5,760,False,18,156,593,9,2,2024-10-03,False,False,False,0.7802631578947369,0.20526315789473684,0.011842105263157895,0.002631578947368421,Peak,Thursday,October
2024-10-03 19:00:00,71,267,4,2,344,65,135,4,3,207,27.4,83,3,4.0,551,False,19,136,402,8,5,2024-10-03,False,False,False,0.7295825771324864,0.24682395644283123,0.014519056261343012,0.009074410163339383,Peak,Thursday,October
2024-10-03 20:00:00,91,506,1,1,599,120,124,3,1,248,26.7,91,3,3.1,847,False,20,211,630,4,2,2024-10-03,False,False,False,0.743801652892562,0.24911452184179456,0.004722550177095631,0.0023612750885478157,Shoulder,Thursday,October
2024-10-03 21:00:00,131,216,3,2,352,88,120,6,1,215,25.8,93,55,6.1,567,False,21,219,336,9,3,2024-10-03,False,False,False,0.5925925925925926,0.3862433862433862,0.015873015873015872,0.005291005291005291,Shoulder,Thursday,October
2024-10-03 22:00:00,95,344,5,1,445,94,146,4,1,245,25.5,94,51,10.2,690,False,22,189,490,9,2,2024-10-03,False,False,False,0.7101449275362319,0.27391304347826084,0.013043478260869565,0.002898550724637681,Shoulder,Thursday,October
2024-10-03 23:00:00,78,396,1,0,475,68,115,4,0,187,25.1,93,2,11.6,662,False,23,146,511,5,0,2024-10-03,False,False,False,0.7719033232628398,0.22054380664652568,0.0075528700906344415,0.0,Shoulder,Thursday,October
2024-10-04 00:00:00,199,449,6,2,656,167,451,7,1,626,25.0,93,1,11.8,1282,False,0,366,900,13,3,2024-10-04,False,False,False,0.7020280811232449,0.28549141965678626,0.01014040561622465,0.00234009360374415,Off-Peak,Friday,October
2024-10-04 01:00:00,180,427,8,3,618,108,523,9,4,644,24.8,93,1,10.6,1262,False,1,288,950,17,7,2024-10-04,False,False,False,0.7527733755942948,0.22820919175911253,0.01347068145800317,0.005546751188589541,Off-Peak,Friday,October
2024-10-04 02:00:00,174,610,7,1,792,147,375,6,2,530,24.5,93,1,8.8,1322,False,2,321,985,13,3,2024-10-04,False,False,False,0.7450832072617246,0.2428139183055976,0.009833585476550681,0.0022692889561270802,Off-Peak,Friday,October
2024-10-04 03:00:00,162,361,7,2,532,151,575,9,1,736,24.0,95,2,4.4,1268,False,3,313,936,16,3,2024-10-04,False,False,False,0.7381703470031545,0.24684542586750788,0.012618296529968454,0.002365930599369085,Off-Peak,Friday,October
2024-10-04 04:00:00,105,318,6,1,430,138,267,8,1,414,23.9,95,51,3.8,844,False,4,243,585,14,2,2024-10-04,False,False,False,0.693127962085308,0.28791469194312796,0.016587677725118485,0.002369668246445498,Off-Peak,Friday,October
2024-10-04 05:00:00,130,566,6,2,704,120,485,7,1,613,23.6,97,51,2.6,1317,False,5,250,1051,13,3,2024-10-04,False,False,False,0.7980258162490509,0.18982536066818528,0.009870918754745633,0.002277904328018223,Shoulder,Friday,October
2024-10-04 06:00:00,151,484,7,2,644,129,536,9,1,675,23.4,97,3,2.5,1319,False,6,280,1020,16,3,2024-10-04,False,False,False,0.7733131159969674,0.21228203184230476,0.012130401819560273,0.002274450341167551,Shoulder,Friday,October
2024-10-04 07:00:00,176,505,8,4,693,124,384,7,2,517,23.5,97,3,2.1,1210,False,7,300,889,15,6,2024-10-04,False,False,False,0.7347107438016529,0.24793388429752067,0.012396694214876033,0.0049586776859504135,Peak,Friday,October
2024-10-04 08:00:00,163,448,8,2,621,201,385,10,2,598,24.7,95,3,5.0,1219,False,8,364,833,18,4,2024-10-04,False,False,False,0.6833470057424118,0.29860541427399506,0.014766201804757998,0.003281378178835111,Peak,Friday,October
2024-10-04 09:00:00,192,461,6,1,660,137,483,6,2,628,26.7,84,3,6.1,1288,False,9,329,944,12,3,2024-10-04,False,False,False,0.7329192546583851,0.2554347826086957,0.009316770186335404,0.002329192546583851,Shoulder,Friday,October
2024-10-04 10:00:00,175,444,8,3,630,150,440,7,1,598,28.4,75,3,7.1,1228,False,10,325,884,15,4,2024-10-04,False,False,False,0.7198697068403909,0.26465798045602607,0.012214983713355049,0.003257328990228013,Shoulder,Friday,October
2024-10-04 11:00:00,164,425,7,2,598,187,233,11,1,432,29.6,70,3,5.6,1030,False,11,351,658,18,3,2024-10-04,False,False,False,0.6388349514563106,0.3407766990291262,0.017475728155339806,0.002912621359223301,Peak,Friday,October
2024-10-04 12:00:00,232,453,8,4,697,114,333,10,1,458,30.1,70,3,7.3,1155,False,12,346,786,18,5,2024-10-04,False,False,False,0.6805194805194805,0.2995670995670996,0.015584415584415584,0.004329004329004329,Peak,Friday,October
2024-10-04 13:00:00,171,444,8,2,625,139,397,8,3,547,30.4,72,51,8.0,1172,False,13,310,841,16,5,2024-10-04,False,False,False,0.7175767918088737,0.2645051194539249,0.013651877133105802,0.004266211604095563,Peak,Friday,October
2024-10-04 14:00:00,136,409,8,2,555,130,286,7,0,423,28.2,80,65,9.3,978,False,14,266,695,15,2,2024-10-04,False,False,False,0.7106339468302658,0.2719836400817996,0.015337423312883436,0.002044989775051125,Peak,Friday,October
2024-10-04 15:00:00,223,419,9,2,653,135,364,9,2,510,28.7,80,63,7.1,1163,False,15,358,783,18,4,2024-10-04,False,False,False,0.6732588134135855,0.30782459157351677,0.015477214101461736,0.0034393809114359416,Peak,Friday,October
2024-10-04 16:00:00,192,264,7,3,466,133,291,8,0,432,28.5,78,51,4.7,898,False,16,325,555,15,3,2024-10-04,False,False,False,0.6180400890868597,0.3619153674832962,0.01670378619153675,0.0033407572383073497,Peak,Friday,October
2024-10-04 17:00:00,218,543,9,3,773,116,369,9,1,495,27.2,83,53,9.3,1268,False,17,334,912,18,4,2024-10-04,False,False,False,0.7192429022082019,0.2634069400630915,0.014195583596214511,0.0031545741324921135,Peak,Friday,October
2024-10-04 18:00:00,153,522,9,2,686,144,373,6,0,523,26.6,89,53,6.0,1209,False,18,297,895,15,2,2024-10-04,False,False,False,0.7402812241521919,0.2456575682382134,0.01240694789081886,0.0016542597187758478,Peak,Friday,October
2024-10-04 19:00:00,195,469,11,1,676,107,426,9,0,542,25.5,95,63,5.9,1218,False,19,302,895,20,1,2024-10-04,False,False,False,0.7348111658456487,0.24794745484400657,0.016420361247947456,0.0008210180623973727,Peak,Friday,October
2024-10-04 20:00:00,109,502,6,5,622,166,393,6,2,567,24.9,97,61,5.5,1189,False,20,275,895,12,7,2024-10-04,False,False,False,0.7527333894028595,0.23128679562657695,0.010092514718250631,0.005887300252312868,Shoulder,Friday,October
2024-10-04 21:00:00,182,505,7,4,698,155,441,10,0,606,25.4,94,61,2.3,1304,False,21,337,946,17,4,2024-10-04,False,False,False,0.7254601226993865,0.2584355828220859,0.01303680981595092,0.003067484662576687,Shoulder,Friday,October
2024-10-04 22:00:00,152,420,8,2,582,125,431,6,1,563,25.0,94,63,1.5,1145,False,22,277,851,14,3,2024-10-04,False,False,False,0.743231441048035,0.24192139737991267,0.01222707423580786,0.0026200873362445414,Shoulder,Friday,October
2024-10-04 23:00:00,112,435,8,2,557,126,481,8,0,615,24.7,96,61,7.9,1172,False,23,238,916,16,2,2024-10-04,False,False,False,0.7815699658703071,0.2030716723549488,0.013651877133105802,0.0017064846416382253,Shoulder,Friday,October
2024-10-05 00:00:00,207,411,8,1,627,137,285,8,0,430,24.2,97,63,4.8,1057,True,0,344,696,16,1,2024-10-05,False,True,False,0.6584673604541155,0.3254493850520341,0.015137180700094607,0.000946073793755913,Off-Peak,Saturday,October
2024-10-05 01:00:00,259,386,7,2,654,97,467,9,1,574,24.2,98,61,3.5,1228,True,1,356,853,16,3,2024-10-05,False,True,False,0.6946254071661238,0.2899022801302932,0.013029315960912053,0.0024429967426710096,Off-Peak,Saturday,October
2024-10-05 02:00:00,222,406,7,3,638,168,487,9,1,665,24.1,97,51,4.4,1303,True,2,390,893,16,4,2024-10-05,False,True,False,0.6853415195702226,0.2993092862624712,0.012279355333844973,0.0030698388334612432,Off-Peak,Saturday,October
2024-10-05 03:00:00,189,413,6,2,610,145,350,7,0,502,24.0,98,3,2.8,1112,True,3,334,763,13,2,2024-10-05,False,True,False,0.6861510791366906,0.30035971223021585,0.011690647482014389,0.0017985611510791368,Off-Peak,Saturday,October
2024-10-05 04:00:00,193,350,11,2,556,143,370,11,0,524,23.9,98,3,2.8,1080,True,4,336,720,22,2,2024-10-05,False,True,False,0.6666666666666666,0.3111111111111111,0.020370370370370372,0.001851851851851852,Off-Peak,Saturday,October
2024-10-05 05:00:00,204,531,6,2,743,241,439,8,1,689,23.9,98,3,4.6,1432,True,5,445,970,14,3,2024-10-05,False,True,True,0.6773743016759777,0.31075418994413406,0.009776536312849162,0.002094972067039106,Shoulder,Saturday,October
2024-10-05 06:00:00,196,413,7,2,618,160,323,7,1,491,23.9,98,53,4.7,1109,True,6,356,736,14,3,2024-10-05,False,True,False,0.6636609558160504,0.32100991884580704,0.012623985572587917,0.002705139765554554,Shoulder,Saturday,October
2024-10-05 07:00:00,183,484,6,2,675,124,321,10,1,456,24.0,98,51,2.0,1131,True,7,307,805,16,3,2024-10-05,False,True,False,0.7117595048629531,0.27144120247568526,0.014146772767462422,0.002652519893899204,Peak,Saturday,October
2024-10-05 08:00:00,176,423,9,2,610,132,528,9,0,669,24.7,96,3,1.2,1279,True,8,308,951,18,2,2024-10-05,False,True,False,0.743549648162627,0.24081313526192338,0.014073494917904612,0.001563721657544957,Peak,Saturday,October
2024-10-05 09:00:00,164,402,7,2,575,188,431,7,1,627,24.3,93,53,1.3,1202,True,9,352,833,14,3,2024-10-05,False,True,False,0.6930116472545758,0.2928452579034942,0.011647254575707155,0.0024958402662229617,Shoulder,Saturday,October
2024-10-05 10:00:00,147,607,7,2,763,151,379,11,2,543,25.4,90,51,3.6,1306,True,10,298,986,18,4,2024-10-05,False,True,False,0.7549770290964778,0.22817764165390506,0.013782542113323124,0.0030627871362940277,Shoulder,Saturday,October
2024-10-05 11:00:00,162,543,9,2,716,102,285,8,0,395,26.7,84,51,6.0,1111,True,11,264,828,17,2,2024-10-05,False,True,False,0.7452745274527453,0.2376237623762376,0.0153015301530153,0.0018001800180018,Peak,Saturday,October
2024-10-05 12:00:00,112,303,8,2,425,177,499,7,2,685,27.9,81,51,8.5,1110,True,12,289,802,15,4,2024-10-05,False,True,False,0.7225225225225225,0.26036036036036037,0.013513513513513514,0.0036036036036036037,Peak,Saturday,October
2024-10-05 13:00:00,171,291,7,3,472,122,365,8,1,496,28.5,79,51,10.4,968,True,13,293,656,15,4,2024-10-05,False,True,False,0.6776859504132231,0.30268595041322316,0.015495867768595042,0.004132231404958678,Peak,Saturday,October
2024-10-05 14:00:00,137,556,6,3,702,203,579,12,2,796,28.8,74,3,9.9,1498,True,14,340,1135,18,5,2024-10-05,False,True,True,0.7576769025367156,0.22696929238985314,0.012016021361815754,0.0033377837116154874,Peak,Saturday,October
2024-10-05 15:00:00,135,416,7,1,559,181,490,8,1,680,29.1,73,3,11.7,1239,True,15,316,906,15,2,2024-10-05,False,True,False,0.7312348668280871,0.255044390637611,0.012106537530266344,0.0016142050040355124,Peak,Saturday,October
2024-10-05 16:00:00,177,322,9,2,510,137,362,10,1,510,28.7,75,3,12.7,1020,True,16,314,684,19,3,2024-10-05,False,True,False,0.6705882352941176,0.307843137254902,0.018627450980392157,0.0029411764705882353,Peak,Saturday,October
2024-10-05 17:00:00,220,559,11,2,792,189,363,8,1,561,28.4,75,3,12.6,1353,True,17,409,922,19,3,2024-10-05,False,True,False,0.6814486326681448,0.30229120473022913,0.014042867701404288,0.0022172949002217295,Peak,Saturday,October
2024-10-05 18:00:00,205,479,7,3,694,147,569,8,1,725,27.9,76,3,13.2,1419,True,18,352,1048,15,4,2024-10-05,False,True,True,0.7385482734319944,0.24806201550387597,0.010570824524312896,0.0028188865398167725,Peak,Saturday,October
2024-10-05 19:00:00,119,495,6,4,624,171,416,8,1,596,27.2,79,3,10.7,1220,True,19,290,911,14,5,2024-10-05,False,True,False,0.7467213114754099,0.23770491803278687,0.011475409836065573,0.004098360655737705,Peak,Saturday,October
2024-10-05 20:00:00,138,545,9,4,696,159,381,11,1,552,26.5,83,3,7.3,1248,True,20,297,926,20,5,2024-10-05,False,True,False,0.7419871794871795,0.23798076923076922,0.016025641025641024,0.004006410256410256,Shoulder,Saturday,October
2024-10-05 21:00:00,202,354,7,3,566,123,426,12,3,564,27.3,80,3,6.3,1130,True,21,325,780,19,6,2024-10-05,False,True,False,0.6902654867256637,0.28761061946902655,0.016814159292035398,0.005309734513274336,Shoulder,Saturday,October
2024-10-05 22:00:00,137,325,9,1,472,124,382,9,1,516,26.8,84,51,9.8,988,True,22,261,707,18,2,2024-10-05,False,True,False,0.7155870445344129,0.26417004048583,0.018218623481781375,0.0020242914979757085,Shoulder,Saturday,October
2024-10-05 23:00:00,161,598,8,2,769,179,444,7,1,631,25.9,88,61,7.2,1400,True,23,340,1042,15,3,2024-10-05,False,True,True,0.7442857142857143,0.24285714285714285,0.010714285714285714,0.002142857142857143,Shoulder,Saturday,October
2024-10-06 00:00:00,159,715,8,2,884,155,467,6,3,631,25.1,94,65,2.2,1515,True,0,314,1182,14,5,2024-10-06,False,False,True,0.7801980198019802,0.20726072607260726,0.009240924092409241,0.0033003300330033004,Off-Peak,Sunday,October
2024-10-06 01:00:00,209,397,12,1,619,149,478,10,2,639,24.8,95,63,2.0,1258,True,1,358,875,22,3,2024-10-06,False,False,False,0.6955484896661367,0.2845786963434022,0.017488076311605722,0.0023847376788553257,Off-Peak,Sunday,October
2024-10-06 02:00:00,186,346,10,1,543,204,405,10,2,621,24.6,96,61,1.7,1164,True,2,390,751,20,3,2024-10-06,False,False,False,0.6451890034364262,0.33505154639175255,0.01718213058419244,0.002577319587628866,Off-Peak,Sunday,October
2024-10-06 03:00:00,202,643,10,1,856,151,436,8,3,598,24.4,99,53,4.7,1454,True,3,353,1079,18,4,2024-10-06,False,False,True,0.7420907840440165,0.24277854195323245,0.012379642365887207,0.002751031636863824,Off-Peak,Sunday,October
2024-10-06 04:00:00,177,512,9,2,700,138,514,8,2,662,24.5,97,51,4.2,1362,True,4,315,1026,17,4,2024-10-06,False,False,False,0.7533039647577092,0.23127753303964757,0.012481644640234948,0.002936857562408223,Off-Peak,Sunday,October
2024-10-06 05:00:00,176,446,11,1,634,147,571,7,2,727,24.5,97,51,3.1,1361,True,5,323,1017,18,3,2024-10-06,False,False,False,0.7472446730345335,0.23732549595885377,0.01322556943423953,0.002204261572373255,Shoulder,Sunday,October
2024-10-06 06:00:00,171,558,8,2,739,150,445,7,1,603,24.6,97,53,0.6,1342,True,6,321,1003,15,3,2024-10-06,False,False,False,0.7473919523099851,0.2391952309985097,0.011177347242921014,0.0022354694485842027,Shoulder,Sunday,October
2024-10-06 07:00:00,221,479,10,0,710,198,423,8,2,631,24.0,97,63,5.3,1341,True,7,419,902,18,2,2024-10-06,False,False,False,0.6726323639075317,0.3124533929903057,0.013422818791946308,0.0014914243102162564,Peak,Sunday,October
2024-10-06 08:00:00,175,567,7,2,751,185,461,9,3,658,24.1,96,63,1.2,1409,True,8,360,1028,16,5,2024-10-06,False,False,True,0.7295954577714692,0.255500354861604,0.0113555713271824,0.0035486160397444995,Peak,Sunday,October
2024-10-06 09:00:00,171,497,12,1,681,192,516,5,4,717,25.0,94,53,6.3,1398,True,9,363,1013,17,5,2024-10-06,False,False,True,0.7246065808297568,0.259656652360515,0.012160228898426323,0.00357653791130186,Shoulder,Sunday,October
2024-10-06 10:00:00,150,564,12,2,728,183,337,9,3,532,25.9,88,53,9.2,1260,True,10,333,901,21,5,2024-10-06,False,False,False,0.7150793650793651,0.2642857142857143,0.016666666666666666,0.003968253968253968,Shoulder,Sunday,October
2024-10-06 11:00:00,204,409,9,2,624,151,258,7,1,417,26.5,84,51,11.5,1041,True,11,355,667,16,3,2024-10-06,False,False,False,0.6407300672430355,0.3410182516810759,0.01536983669548511,0.002881844380403458,Peak,Sunday,October
2024-10-06 12:00:00,195,636,9,0,840,196,417,6,1,620,27.4,80,51,10.0,1460,True,12,391,1053,15,1,2024-10-06,False,False,True,0.7212328767123287,0.2678082191780822,0.010273972602739725,0.0006849315068493151,Peak,Sunday,October
2024-10-06 13:00:00,169,568,12,1,750,209,347,6,2,564,28.0,78,51,7.9,1314,True,13,378,915,18,3,2024-10-06,False,False,False,0.6963470319634704,0.2876712328767123,0.0136986301369863,0.00228310502283105,Peak,Sunday,October
2024-10-06 14:00:00,161,554,8,0,723,189,416,8,3,616,27.6,77,3,6.1,1339,True,14,350,970,16,3,2024-10-06,False,False,False,0.7244212098581031,0.26138909634055263,0.01194921583271098,0.0022404779686333084,Peak,Sunday,October
2024-10-06 15:00:00,258,379,11,1,649,182,444,8,4,638,27.7,77,3,6.4,1287,True,15,440,823,19,5,2024-10-06,False,False,False,0.6394716394716394,0.3418803418803419,0.014763014763014764,0.003885003885003885,Peak,Sunday,October
2024-10-06 16:00:00,119,662,13,1,795,147,422,7,4,580,27.8,76,3,8.4,1375,True,16,266,1084,20,5,2024-10-06,False,False,True,0.7883636363636364,0.19345454545454546,0.014545454545454545,0.0036363636363636364,Peak,Sunday,October
2024-10-06 17:00:00,204,494,9,2,709,178,592,9,1,780,27.4,78,3,7.2,1489,True,17,382,1086,18,3,2024-10-06,False,False,True,0.7293485560779046,0.25654801880456685,0.01208865010073875,0.0020147750167897917,Peak,Sunday,October
2024-10-06 18:00:00,238,567,10,2,817,144,484,4,1,633,27.3,79,3,4.7,1450,True,18,382,1051,14,3,2024-10-06,False,False,True,0.7248275862068966,0.263448275862069,0.009655172413793104,0.0020689655172413794,Peak,Sunday,October
2024-10-06 19:00:00,66,469,10,1,546,167,489,7,2,665,26.5,89,3,3.4,1211,True,19,233,958,17,3,2024-10-06,False,False,False,0.7910817506193228,0.19240297274979357,0.014037985136251032,0.002477291494632535,Peak,Sunday,October
2024-10-06 20:00:00,213,522,10,1,746,117,518,6,3,644,26.2,88,3,3.1,1390,True,20,330,1040,16,4,2024-10-06,False,False,True,0.7482014388489209,0.23741007194244604,0.011510791366906475,0.0028776978417266188,Shoulder,Sunday,October
2024-10-06 21:00:00,181,520,9,2,712,116,364,7,2,489,26.1,86,51,3.6,1201,True,21,297,884,16,4,2024-10-06,False,False,False,0.736053288925895,0.2472939217318901,0.013322231473771857,0.0033305578684429643,Shoulder,Sunday,October
2024-10-06 22:00:00,198,204,12,3,417,169,554,10,2,735,25.9,88,3,3.3,1152,True,22,367,758,22,5,2024-10-06,False,False,False,0.6579861111111112,0.3185763888888889,0.019097222222222224,0.004340277777777778,Shoulder,Sunday,October
2024-10-06 23:00:00,177,558,9,2,746,154,454,10,2,620,25.4,93,3,2.3,1366,True,23,331,1012,19,4,2024-10-06,False,False,False,0.7408491947291361,0.24231332357247437,0.013909224011713031,0.0029282576866764276,Shoulder,Sunday,October
2024-10-07 00:00:00,111,362,7,1,481,78,111,4,0,193,25.2,91,3,3.2,674,False,0,189,473,11,1,2024-10-07,False,False,False,0.701780415430267,0.28041543026706234,0.016320474777448073,0.001483679525222552,Off-Peak,Monday,October
2024-10-07 01:00:00,104,494,9,0,607,107,156,5,1,269,25.1,91,3,2.7,876,False,1,211,650,14,1,2024-10-07,False,False,False,0.7420091324200914,0.2408675799086758,0.01598173515981735,0.001141552511415525,Off-Peak,Monday,October
2024-10-07 02:00:00,137,257,10,2,406,92,129,4,1,226,24.7,92,51,3.6,632,False,2,229,386,14,3,2024-10-07,False,False,False,0.6107594936708861,0.3623417721518987,0.022151898734177215,0.004746835443037975,Off-Peak,Monday,October
2024-10-07 03:00:00,115,376,6,3,500,137,124,3,4,268,24.7,89,51,5.8,768,False,3,252,500,9,7,2024-10-07,False,False,False,0.6510416666666666,0.328125,0.01171875,0.009114583333333334,Off-Peak,Monday,October
2024-10-07 04:00:00,117,415,10,1,543,117,137,4,2,260,24.6,88,3,4.5,803,False,4,234,552,14,3,2024-10-07,False,False,False,0.6874221668742216,0.29140722291407223,0.017434620174346202,0.0037359900373599006,Off-Peak,Monday,October
2024-10-07 05:00:00,107,432,8,0,547,109,125,4,4,242,23.4,92,3,3.8,789,False,5,216,557,12,4,2024-10-07,False,False,False,0.70595690747782,0.2737642585551331,0.015209125475285171,0.005069708491761723,Shoulder,Monday,October
2024-10-07 06:00:00,124,362,10,2,498,109,168,4,1,282,23.4,91,3,3.2,780,False,6,233,530,14,3,2024-10-07,False,False,False,0.6794871794871795,0.2987179487179487,0.017948717948717947,0.0038461538461538464,Shoulder,Monday,October
2024-10-07 07:00:00,111,400,5,1,517,124,107,5,1,237,22.9,92,3,2.9,754,False,7,235,507,10,2,2024-10-07,False,False,False,0.6724137931034483,0.3116710875331565,0.013262599469496022,0.002652519893899204,Peak,Monday,October
2024-10-07 08:00:00,107,208,5,0,320,119,107,6,2,234,24.3,89,3,4.2,554,False,8,226,315,11,2,2024-10-07,False,False,False,0.5685920577617328,0.40794223826714804,0.019855595667870037,0.0036101083032490976,Peak,Monday,October
2024-10-07 09:00:00,146,357,7,0,510,109,92,5,0,206,26.4,84,3,4.9,716,False,9,255,449,12,0,2024-10-07,False,False,False,0.6270949720670391,0.35614525139664804,0.01675977653631285,0.0,Shoulder,Monday,October
2024-10-07 10:00:00,136,443,9,1,589,78,116,5,2,201,27.8,78,3,3.4,790,False,10,214,559,14,3,2024-10-07,False,False,False,0.7075949367088608,0.2708860759493671,0.017721518987341773,0.0037974683544303796,Shoulder,Monday,October
2024-10-07 11:00:00,153,329,10,0,492,163,101,6,1,271,29.3,72,1,2.4,763,False,11,316,430,16,1,2024-10-07,False,False,False,0.563564875491481,0.41415465268676277,0.020969855832241154,0.001310615989515072,Peak,Monday,October
2024-10-07 12:00:00,96,415,9,0,520,78,128,4,1,211,30.1,68,2,7.0,731,False,12,174,543,13,1,2024-10-07,False,False,False,0.7428180574555403,0.23803009575923392,0.017783857729138167,0.0013679890560875513,Peak,Monday,October
2024-10-07 13:00:00,140,436,9,2,587,91,129,4,1,225,30.3,69,1,9.9,812,False,13,231,565,13,3,2024-10-07,False,False,False,0.6958128078817734,0.28448275862068967,0.01600985221674877,0.003694581280788177,Peak,Monday,October
2024-10-07 14:00:00,201,381,7,1,590,64,102,6,1,173,30.5,65,51,10.8,763,False,14,265,483,13,2,2024-10-07,False,False,False,0.6330275229357798,0.3473132372214941,0.01703800786369594,0.002621231979030144,Peak,Monday,October
2024-10-07 15:00:00,130,420,9,3,562,111,143,4,0,258,30.0,71,1,10.2,820,False,15,241,563,13,3,2024-10-07,False,False,False,0.6865853658536586,0.2939024390243902,0.015853658536585366,0.003658536585365854,Peak,Monday,October
2024-10-07 16:00:00,165,322,7,2,496,102,165,5,2,274,29.7,73,0,10.9,770,False,16,267,487,12,4,2024-10-07,False,False,False,0.6324675324675325,0.34675324675324676,0.015584415584415584,0.005194805194805195,Peak,Monday,October
2024-10-07 17:00:00,160,379,10,2,551,115,138,3,0,256,29.5,73,0,10.4,807,False,17,275,517,13,2,2024-10-07,False,False,False,0.6406443618339529,0.34076827757125155,0.0161090458488228,0.0024783147459727386,Peak,Monday,October
2024-10-07 18:00:00,159,448,8,2,617,65,63,3,2,133,29.1,74,2,7.4,750,False,18,224,511,11,4,2024-10-07,False,False,False,0.6813333333333333,0.2986666666666667,0.014666666666666666,0.005333333333333333,Peak,Monday,October
2024-10-07 19:00:00,146,420,10,1,577,120,179,6,2,307,27.7,84,1,5.4,884,False,19,266,599,16,3,2024-10-07,False,False,False,0.6776018099547512,0.3009049773755656,0.01809954751131222,0.003393665158371041,Peak,Monday,October
2024-10-07 20:00:00,157,351,9,0,517,83,148,3,0,234,27.3,84,1,4.4,751,False,20,240,499,12,0,2024-10-07,False,False,False,0.6644474034620506,0.3195739014647137,0.015978695073235686,0.0,Shoulder,Monday,October
2024-10-07 21:00:00,161,426,8,1,596,97,177,6,1,281,27.6,83,61,13.4,877,False,21,258,603,14,2,2024-10-07,False,False,False,0.6875712656784493,0.29418472063854045,0.01596351197263398,0.002280501710376283,Shoulder,Monday,October
2024-10-07 22:00:00,162,456,7,0,625,116,157,3,2,278,27.2,89,3,11.9,903,False,22,278,613,10,2,2024-10-07,False,False,False,0.6788482834994463,0.3078626799557032,0.01107419712070875,0.0022148394241417496,Shoulder,Monday,October
2024-10-07 23:00:00,107,243,7,1,358,101,163,4,2,270,27.0,90,51,8.9,628,False,23,208,406,11,3,2024-10-07,False,False,False,0.6464968152866242,0.33121019108280253,0.01751592356687898,0.004777070063694267,Shoulder,Monday,October
2024-10-08 00:00:00,105,275,6,1,387,94,107,5,0,206,26.3,94,2,5.1,593,False,0,199,382,11,1,2024-10-08,False,False,False,0.6441821247892074,0.33558178752107926,0.01854974704890388,0.0016863406408094434,Off-Peak,Tuesday,October
2024-10-08 01:00:00,86,355,9,0,450,62,150,8,2,222,25.9,94,3,7.0,672,False,1,148,505,17,2,2024-10-08,False,False,False,0.7514880952380952,0.22023809523809523,0.025297619047619048,0.002976190476190476,Off-Peak,Tuesday,October
2024-10-08 02:00:00,111,262,8,0,381,76,130,3,0,209,25.5,94,3,7.0,590,False,2,187,392,11,0,2024-10-08,False,False,False,0.6644067796610169,0.3169491525423729,0.01864406779661017,0.0,Off-Peak,Tuesday,October
2024-10-08 03:00:00,129,487,6,0,622,103,126,3,0,232,25.0,94,3,5.2,854,False,3,232,613,9,0,2024-10-08,False,False,False,0.7177985948477752,0.2716627634660422,0.01053864168618267,0.0,Off-Peak,Tuesday,October
2024-10-08 04:00:00,98,364,6,0,468,124,124,5,2,255,24.7,96,3,5.5,723,False,4,222,488,11,2,2024-10-08,False,False,False,0.6749654218533887,0.3070539419087137,0.015214384508990318,0.0027662517289073307,Off-Peak,Tuesday,October
2024-10-08 05:00:00,73,503,14,1,591,92,175,4,1,272,24.9,94,3,6.1,863,False,5,165,678,18,2,2024-10-08,False,False,False,0.7856315179606026,0.19119351100811124,0.02085747392815759,0.002317497103128621,Shoulder,Tuesday,October
2024-10-08 06:00:00,89,364,7,2,462,101,162,3,2,268,25.0,94,3,5.0,730,False,6,190,526,10,4,2024-10-08,False,False,False,0.7205479452054795,0.2602739726027397,0.0136986301369863,0.005479452054794521,Shoulder,Tuesday,October
2024-10-08 07:00:00,66,281,10,0,357,116,183,5,2,306,25.1,93,3,4.5,663,False,7,182,464,15,2,2024-10-08,False,False,False,0.6998491704374057,0.27450980392156865,0.02262443438914027,0.0030165912518853697,Peak,Tuesday,October
2024-10-08 08:00:00,122,368,6,1,497,83,149,5,1,238,26.1,91,3,6.6,735,False,8,205,517,11,2,2024-10-08,False,False,False,0.7034013605442176,0.2789115646258503,0.014965986394557823,0.0027210884353741495,Peak,Tuesday,October
2024-10-08 09:00:00,111,369,8,1,489,91,138,6,1,236,27.4,84,3,7.6,725,False,9,202,507,14,2,2024-10-08,False,False,False,0.6993103448275862,0.2786206896551724,0.019310344827586208,0.002758620689655172,Shoulder,Tuesday,October
2024-10-08 10:00:00,88,339,10,0,437,81,133,5,1,220,28.8,73,3,7.9,657,False,10,169,472,15,1,2024-10-08,False,False,False,0.7184170471841704,0.2572298325722983,0.0228310502283105,0.0015220700152207,Shoulder,Tuesday,October
2024-10-08 11:00:00,69,352,10,2,433,129,105,4,2,240,29.4,66,3,12.0,673,False,11,198,457,14,4,2024-10-08,False,False,False,0.6790490341753344,0.29420505200594355,0.020802377414561663,0.005943536404160475,Peak,Tuesday,October
2024-10-08 12:00:00,84,362,7,0,453,135,97,5,1,238,28.7,68,3,8.6,691,False,12,219,459,12,1,2024-10-08,False,False,False,0.6642547033285094,0.31693198263386396,0.017366136034732273,0.001447178002894356,Peak,Tuesday,October
2024-10-08 13:00:00,89,242,9,1,341,73,150,3,1,227,29.9,65,3,13.2,568,False,13,162,392,12,2,2024-10-08,False,False,False,0.6901408450704225,0.2852112676056338,0.02112676056338028,0.0035211267605633804,Peak,Tuesday,October
2024-10-08 14:00:00,103,241,6,0,350,103,110,3,0,216,28.3,79,3,14.6,566,False,14,206,351,9,0,2024-10-08,False,False,False,0.6201413427561837,0.36395759717314485,0.015901060070671377,0.0,Peak,Tuesday,October
2024-10-08 15:00:00,104,258,6,1,369,131,139,6,1,277,28.5,79,51,10.3,646,False,15,235,397,12,2,2024-10-08,False,False,False,0.6145510835913313,0.3637770897832817,0.018575851393188854,0.0030959752321981426,Peak,Tuesday,October
2024-10-08 16:00:00,128,311,5,0,444,111,167,4,0,282,28.9,78,51,10.5,726,False,16,239,478,9,0,2024-10-08,False,False,False,0.6584022038567493,0.32920110192837465,0.012396694214876033,0.0,Peak,Tuesday,October
2024-10-08 17:00:00,88,294,8,2,392,95,115,6,1,217,27.4,83,61,14.5,609,False,17,183,409,14,3,2024-10-08,False,False,False,0.6715927750410509,0.30049261083743845,0.022988505747126436,0.0049261083743842365,Peak,Tuesday,October
2024-10-08 18:00:00,69,250,7,0,326,72,187,8,2,269,26.5,87,3,9.4,595,False,18,141,437,15,2,2024-10-08,False,False,False,0.7344537815126051,0.23697478991596638,0.025210084033613446,0.0033613445378151263,Peak,Tuesday,October
2024-10-08 19:00:00,79,362,8,1,450,122,108,1,2,233,26.1,90,3,5.0,683,False,19,201,470,9,3,2024-10-08,False,False,False,0.6881405563689604,0.29428989751098095,0.013177159590043924,0.004392386530014641,Peak,Tuesday,October
2024-10-08 20:00:00,98,331,8,2,439,111,160,4,1,276,25.9,92,3,3.3,715,False,20,209,491,12,3,2024-10-08,False,False,False,0.6867132867132867,0.2923076923076923,0.016783216783216783,0.004195804195804196,Shoulder,Tuesday,October
2024-10-08 21:00:00,88,324,7,2,421,73,143,5,2,223,26.3,87,3,9.7,644,False,21,161,467,12,4,2024-10-08,False,False,False,0.7251552795031055,0.25,0.018633540372670808,0.006211180124223602,Shoulder,Tuesday,October
2024-10-08 22:00:00,95,289,9,1,394,129,159,6,5,299,26.0,88,3,8.6,693,False,22,224,448,15,6,2024-10-08,False,False,False,0.6464646464646465,0.32323232323232326,0.021645021645021644,0.008658008658008658,Shoulder,Tuesday,October
2024-10-08 23:00:00,92,282,6,1,381,70,104,4,2,180,25.9,88,3,9.0,561,False,23,162,386,10,3,2024-10-08,False,False,False,0.6880570409982175,0.2887700534759358,0.017825311942959002,0.0053475935828877,Shoulder,Tuesday,October
2024-10-09 00:00:00,87,374,8,1,470,109,118,3,1,231,25.5,89,3,6.9,701,False,0,196,492,11,2,2024-10-09,False,False,False,0.7018544935805991,0.2796005706134094,0.015691868758915834,0.0028530670470756064,Off-Peak,Wednesday,October
2024-10-09 01:00:00,61,448,6,0,515,110,118,4,2,234,25.2,91,3,5.7,749,False,1,171,566,10,2,2024-10-09,False,False,False,0.7556742323097463,0.22830440587449932,0.01335113484646195,0.0026702269692923898,Off-Peak,Wednesday,October
2024-10-09 02:00:00,87,328,8,0,423,121,144,5,1,271,24.8,92,2,6.3,694,False,2,208,472,13,1,2024-10-09,False,False,False,0.6801152737752162,0.29971181556195964,0.018731988472622477,0.001440922190201729,Off-Peak,Wednesday,October
2024-10-09 03:00:00,126,220,8,2,356,94,189,4,2,289,24.5,93,3,6.4,645,False,3,220,409,12,4,2024-10-09,False,False,False,0.6341085271317829,0.34108527131782945,0.018604651162790697,0.006201550387596899,Off-Peak,Wednesday,October
2024-10-09 04:00:00,93,403,8,1,505,96,123,4,1,224,24.6,93,3,5.7,729,False,4,189,526,12,2,2024-10-09,False,False,False,0.7215363511659808,0.25925925925925924,0.01646090534979424,0.0027434842249657062,Off-Peak,Wednesday,October
2024-10-09 05:00:00,85,229,5,0,319,105,193,4,1,303,24.8,92,3,6.5,622,False,5,190,422,9,1,2024-10-09,False,False,False,0.6784565916398714,0.3054662379421222,0.014469453376205787,0.001607717041800643,Shoulder,Wednesday,October
2024-10-09 06:00:00,89,355,6,0,450,128,175,4,4,311,24.3,94,3,7.4,761,False,6,217,530,10,4,2024-10-09,False,False,False,0.6964520367936925,0.2851511169513798,0.013140604467805518,0.005256241787122208,Shoulder,Wednesday,October
2024-10-09 07:00:00,74,405,6,0,485,83,105,4,2,194,24.0,95,1,4.8,679,False,7,157,510,10,2,2024-10-09,False,False,False,0.7511045655375552,0.23122238586156113,0.014727540500736377,0.0029455081001472753,Peak,Wednesday,October
2024-10-09 08:00:00,73,363,7,2,445,82,138,7,3,230,25.2,92,2,5.4,675,False,8,155,501,14,5,2024-10-09,False,False,False,0.7422222222222222,0.22962962962962963,0.02074074074074074,0.007407407407407408,Peak,Wednesday,October
2024-10-09 09:00:00,74,497,5,3,579,94,123,4,0,221,27.3,84,3,4.2,800,False,9,168,620,9,3,2024-10-09,False,False,False,0.775,0.21,0.01125,0.00375,Shoulder,Wednesday,October
2024-10-09 10:00:00,71,209,8,1,289,98,164,4,0,266,28.9,74,51,5.4,555,False,10,169,373,12,1,2024-10-09,False,False,False,0.6720720720720721,0.3045045045045045,0.021621621621621623,0.0018018018018018018,Shoulder,Wednesday,October
2024-10-09 11:00:00,72,333,6,0,411,71,121,5,1,198,29.8,70,3,7.7,609,False,11,143,454,11,1,2024-10-09,False,False,False,0.7454844006568144,0.2348111658456486,0.0180623973727422,0.0016420361247947454,Peak,Wednesday,October
2024-10-09 12:00:00,68,342,6,1,417,137,103,7,0,247,30.5,67,2,8.8,664,False,12,205,445,13,1,2024-10-09,False,False,False,0.6701807228915663,0.30873493975903615,0.01957831325301205,0.0015060240963855422,Peak,Wednesday,October
2024-10-09 13:00:00,75,250,8,0,333,100,138,5,2,245,30.9,64,1,10.5,578,False,13,175,388,13,2,2024-10-09,False,False,False,0.671280276816609,0.3027681660899654,0.02249134948096886,0.0034602076124567475,Peak,Wednesday,October
2024-10-09 14:00:00,76,265,6,0,347,99,184,4,1,288,30.9,63,1,11.0,635,False,14,175,449,10,1,2024-10-09,False,False,False,0.7070866141732284,0.2755905511811024,0.015748031496062992,0.0015748031496062992,Peak,Wednesday,October
2024-10-09 15:00:00,85,290,10,0,385,138,144,5,1,288,30.8,64,1,10.7,673,False,15,223,434,15,1,2024-10-09,False,False,False,0.6448736998514116,0.3313521545319465,0.022288261515601784,0.0014858841010401188,Peak,Wednesday,October
2024-10-09 16:00:00,79,266,4,3,352,117,163,5,2,287,30.3,68,3,11.4,639,False,16,196,429,9,5,2024-10-09,False,False,False,0.6713615023474179,0.30672926447574334,0.014084507042253521,0.00782472613458529,Peak,Wednesday,October
2024-10-09 17:00:00,82,334,6,2,424,97,161,2,4,264,29.8,72,3,10.6,688,False,17,179,495,8,6,2024-10-09,False,False,False,0.7194767441860465,0.2601744186046512,0.011627906976744186,0.00872093023255814,Peak,Wednesday,October
2024-10-09 18:00:00,103,299,8,0,410,109,106,5,0,220,29.2,75,3,9.9,630,False,18,212,405,13,0,2024-10-09,False,False,False,0.6428571428571429,0.33650793650793653,0.020634920634920634,0.0,Peak,Wednesday,October
2024-10-09 19:00:00,80,365,7,0,452,104,120,5,1,230,28.7,74,3,9.3,682,False,19,184,485,12,1,2024-10-09,False,False,False,0.7111436950146628,0.2697947214076246,0.017595307917888565,0.001466275659824047,Peak,Wednesday,October
2024-10-09 20:00:00,117,391,5,0,513,134,151,6,0,291,28.3,76,3,8.5,804,False,20,251,542,11,0,2024-10-09,False,False,False,0.6741293532338308,0.31218905472636815,0.013681592039800995,0.0,Shoulder,Wednesday,October
2024-10-09 21:00:00,84,384,9,0,477,102,133,4,3,242,26.9,87,3,9.0,719,False,21,186,517,13,3,2024-10-09,False,False,False,0.7190542420027817,0.25869262865090403,0.01808066759388039,0.004172461752433936,Shoulder,Wednesday,October
2024-10-09 22:00:00,72,314,10,0,396,76,201,8,0,285,26.8,88,51,5.4,681,False,22,148,515,18,0,2024-10-09,False,False,False,0.7562408223201175,0.2173274596182085,0.02643171806167401,0.0,Shoulder,Wednesday,October
2024-10-09 23:00:00,99,359,9,0,467,66,113,5,1,185,26.3,90,3,5.5,652,False,23,165,472,14,1,2024-10-09,False,False,False,0.7239263803680982,0.25306748466257667,0.02147239263803681,0.0015337423312883436,Shoulder,Wednesday,October
2024-10-10 00:00:00,67,470,2,2,541,84,151,8,2,245,26.0,90,3,5.6,786,False,0,151,621,10,4,2024-10-10,False,False,False,0.7900763358778626,0.1921119592875318,0.01272264631043257,0.005089058524173028,Off-Peak,Thursday,October
2024-10-10 01:00:00,76,479,2,1,558,126,113,6,2,247,25.6,92,3,5.3,805,False,1,202,592,8,3,2024-10-10,False,False,False,0.7354037267080745,0.25093167701863356,0.009937888198757764,0.0037267080745341614,Off-Peak,Thursday,October
2024-10-10 02:00:00,55,410,2,0,467,136,89,6,1,232,25.4,92,3,7.6,699,False,2,191,499,8,1,2024-10-10,False,False,False,0.7138769670958512,0.2732474964234621,0.011444921316165951,0.001430615164520744,Off-Peak,Thursday,October
2024-10-10 03:00:00,78,385,4,1,468,75,144,5,1,225,25.3,93,3,6.3,693,False,3,153,529,9,2,2024-10-10,False,False,False,0.7633477633477633,0.22077922077922077,0.012987012987012988,0.002886002886002886,Off-Peak,Thursday,October
2024-10-10 04:00:00,85,363,1,1,450,111,148,7,2,268,25.1,95,3,5.4,718,False,4,196,511,8,3,2024-10-10,False,False,False,0.7116991643454039,0.27298050139275765,0.011142061281337047,0.004178272980501393,Off-Peak,Thursday,October
2024-10-10 05:00:00,80,335,1,1,417,97,93,5,1,196,24.5,98,3,2.0,613,False,5,177,428,6,2,2024-10-10,False,False,False,0.6982055464926591,0.28874388254486133,0.009787928221859706,0.0032626427406199023,Shoulder,Thursday,October
2024-10-10 06:00:00,120,350,5,0,475,120,123,5,2,250,24.7,97,3,2.3,725,False,6,240,473,10,2,2024-10-10,False,False,False,0.6524137931034483,0.3310344827586207,0.013793103448275862,0.002758620689655172,Shoulder,Thursday,October
2024-10-10 07:00:00,115,302,2,2,421,82,165,6,2,255,24.6,97,3,2.9,676,False,7,197,467,8,4,2024-10-10,False,False,False,0.6908284023668639,0.29142011834319526,0.011834319526627219,0.005917159763313609,Peak,Thursday,October
2024-10-10 08:00:00,71,393,3,1,468,140,145,4,1,290,25.7,93,2,6.2,758,False,8,211,538,7,2,2024-10-10,False,False,False,0.7097625329815304,0.2783641160949868,0.009234828496042216,0.002638522427440633,Peak,Thursday,October
2024-10-10 09:00:00,51,271,3,2,327,73,119,1,1,194,26.8,87,3,4.9,521,False,9,124,390,4,3,2024-10-10,False,False,False,0.7485604606525912,0.2380038387715931,0.007677543186180422,0.005758157389635317,Shoulder,Thursday,October
2024-10-10 10:00:00,87,417,3,1,508,102,115,5,1,223,27.9,82,51,1.4,731,False,10,189,532,8,2,2024-10-10,False,False,False,0.7277701778385773,0.2585499316005472,0.01094391244870041,0.0027359781121751026,Shoulder,Thursday,October
2024-10-10 11:00:00,92,400,3,1,496,116,182,5,1,304,29.1,76,51,6.5,800,False,11,208,582,8,2,2024-10-10,False,False,False,0.7275,0.26,0.01,0.0025,Peak,Thursday,October
2024-10-10 12:00:00,69,408,3,1,481,90,91,6,1,188,29.7,73,51,8.4,669,False,12,159,499,9,2,2024-10-10,False,False,False,0.7458893871449925,0.23766816143497757,0.013452914798206279,0.0029895366218236174,Peak,Thursday,October
2024-10-10 13:00:00,74,360,1,2,437,87,129,5,1,222,29.9,74,51,10.0,659,False,13,161,489,6,3,2024-10-10,False,False,False,0.7420333839150227,0.24430955993930198,0.009104704097116844,0.004552352048558422,Peak,Thursday,October
2024-10-10 14:00:00,112,645,1,1,759,109,94,4,0,207,29.3,76,51,11.0,966,False,14,221,739,5,1,2024-10-10,False,False,False,0.7650103519668737,0.2287784679089027,0.005175983436853002,0.0010351966873706005,Peak,Thursday,October
2024-10-10 15:00:00,79,508,3,2,592,103,164,5,0,272,29.3,75,51,12.3,864,False,15,182,672,8,2,2024-10-10,False,False,False,0.7777777777777778,0.21064814814814814,0.009259259259259259,0.0023148148148148147,Peak,Thursday,October
2024-10-10 16:00:00,94,300,1,3,398,104,131,3,2,240,28.4,78,51,9.3,638,False,16,198,431,4,5,2024-10-10,False,False,False,0.6755485893416928,0.3103448275862069,0.006269592476489028,0.007836990595611285,Peak,Thursday,October
2024-10-10 17:00:00,72,421,1,1,495,123,136,7,2,268,28.4,79,51,7.5,763,False,17,195,557,8,3,2024-10-10,False,False,False,0.7300131061598951,0.25557011795543905,0.010484927916120577,0.003931847968545216,Peak,Thursday,October
2024-10-10 18:00:00,84,353,2,1,440,100,206,5,2,313,28.2,79,51,6.2,753,False,18,184,559,7,3,2024-10-10,False,False,False,0.7423638778220452,0.24435590969455512,0.009296148738379814,0.00398406374501992,Peak,Thursday,October
2024-10-10 19:00:00,80,319,3,2,404,110,116,8,3,237,27.4,86,3,4.1,641,False,19,190,435,11,5,2024-10-10,False,False,False,0.6786271450858035,0.296411856474259,0.0171606864274571,0.0078003120124804995,Peak,Thursday,October
2024-10-10 20:00:00,72,293,1,1,367,94,177,5,1,277,27.1,88,3,4.5,644,False,20,166,470,6,2,2024-10-10,False,False,False,0.7298136645962733,0.2577639751552795,0.009316770186335404,0.003105590062111801,Shoulder,Thursday,October
2024-10-10 21:00:00,106,437,3,2,548,87,118,7,1,213,27.2,91,51,2.8,761,False,21,193,555,10,3,2024-10-10,False,False,False,0.7293035479632063,0.2536136662286465,0.013140604467805518,0.003942181340341655,Shoulder,Thursday,October
2024-10-10 22:00:00,62,346,6,1,415,100,120,3,1,224,26.7,92,61,2.6,639,False,22,162,466,9,2,2024-10-10,False,False,False,0.729264475743349,0.2535211267605634,0.014084507042253521,0.003129890453834116,Shoulder,Thursday,October
2024-10-10 23:00:00,90,476,4,0,570,93,203,7,2,305,25.0,97,65,7.1,875,False,23,183,679,11,2,2024-10-10,False,False,False,0.776,0.20914285714285713,0.012571428571428572,0.002285714285714286,Shoulder,Thursday,October
2024-10-11 00:00:00,128,308,11,2,449,97,429,5,2,533,25.3,96,51,2.3,982,False,0,225,737,16,4,2024-10-11,False,False,False,0.7505091649694501,0.22912423625254583,0.016293279022403257,0.004073319755600814,Off-Peak,Friday,October
2024-10-11 01:00:00,179,511,6,4,700,120,487,10,1,618,25.1,98,3,2.7,1318,False,1,299,998,16,5,2024-10-11,False,False,False,0.7572078907435509,0.2268588770864947,0.012139605462822459,0.0037936267071320183,Off-Peak,Friday,October
2024-10-11 02:00:00,193,438,12,3,646,167,323,8,2,500,25.2,97,3,4.7,1146,False,2,360,761,20,5,2024-10-11,False,False,False,0.6640488656195462,0.31413612565445026,0.017452006980802792,0.004363001745200698,Off-Peak,Friday,October
2024-10-11 03:00:00,140,532,9,2,683,137,415,7,2,561,24.8,98,61,8.0,1244,False,3,277,947,16,4,2024-10-11,False,False,False,0.7612540192926045,0.22266881028938906,0.012861736334405145,0.003215434083601286,Off-Peak,Friday,October
2024-10-11 04:00:00,74,556,9,2,641,62,380,7,1,450,24.0,99,65,8.7,1091,False,4,136,936,16,3,2024-10-11,False,False,False,0.8579285059578369,0.12465627864344637,0.01466544454628781,0.002749770852428964,Off-Peak,Friday,October
2024-10-11 05:00:00,187,464,7,4,662,104,477,6,1,588,24.2,96,51,6.6,1250,False,5,291,941,13,5,2024-10-11,False,False,False,0.7528,0.2328,0.0104,0.004,Shoulder,Friday,October
2024-10-11 06:00:00,193,565,8,2,768,148,517,6,1,672,23.9,98,51,5.1,1440,False,6,341,1082,14,3,2024-10-11,False,False,True,0.7513888888888889,0.23680555555555555,0.009722222222222222,0.0020833333333333333,Shoulder,Friday,October
2024-10-11 07:00:00,166,527,8,2,703,90,305,8,6,409,23.8,97,3,5.1,1112,False,7,256,832,16,8,2024-10-11,False,False,False,0.7482014388489209,0.2302158273381295,0.014388489208633094,0.007194244604316547,Peak,Friday,October
2024-10-11 08:00:00,212,562,6,3,783,135,546,7,2,690,24.7,94,3,4.0,1473,False,8,347,1108,13,5,2024-10-11,False,False,True,0.7522063815342838,0.2355736591989138,0.008825526137135099,0.0033944331296673455,Peak,Friday,October
2024-10-11 09:00:00,190,529,9,2,730,101,396,10,1,508,24.7,95,51,5.7,1238,False,9,291,925,19,3,2024-10-11,False,False,False,0.747172859450727,0.23505654281098545,0.015347334410339256,0.0024232633279483036,Shoulder,Friday,October
2024-10-11 10:00:00,218,477,8,3,706,165,356,7,0,528,26.4,88,51,3.6,1234,False,10,383,833,15,3,2024-10-11,False,False,False,0.6750405186385737,0.31037277147487846,0.012155591572123177,0.0024311183144246355,Shoulder,Friday,October
2024-10-11 11:00:00,175,485,11,2,673,147,534,9,1,691,28.4,79,3,4.3,1364,False,11,322,1019,20,3,2024-10-11,False,False,False,0.7470674486803519,0.23607038123167157,0.01466275659824047,0.0021994134897360706,Peak,Friday,October
2024-10-11 12:00:00,149,539,7,3,698,135,356,9,1,501,29.4,75,51,8.4,1199,False,12,284,895,16,4,2024-10-11,False,False,False,0.7464553794829024,0.23686405337781485,0.013344453711426188,0.003336113427856547,Peak,Friday,October
2024-10-11 13:00:00,154,476,10,2,642,122,386,8,3,519,29.6,74,3,9.3,1161,False,13,276,862,18,5,2024-10-11,False,False,False,0.7424633936261843,0.23772609819121446,0.015503875968992248,0.004306632213608958,Peak,Friday,October
2024-10-11 14:00:00,195,457,7,3,662,129,356,5,2,492,29.7,75,3,9.4,1154,False,14,324,813,12,5,2024-10-11,False,False,False,0.7045060658578857,0.2807625649913345,0.010398613518197574,0.004332755632582322,Peak,Friday,October
2024-10-11 15:00:00,117,291,7,3,418,163,266,8,3,440,29.8,74,3,10.3,858,False,15,280,557,15,6,2024-10-11,False,False,False,0.6491841491841492,0.32634032634032634,0.017482517482517484,0.006993006993006993,Peak,Friday,October
2024-10-11 16:00:00,147,294,10,2,453,117,518,8,1,644,29.5,74,3,9.4,1097,False,16,264,812,18,3,2024-10-11,False,False,False,0.740200546946217,0.2406563354603464,0.016408386508659983,0.0027347310847766638,Peak,Friday,October
2024-10-11 17:00:00,235,404,9,1,649,71,422,5,2,500,29.5,72,3,8.2,1149,False,17,306,826,14,3,2024-10-11,False,False,False,0.7188859878154917,0.26631853785900783,0.012184508268059183,0.0026109660574412533,Peak,Friday,October
2024-10-11 18:00:00,168,436,9,1,614,127,506,5,1,639,28.9,75,3,5.2,1253,False,18,295,942,14,2,2024-10-11,False,False,False,0.7517956903431764,0.23543495610534718,0.0111731843575419,0.0015961691939345571,Peak,Friday,October
2024-10-11 19:00:00,275,483,10,3,771,89,475,6,2,572,27.9,82,3,3.4,1343,False,19,364,958,16,5,2024-10-11,False,False,False,0.7133283693224125,0.2710349962769918,0.011913626209977662,0.0037230081906180195,Peak,Friday,October
2024-10-11 20:00:00,188,403,6,4,601,120,347,5,0,472,27.5,88,3,3.3,1073,False,20,308,750,11,4,2024-10-11,False,False,False,0.6989748369058714,0.2870456663560112,0.010251630941286114,0.003727865796831314,Shoulder,Friday,October
2024-10-11 21:00:00,173,511,6,3,693,155,524,7,0,686,28.1,83,3,5.2,1379,False,21,328,1035,13,3,2024-10-11,False,False,True,0.7505438723712835,0.2378535170413343,0.009427121102248005,0.002175489485134155,Shoulder,Friday,October
2024-10-11 22:00:00,162,487,8,2,659,185,420,6,1,612,26.5,89,63,4.1,1271,False,22,347,907,14,3,2024-10-11,False,False,False,0.7136113296616837,0.27301337529504327,0.011014948859166011,0.0023603461841070024,Shoulder,Friday,October
2024-10-11 23:00:00,186,414,9,2,611,152,516,6,1,675,25.2,96,65,2.7,1286,False,23,338,930,15,3,2024-10-11,False,False,False,0.7231726283048211,0.26283048211508553,0.01166407465007776,0.0023328149300155523,Shoulder,Friday,October
2024-10-12 00:00:00,244,461,5,3,713,123,439,8,0,570,25.2,96,53,5.7,1283,True,0,367,900,13,3,2024-10-12,False,True,False,0.7014809041309431,0.2860483242400624,0.010132501948558068,0.002338269680436477,Off-Peak,Saturday,October
2024-10-12 01:00:00,160,398,7,3,568,112,597,9,0,718,24.9,96,51,5.1,1286,True,1,272,995,16,3,2024-10-12,False,True,False,0.7737169517884914,0.2115085536547434,0.012441679626749611,0.0023328149300155523,Off-Peak,Saturday,October
2024-10-12 02:00:00,206,497,9,1,713,127,354,9,1,491,24.6,96,51,6.0,1204,True,2,333,851,18,2,2024-10-12,False,True,False,0.7068106312292359,0.276578073089701,0.014950166112956811,0.0016611295681063123,Off-Peak,Saturday,October
2024-10-12 03:00:00,82,465,6,2,555,113,295,12,1,421,24.2,97,3,3.1,976,True,3,195,760,18,3,2024-10-12,False,True,False,0.7786885245901639,0.19979508196721313,0.018442622950819672,0.0030737704918032786,Off-Peak,Saturday,October
2024-10-12 04:00:00,222,392,10,4,628,175,315,9,1,500,24.2,97,3,7.9,1128,True,4,397,707,19,5,2024-10-12,False,True,False,0.62677304964539,0.3519503546099291,0.016843971631205674,0.004432624113475178,Off-Peak,Saturday,October
2024-10-12 05:00:00,126,376,8,5,515,116,442,8,1,567,23.8,99,3,3.0,1082,True,5,242,818,16,6,2024-10-12,False,True,False,0.756007393715342,0.22365988909426987,0.014787430683918669,0.005545286506469501,Shoulder,Saturday,October
2024-10-12 06:00:00,162,563,6,2,733,131,268,9,2,410,23.6,99,3,3.0,1143,True,6,293,831,15,4,2024-10-12,False,True,False,0.7270341207349081,0.2563429571303587,0.013123359580052493,0.003499562554680665,Shoulder,Saturday,October
2024-10-12 07:00:00,146,619,13,2,780,118,529,9,2,658,24.0,98,51,1.9,1438,True,7,264,1148,22,4,2024-10-12,False,True,True,0.7983310152990264,0.1835883171070932,0.015299026425591099,0.0027816411682892906,Peak,Saturday,October
2024-10-12 08:00:00,150,497,9,3,659,71,466,6,0,543,25.3,97,3,1.9,1202,True,8,221,963,15,3,2024-10-12,False,True,False,0.8011647254575707,0.18386023294509152,0.012479201331114808,0.0024958402662229617,Peak,Saturday,October
2024-10-12 09:00:00,139,467,9,1,616,108,404,8,2,522,26.9,86,51,0.5,1138,True,9,247,871,17,3,2024-10-12,False,True,False,0.7653778558875219,0.21704745166959577,0.014938488576449912,0.0026362038664323375,Shoulder,Saturday,October
2024-10-12 10:00:00,106,390,11,1,508,120,325,6,0,451,28.1,84,51,1.2,959,True,10,226,715,17,1,2024-10-12,False,True,False,0.7455683003128258,0.23566214807090718,0.017726798748696558,0.0010427528675703858,Shoulder,Saturday,October
2024-10-12 11:00:00,199,415,8,2,624,171,413,6,1,591,28.6,80,51,5.3,1215,True,11,370,828,14,3,2024-10-12,False,True,False,0.6814814814814815,0.3045267489711934,0.011522633744855968,0.0024691358024691358,Peak,Saturday,October
2024-10-12 12:00:00,178,480,7,6,671,78,475,6,2,561,27.4,82,63,9.5,1232,True,12,256,955,13,8,2024-10-12,False,True,False,0.7751623376623377,0.2077922077922078,0.010551948051948052,0.006493506493506494,Peak,Saturday,October
2024-10-12 13:00:00,152,386,9,1,548,72,437,10,1,520,28.2,79,51,6.0,1068,True,13,224,823,19,2,2024-10-12,False,True,False,0.7705992509363296,0.20973782771535582,0.017790262172284643,0.0018726591760299626,Peak,Saturday,October
2024-10-12 14:00:00,185,513,8,3,709,146,612,9,1,768,27.0,84,61,8.6,1477,True,14,331,1125,17,4,2024-10-12,False,True,True,0.7616790792146242,0.22410291130670276,0.011509817197020988,0.002708192281651997,Peak,Saturday,October
2024-10-12 15:00:00,197,388,6,4,595,78,376,10,2,466,27.6,83,51,2.6,1061,True,15,275,764,16,6,2024-10-12,False,True,False,0.7200754005655042,0.25918944392082943,0.015080113100848256,0.005655042412818096,Peak,Saturday,October
2024-10-12 16:00:00,168,443,6,2,619,134,406,8,3,551,28.0,83,51,3.4,1170,True,16,302,849,14,5,2024-10-12,False,True,False,0.7256410256410256,0.25811965811965815,0.011965811965811967,0.004273504273504274,Peak,Saturday,October
2024-10-12 17:00:00,197,443,8,4,652,118,489,7,1,615,28.2,81,3,2.3,1267,True,17,315,932,15,5,2024-10-12,False,True,False,0.7355958958168903,0.24861878453038674,0.011838989739542225,0.003946329913180742,Peak,Saturday,October
2024-10-12 18:00:00,242,498,7,2,749,136,397,9,0,542,27.9,82,51,2.9,1291,True,18,378,895,16,2,2024-10-12,False,True,False,0.6932610379550735,0.2927962819519752,0.012393493415956624,0.001549186676994578,Peak,Saturday,October
2024-10-12 19:00:00,178,392,10,3,583,108,469,9,0,586,26.3,89,63,4.4,1169,True,19,286,861,19,3,2024-10-12,False,True,False,0.7365269461077845,0.2446535500427716,0.016253207869974338,0.0025662959794696323,Peak,Saturday,October
2024-10-12 20:00:00,177,522,7,3,709,119,451,6,0,576,25.5,95,63,5.6,1285,True,20,296,973,13,3,2024-10-12,False,True,False,0.7571984435797665,0.23035019455252917,0.010116731517509728,0.0023346303501945525,Shoulder,Saturday,October
2024-10-12 21:00:00,154,563,9,3,729,128,375,7,0,510,25.3,98,53,4.1,1239,True,21,282,938,16,3,2024-10-12,False,True,False,0.7570621468926554,0.22760290556900725,0.0129136400322841,0.002421307506053269,Shoulder,Saturday,October
2024-10-12 22:00:00,145,429,5,3,582,130,604,11,2,747,25.4,97,53,0.3,1329,True,22,275,1033,16,5,2024-10-12,False,True,False,0.7772761474793077,0.20692249811888638,0.012039127163280662,0.003762227238525207,Shoulder,Saturday,October
2024-10-12 23:00:00,156,568,9,1,734,79,399,9,0,487,25.1,99,61,3.8,1221,True,23,235,967,18,1,2024-10-12,False,True,False,0.7919737919737919,0.19246519246519248,0.014742014742014743,0.000819000819000819,Shoulder,Saturday,October
2024-10-13 00:00:00,196,599,7,1,803,153,474,6,2,635,24.8,97,63,7.2,1438,True,0,349,1073,13,3,2024-10-13,False,False,True,0.7461752433936022,0.2426981919332406,0.009040333796940195,0.002086230876216968,Off-Peak,Sunday,October
2024-10-13 01:00:00,216,545,8,2,771,180,558,11,3,752,24.6,97,51,5.8,1523,True,1,396,1103,19,5,2024-10-13,False,False,True,0.7242284963887065,0.26001313197636244,0.01247537754432042,0.003282994090610637,Off-Peak,Sunday,October
2024-10-13 02:00:00,206,629,5,1,841,179,369,8,3,559,24.3,97,61,8.1,1400,True,2,385,998,13,4,2024-10-13,False,False,True,0.7128571428571429,0.275,0.009285714285714286,0.002857142857142857,Off-Peak,Sunday,October
2024-10-13 03:00:00,159,494,6,3,662,162,296,8,2,468,23.9,98,51,7.2,1130,True,3,321,790,14,5,2024-10-13,False,False,False,0.6991150442477876,0.28407079646017697,0.012389380530973451,0.004424778761061947,Off-Peak,Sunday,October
2024-10-13 04:00:00,209,386,11,1,607,197,510,8,2,717,24.0,97,51,7.7,1324,True,4,406,896,19,3,2024-10-13,False,False,False,0.676737160120846,0.3066465256797583,0.014350453172205438,0.0022658610271903325,Off-Peak,Sunday,October
2024-10-13 05:00:00,133,715,7,4,859,217,456,11,4,688,24.4,96,3,6.2,1547,True,5,350,1171,18,8,2024-10-13,False,False,True,0.7569489334195216,0.22624434389140272,0.011635423400129283,0.005171299288946348,Shoulder,Sunday,October
2024-10-13 06:00:00,159,427,8,1,595,179,523,9,2,713,24.2,97,51,4.6,1308,True,6,338,950,17,3,2024-10-13,False,False,False,0.7262996941896025,0.25840978593272174,0.012996941896024464,0.0022935779816513763,Shoulder,Sunday,October
2024-10-13 07:00:00,130,510,10,3,653,191,465,8,2,666,24.7,96,51,3.1,1319,True,7,321,975,18,5,2024-10-13,False,False,False,0.7391963608794542,0.24336618650492797,0.013646702047005308,0.0037907505686125853,Peak,Sunday,October
2024-10-13 08:00:00,160,575,9,3,747,98,612,11,3,724,25.9,93,51,6.3,1471,True,8,258,1187,20,6,2024-10-13,False,False,True,0.8069340584636302,0.17539089055064583,0.013596193065941536,0.004078857919782461,Peak,Sunday,October
2024-10-13 09:00:00,135,444,9,1,589,191,460,3,3,657,26.4,87,51,12.7,1246,True,9,326,904,12,4,2024-10-13,False,False,False,0.7255216693418941,0.26163723916532905,0.009630818619582664,0.0032102728731942215,Shoulder,Sunday,October
2024-10-13 10:00:00,138,574,7,2,721,135,323,8,1,467,27.3,81,51,14.5,1188,True,10,273,897,15,3,2024-10-13,False,False,False,0.7550505050505051,0.2297979797979798,0.012626262626262626,0.0025252525252525255,Shoulder,Sunday,October
2024-10-13 11:00:00,144,639,10,1,794,200,288,10,2,500,28.6,75,3,15.1,1294,True,11,344,927,20,3,2024-10-13,False,False,False,0.7163833075734157,0.26584234930448225,0.015455950540958269,0.00231839258114374,Peak,Sunday,October
2024-10-13 12:00:00,248,530,7,4,789,217,362,8,2,589,29.1,74,3,14.6,1378,True,12,465,892,15,6,2024-10-13,False,False,True,0.6473149492017417,0.3374455732946299,0.01088534107402032,0.0043541364296081275,Peak,Sunday,October
2024-10-13 13:00:00,138,518,10,3,669,207,569,5,1,782,29.6,72,3,13.4,1451,True,13,345,1087,15,4,2024-10-13,False,False,True,0.7491385251550655,0.2377670572019297,0.010337698139214336,0.0027567195037904893,Peak,Sunday,October
2024-10-13 14:00:00,134,486,8,4,632,54,453,9,4,520,29.7,71,3,11.6,1152,True,14,188,939,17,8,2024-10-13,False,False,False,0.8151041666666666,0.16319444444444445,0.014756944444444444,0.006944444444444444,Peak,Sunday,October
2024-10-13 15:00:00,174,457,8,3,642,194,300,8,2,504,29.8,68,3,12.1,1146,True,15,368,757,16,5,2024-10-13,False,False,False,0.6605584642233857,0.32111692844677137,0.013961605584642234,0.004363001745200698,Peak,Sunday,October
2024-10-13 16:00:00,206,383,7,1,597,206,552,10,3,771,29.6,68,3,10.1,1368,True,16,412,935,17,4,2024-10-13,False,False,False,0.6834795321637427,0.30116959064327486,0.012426900584795321,0.0029239766081871343,Peak,Sunday,October
2024-10-13 17:00:00,158,445,10,1,614,190,433,8,1,632,29.2,69,3,7.8,1246,True,17,348,878,18,2,2024-10-13,False,False,False,0.7046548956661316,0.27929373996789725,0.014446227929373997,0.0016051364365971107,Peak,Sunday,October
2024-10-13 18:00:00,133,488,8,4,633,178,528,10,2,718,28.5,72,3,5.9,1351,True,18,311,1016,18,6,2024-10-13,False,False,False,0.7520355292376018,0.23019985196151,0.013323464100666173,0.0044411547002220575,Peak,Sunday,October
2024-10-13 19:00:00,173,455,9,4,641,134,442,10,2,588,27.3,78,3,4.4,1229,True,19,307,897,19,6,2024-10-13,False,False,False,0.7298616761594793,0.24979658258746948,0.015459723352318959,0.004882017900732303,Peak,Sunday,October
2024-10-13 20:00:00,223,544,10,2,779,180,384,7,2,573,27.1,79,3,6.7,1352,True,20,403,928,17,4,2024-10-13,False,False,False,0.6863905325443787,0.2980769230769231,0.01257396449704142,0.0029585798816568047,Shoulder,Sunday,October
2024-10-13 21:00:00,147,528,10,3,688,168,473,11,2,654,27.1,78,3,5.7,1342,True,21,315,1001,21,5,2024-10-13,False,False,False,0.7459016393442623,0.23472429210134127,0.01564828614008942,0.0037257824143070045,Shoulder,Sunday,October
2024-10-13 22:00:00,227,574,9,1,811,169,521,8,5,703,26.9,79,3,5.9,1514,True,22,396,1095,17,6,2024-10-13,False,False,True,0.7232496697490093,0.261558784676354,0.011228533685601057,0.003963011889035667,Shoulder,Sunday,October
2024-10-13 23:00:00,150,717,9,2,878,212,419,7,2,640,26.5,82,3,7.3,1518,True,23,362,1136,16,4,2024-10-13,False,False,True,0.7483530961791831,0.23847167325428195,0.010540184453227932,0.002635046113306983,Shoulder,Sunday,October
2024-10-14 00:00:00,96,340,4,0,440,61,166,4,0,231,26.7,82,3,9.7,671,False,0,157,506,8,0,2024-10-14,False,False,False,0.7540983606557377,0.23397913561847988,0.011922503725782414,0.0,Off-Peak,Monday,October
2024-10-14 01:00:00,130,352,6,1,489,111,169,5,0,285,26.7,82,3,9.7,774,False,1,241,521,11,1,2024-10-14,False,False,False,0.6731266149870802,0.31136950904392763,0.014211886304909561,0.0012919896640826874,Off-Peak,Monday,October
2024-10-14 02:00:00,98,398,4,1,501,111,109,4,1,225,25.6,89,53,11.8,726,False,2,209,507,8,2,2024-10-14,False,False,False,0.6983471074380165,0.2878787878787879,0.011019283746556474,0.0027548209366391185,Off-Peak,Monday,October
2024-10-14 03:00:00,73,235,3,0,311,118,81,4,2,205,25.5,91,3,7.5,516,False,3,191,316,7,2,2024-10-14,False,False,False,0.6124031007751938,0.3701550387596899,0.013565891472868217,0.003875968992248062,Off-Peak,Monday,October
2024-10-14 04:00:00,98,290,5,1,394,93,138,4,0,235,25.3,93,3,4.8,629,False,4,191,428,9,1,2024-10-14,False,False,False,0.6804451510333863,0.3036565977742448,0.014308426073131956,0.001589825119236884,Off-Peak,Monday,October
2024-10-14 05:00:00,99,322,7,3,431,92,134,4,2,232,24.9,93,3,8.5,663,False,5,191,456,11,5,2024-10-14,False,False,False,0.6877828054298643,0.28808446455505277,0.016591251885369532,0.007541478129713424,Shoulder,Monday,October
2024-10-14 06:00:00,95,476,5,1,577,98,132,5,0,235,24.7,92,3,8.4,812,False,6,193,608,10,1,2024-10-14,False,False,False,0.7487684729064039,0.2376847290640394,0.012315270935960592,0.0012315270935960591,Shoulder,Monday,October
2024-10-14 07:00:00,100,257,4,1,362,100,113,5,1,219,24.3,92,3,5.2,581,False,7,200,370,9,2,2024-10-14,False,False,False,0.6368330464716007,0.3442340791738382,0.01549053356282272,0.0034423407917383822,Peak,Monday,October
2024-10-14 08:00:00,83,449,3,1,536,98,144,5,2,249,24.7,91,3,6.8,785,False,8,181,593,8,3,2024-10-14,False,False,False,0.7554140127388536,0.23057324840764332,0.01019108280254777,0.003821656050955414,Peak,Monday,October
2024-10-14 09:00:00,90,359,4,0,453,73,115,3,0,191,26.8,86,3,12.6,644,False,9,163,474,7,0,2024-10-14,False,False,False,0.7360248447204969,0.2531055900621118,0.010869565217391304,0.0,Shoulder,Monday,October
2024-10-14 10:00:00,76,391,7,1,475,142,166,4,2,314,28.0,80,3,10.7,789,False,10,218,557,11,3,2024-10-14,False,False,False,0.70595690747782,0.27629911280101394,0.01394169835234474,0.0038022813688212928,Shoulder,Monday,October
2024-10-14 11:00:00,68,337,4,2,411,117,155,6,2,280,29.2,74,3,8.5,691,False,11,185,492,10,4,2024-10-14,False,False,False,0.7120115774240231,0.26772793053545585,0.01447178002894356,0.005788712011577424,Peak,Monday,October
2024-10-14 12:00:00,100,240,4,0,344,90,119,6,4,219,29.6,71,3,8.5,563,False,12,190,359,10,4,2024-10-14,False,False,False,0.6376554174067496,0.33747779751332146,0.017761989342806393,0.007104795737122558,Peak,Monday,October
2024-10-14 13:00:00,78,255,5,2,340,87,200,3,1,291,29.6,70,3,7.9,631,False,13,165,455,8,3,2024-10-14,False,False,False,0.7210776545166403,0.26148969889064977,0.012678288431061807,0.004754358161648178,Peak,Monday,October
2024-10-14 14:00:00,93,289,1,1,384,98,121,6,3,228,29.7,71,3,9.2,612,False,14,191,410,7,4,2024-10-14,False,False,False,0.6699346405228758,0.31209150326797386,0.011437908496732025,0.006535947712418301,Peak,Monday,October
2024-10-14 15:00:00,114,322,4,2,442,152,196,2,1,351,29.3,73,3,9.2,793,False,15,266,518,6,3,2024-10-14,False,False,False,0.6532156368221942,0.3354350567465322,0.007566204287515763,0.0037831021437578815,Peak,Monday,October
2024-10-14 16:00:00,94,304,5,1,404,114,115,5,1,235,29.2,74,3,8.0,639,False,16,208,419,10,2,2024-10-14,False,False,False,0.6557120500782473,0.325508607198748,0.01564945226917058,0.003129890453834116,Peak,Monday,October
2024-10-14 17:00:00,112,312,6,1,431,94,131,8,1,234,28.8,76,3,6.1,665,False,17,206,443,14,2,2024-10-14,False,False,False,0.6661654135338346,0.3097744360902256,0.021052631578947368,0.0030075187969924814,Peak,Monday,October
2024-10-14 18:00:00,102,320,3,1,426,95,177,5,4,281,28.2,79,3,6.5,707,False,18,197,497,8,5,2024-10-14,False,False,False,0.7029702970297029,0.27864214992927866,0.011315417256011316,0.007072135785007072,Peak,Monday,October
2024-10-14 19:00:00,88,289,4,2,383,116,102,8,2,228,27.3,85,3,3.4,611,False,19,204,391,12,4,2024-10-14,False,False,False,0.6399345335515548,0.33387888707037644,0.019639934533551555,0.006546644844517185,Peak,Monday,October
2024-10-14 20:00:00,93,383,4,0,480,141,145,4,1,291,27.2,86,3,3.6,771,False,20,234,528,8,1,2024-10-14,False,False,False,0.6848249027237354,0.3035019455252918,0.010376134889753566,0.0012970168612191958,Shoulder,Monday,October
2024-10-14 21:00:00,56,401,4,1,462,80,87,6,1,174,26.2,88,3,3.1,636,False,21,136,488,10,2,2024-10-14,False,False,False,0.7672955974842768,0.2138364779874214,0.015723270440251572,0.0031446540880503146,Shoulder,Monday,October
2024-10-14 22:00:00,114,437,7,1,559,80,141,4,0,225,25.8,90,3,3.1,784,False,22,194,578,11,1,2024-10-14,False,False,False,0.7372448979591837,0.24744897959183673,0.01403061224489796,0.0012755102040816326,Shoulder,Monday,October
2024-10-14 23:00:00,85,328,4,1,418,154,90,6,3,253,25.5,92,3,3.3,671,False,23,239,418,10,4,2024-10-14,False,False,False,0.6229508196721312,0.3561847988077496,0.014903129657228018,0.005961251862891207,Shoulder,Monday,October
2024-10-15 00:00:00,92,428,4,2,526,96,169,6,1,272,25.4,92,3,5.0,798,False,0,188,597,10,3,2024-10-15,False,False,False,0.7481203007518797,0.23558897243107768,0.012531328320802004,0.0037593984962406013,Off-Peak,Tuesday,October
2024-10-15 01:00:00,114,366,4,1,485,104,138,3,2,247,25.1,94,53,5.0,732,False,1,218,504,7,3,2024-10-15,False,False,False,0.6885245901639344,0.2978142076502732,0.009562841530054645,0.004098360655737705,Off-Peak,Tuesday,October
2024-10-15 02:00:00,112,345,3,1,461,91,107,5,0,203,24.8,97,53,4.8,664,False,2,203,452,8,1,2024-10-15,False,False,False,0.6807228915662651,0.3057228915662651,0.012048192771084338,0.0015060240963855422,Off-Peak,Tuesday,October
2024-10-15 03:00:00,77,337,5,2,421,82,114,8,1,205,24.8,98,51,3.6,626,False,3,159,451,13,3,2024-10-15,False,False,False,0.7204472843450479,0.2539936102236422,0.020766773162939296,0.004792332268370607,Off-Peak,Tuesday,October
2024-10-15 04:00:00,71,293,4,0,368,111,141,6,1,259,24.7,98,3,1.4,627,False,4,182,434,10,1,2024-10-15,False,False,False,0.6921850079744817,0.2902711323763955,0.01594896331738437,0.001594896331738437,Off-Peak,Tuesday,October
2024-10-15 05:00:00,87,226,3,0,316,119,139,6,2,266,24.6,98,3,0.4,582,False,5,206,365,9,2,2024-10-15,False,False,False,0.627147766323024,0.3539518900343643,0.015463917525773196,0.003436426116838488,Shoulder,Tuesday,October
2024-10-15 06:00:00,95,247,4,1,347,89,147,3,0,239,24.8,97,3,2.0,586,False,6,184,394,7,1,2024-10-15,False,False,False,0.6723549488054608,0.31399317406143346,0.011945392491467578,0.0017064846416382253,Shoulder,Tuesday,October
2024-10-15 07:00:00,93,350,8,2,453,99,105,6,1,211,24.5,94,63,9.6,664,False,7,192,455,14,3,2024-10-15,False,False,False,0.6852409638554217,0.2891566265060241,0.02108433734939759,0.004518072289156626,Peak,Tuesday,October
2024-10-15 08:00:00,70,308,5,0,383,117,150,4,1,272,25.1,94,65,5.4,655,False,8,187,458,9,1,2024-10-15,False,False,False,0.6992366412213741,0.28549618320610687,0.013740458015267175,0.0015267175572519084,Peak,Tuesday,October
2024-10-15 09:00:00,88,246,4,2,340,120,155,4,5,284,25.4,89,63,9.1,624,False,9,208,401,8,7,2024-10-15,False,False,False,0.6426282051282052,0.3333333333333333,0.01282051282051282,0.011217948717948718,Shoulder,Tuesday,October
2024-10-15 10:00:00,98,378,6,1,483,98,114,5,2,219,25.7,87,53,11.6,702,False,10,196,492,11,3,2024-10-15,False,False,False,0.7008547008547008,0.2792022792022792,0.01566951566951567,0.004273504273504274,Shoulder,Tuesday,October
2024-10-15 11:00:00,75,358,6,2,441,123,161,5,0,289,26.9,83,51,4.3,730,False,11,198,519,11,2,2024-10-15,False,False,False,0.7109589041095891,0.27123287671232876,0.015068493150684932,0.0027397260273972603,Peak,Tuesday,October
2024-10-15 12:00:00,97,407,4,1,509,87,151,5,2,245,28.1,79,51,5.9,754,False,12,184,558,9,3,2024-10-15,False,False,False,0.7400530503978779,0.2440318302387268,0.011936339522546418,0.003978779840848806,Peak,Tuesday,October
2024-10-15 13:00:00,103,222,6,1,332,115,159,5,1,280,29.0,77,51,8.4,612,False,13,218,381,11,2,2024-10-15,False,False,False,0.6225490196078431,0.3562091503267974,0.017973856209150325,0.0032679738562091504,Peak,Tuesday,October
2024-10-15 14:00:00,84,272,5,0,361,108,147,2,2,259,28.9,78,51,10.3,620,False,14,192,419,7,2,2024-10-15,False,False,False,0.6758064516129032,0.3096774193548387,0.01129032258064516,0.0032258064516129032,Peak,Tuesday,October
2024-10-15 15:00:00,137,410,2,2,551,118,164,5,1,288,28.8,78,51,9.3,839,False,15,255,574,7,3,2024-10-15,False,False,False,0.6841477949940405,0.3039332538736591,0.00834326579261025,0.003575685339690107,Peak,Tuesday,October
2024-10-15 16:00:00,95,343,2,1,441,143,120,4,0,267,28.8,75,2,9.7,708,False,16,238,463,6,1,2024-10-15,False,False,False,0.653954802259887,0.3361581920903955,0.00847457627118644,0.0014124293785310734,Peak,Tuesday,October
2024-10-15 17:00:00,52,384,4,1,441,107,169,5,1,282,28.3,76,3,10.3,723,False,17,159,553,9,2,2024-10-15,False,False,False,0.7648686030428768,0.21991701244813278,0.012448132780082987,0.0027662517289073307,Peak,Tuesday,October
2024-10-15 18:00:00,112,388,6,1,507,65,143,3,1,212,27.8,78,3,8.8,719,False,18,177,531,9,2,2024-10-15,False,False,False,0.7385257301808067,0.24617524339360222,0.012517385257301807,0.0027816411682892906,Peak,Tuesday,October
2024-10-15 19:00:00,117,303,4,1,425,82,84,5,0,171,26.8,83,2,4.9,596,False,19,199,387,9,1,2024-10-15,False,False,False,0.6493288590604027,0.3338926174496644,0.015100671140939598,0.0016778523489932886,Peak,Tuesday,October
2024-10-15 20:00:00,109,343,5,0,457,111,172,4,3,290,26.4,87,3,4.2,747,False,20,220,515,9,3,2024-10-15,False,False,False,0.6894243641231593,0.29451137884872824,0.012048192771084338,0.004016064257028112,Shoulder,Tuesday,October
2024-10-15 21:00:00,93,277,4,2,376,42,88,5,4,139,26.7,79,3,7.8,515,False,21,135,365,9,6,2024-10-15,False,False,False,0.7087378640776699,0.2621359223300971,0.017475728155339806,0.011650485436893204,Shoulder,Tuesday,October
2024-10-15 22:00:00,91,476,4,0,571,120,98,5,1,224,26.6,80,3,9.9,795,False,22,211,574,9,1,2024-10-15,False,False,False,0.7220125786163522,0.26540880503144654,0.011320754716981131,0.0012578616352201257,Shoulder,Tuesday,October
2024-10-15 23:00:00,73,379,5,1,458,115,111,7,2,235,26.4,82,3,12.1,693,False,23,188,490,12,3,2024-10-15,False,False,False,0.7070707070707071,0.2712842712842713,0.017316017316017316,0.004329004329004329,Shoulder,Tuesday,October
2024-10-16 00:00:00,102,474,5,0,581,94,153,4,2,253,26.2,79,3,10.1,834,False,0,196,627,9,2,2024-10-16,False,False,False,0.7517985611510791,0.23501199040767387,0.01079136690647482,0.002398081534772182,Off-Peak,Wednesday,October
2024-10-16 01:00:00,88,414,3,2,507,123,199,5,2,329,26.0,77,3,10.3,836,False,1,211,613,8,4,2024-10-16,False,False,False,0.7332535885167464,0.25239234449760767,0.009569377990430622,0.004784688995215311,Off-Peak,Wednesday,October
2024-10-16 02:00:00,100,374,5,0,479,93,125,4,1,223,25.7,76,51,11.6,702,False,2,193,499,9,1,2024-10-16,False,False,False,0.7108262108262108,0.27492877492877493,0.01282051282051282,0.0014245014245014246,Off-Peak,Wednesday,October
2024-10-16 03:00:00,136,514,7,3,660,92,131,5,0,228,25.2,79,51,11.2,888,False,3,228,645,12,3,2024-10-16,False,False,False,0.7263513513513513,0.25675675675675674,0.013513513513513514,0.0033783783783783786,Off-Peak,Wednesday,October
2024-10-16 04:00:00,114,562,6,3,685,117,138,4,4,263,24.7,81,3,9.6,948,False,4,231,700,10,7,2024-10-16,False,False,False,0.7383966244725738,0.24367088607594936,0.010548523206751054,0.007383966244725738,Off-Peak,Wednesday,October
2024-10-16 05:00:00,119,355,5,2,481,101,161,6,2,270,24.8,81,3,9.6,751,False,5,220,516,11,4,2024-10-16,False,False,False,0.6870838881491345,0.2929427430093209,0.014647137150466045,0.005326231691078562,Shoulder,Wednesday,October
2024-10-16 06:00:00,98,422,4,2,526,88,135,5,1,229,24.9,84,3,11.3,755,False,6,186,557,9,3,2024-10-16,False,False,False,0.7377483443708609,0.24635761589403973,0.011920529801324504,0.003973509933774834,Shoulder,Wednesday,October
2024-10-16 07:00:00,108,400,4,1,513,86,153,5,2,246,25.0,88,3,10.3,759,False,7,194,553,9,3,2024-10-16,False,False,False,0.7285902503293807,0.25559947299077734,0.011857707509881422,0.003952569169960474,Peak,Wednesday,October
2024-10-16 08:00:00,111,556,4,2,673,98,112,5,3,218,25.7,88,3,12.6,891,False,8,209,668,9,5,2024-10-16,False,False,False,0.7497194163860831,0.2345679012345679,0.010101010101010102,0.005611672278338945,Peak,Wednesday,October
2024-10-16 09:00:00,89,404,6,1,500,119,183,7,1,310,27.2,81,3,7.7,810,False,9,208,587,13,2,2024-10-16,False,False,False,0.7246913580246913,0.25679012345679014,0.016049382716049384,0.0024691358024691358,Shoulder,Wednesday,October
2024-10-16 10:00:00,111,351,3,2,467,81,108,7,0,196,28.6,79,2,9.2,663,False,10,192,459,10,2,2024-10-16,False,False,False,0.6923076923076923,0.2895927601809955,0.015082956259426848,0.0030165912518853697,Shoulder,Wednesday,October
2024-10-16 11:00:00,59,431,6,2,498,89,173,4,4,270,29.8,74,1,9.7,768,False,11,148,604,10,6,2024-10-16,False,False,False,0.7864583333333334,0.19270833333333334,0.013020833333333334,0.0078125,Peak,Wednesday,October
2024-10-16 12:00:00,111,479,5,3,598,129,145,4,2,280,30.4,68,51,11.4,878,False,12,240,624,9,5,2024-10-16,False,False,False,0.7107061503416856,0.2733485193621868,0.010250569476082005,0.0056947608200455585,Peak,Wednesday,October
2024-10-16 13:00:00,78,647,6,0,731,74,142,5,1,222,30.7,67,3,10.6,953,False,13,152,789,11,1,2024-10-16,False,False,False,0.8279118572927597,0.15949632738719832,0.011542497376705142,0.001049317943336831,Peak,Wednesday,October
2024-10-16 14:00:00,84,471,8,1,564,94,168,5,2,269,30.6,68,3,11.1,833,False,14,178,639,13,3,2024-10-16,False,False,False,0.7671068427370948,0.21368547418967587,0.015606242496998799,0.003601440576230492,Peak,Wednesday,October
2024-10-16 15:00:00,71,288,6,2,367,106,159,8,0,273,31.0,66,3,9.8,640,False,15,177,447,14,2,2024-10-16,False,False,False,0.6984375,0.2765625,0.021875,0.003125,Peak,Wednesday,October
2024-10-16 16:00:00,121,400,8,1,530,133,143,7,2,285,31.0,68,3,10.0,815,False,16,254,543,15,3,2024-10-16,False,False,False,0.6662576687116565,0.3116564417177914,0.018404907975460124,0.0036809815950920245,Peak,Wednesday,October
2024-10-16 17:00:00,106,511,7,0,624,69,137,6,0,212,30.3,72,3,9.0,836,False,17,175,648,13,0,2024-10-16,False,False,False,0.7751196172248804,0.20933014354066987,0.01555023923444976,0.0,Peak,Wednesday,October
2024-10-16 18:00:00,81,410,5,4,500,118,128,7,2,255,29.5,77,3,8.7,755,False,18,199,538,12,6,2024-10-16,False,False,False,0.7125827814569536,0.2635761589403974,0.015894039735099338,0.007947019867549669,Peak,Wednesday,October
2024-10-16 19:00:00,121,391,6,1,519,66,156,3,2,227,28.3,82,3,9.4,746,False,19,187,547,9,3,2024-10-16,False,False,False,0.7332439678284183,0.25067024128686327,0.012064343163538873,0.004021447721179625,Peak,Wednesday,October
2024-10-16 20:00:00,111,357,4,0,472,69,161,5,0,235,27.8,83,3,7.4,707,False,20,180,518,9,0,2024-10-16,False,False,False,0.7326732673267327,0.2545968882602546,0.01272984441301273,0.0,Shoulder,Wednesday,October
2024-10-16 21:00:00,106,436,4,2,548,128,96,4,0,228,27.4,81,3,4.4,776,False,21,234,532,8,2,2024-10-16,False,False,False,0.6855670103092784,0.3015463917525773,0.010309278350515464,0.002577319587628866,Shoulder,Wednesday,October
2024-10-16 22:00:00,91,591,4,1,687,80,118,6,1,205,27.0,85,3,5.2,892,False,22,171,709,10,2,2024-10-16,False,False,False,0.7948430493273543,0.19170403587443946,0.011210762331838564,0.002242152466367713,Shoulder,Wednesday,October
2024-10-16 23:00:00,107,401,5,1,514,88,164,5,0,257,26.2,92,3,3.2,771,False,23,195,565,10,1,2024-10-16,False,False,False,0.7328145265888456,0.2529182879377432,0.01297016861219196,0.0012970168612191958,Shoulder,Wednesday,October
2024-10-17 00:00:00,74,495,2,1,572,112,109,3,1,225,25.7,91,3,5.0,797,False,0,186,604,5,2,2024-10-17,False,False,False,0.7578419071518193,0.23337515683814303,0.006273525721455458,0.002509410288582183,Off-Peak,Thursday,October
2024-10-17 01:00:00,66,365,1,3,435,85,172,4,1,262,25.6,89,3,6.5,697,False,1,151,537,5,4,2024-10-17,False,False,False,0.7704447632711621,0.21664275466284075,0.007173601147776184,0.005738880918220947,Off-Peak,Thursday,October
2024-10-17 02:00:00,58,362,2,4,426,118,153,5,0,276,25.4,89,3,3.4,702,False,2,176,515,7,4,2024-10-17,False,False,False,0.7336182336182336,0.25071225071225073,0.009971509971509971,0.005698005698005698,Off-Peak,Thursday,October
2024-10-17 03:00:00,71,462,3,2,538,82,74,6,0,162,25.3,89,3,3.8,700,False,3,153,536,9,2,2024-10-17,False,False,False,0.7657142857142857,0.21857142857142858,0.012857142857142857,0.002857142857142857,Off-Peak,Thursday,October
2024-10-17 04:00:00,83,288,4,1,376,99,115,4,3,221,25.2,88,3,6.7,597,False,4,182,403,8,4,2024-10-17,False,False,False,0.6750418760469011,0.304857621440536,0.01340033500837521,0.006700167504187605,Off-Peak,Thursday,October
2024-10-17 05:00:00,90,277,2,0,369,115,159,5,2,281,24.4,88,3,3.7,650,False,5,205,436,7,2,2024-10-17,False,False,False,0.6707692307692308,0.3153846153846154,0.010769230769230769,0.003076923076923077,Shoulder,Thursday,October
2024-10-17 06:00:00,74,454,2,1,531,133,159,6,0,298,24.4,85,1,4.8,829,False,6,207,613,8,1,2024-10-17,False,False,False,0.7394451145958987,0.24969843184559712,0.009650180940892641,0.0012062726176115801,Shoulder,Thursday,October
2024-10-17 07:00:00,78,409,2,1,490,74,147,5,4,230,23.4,91,2,5.3,720,False,7,152,556,7,5,2024-10-17,False,False,False,0.7722222222222223,0.2111111111111111,0.009722222222222222,0.006944444444444444,Peak,Thursday,October
2024-10-17 08:00:00,68,223,2,3,296,122,106,4,2,234,25.8,86,3,10.1,530,False,8,190,329,6,5,2024-10-17,False,False,False,0.620754716981132,0.3584905660377358,0.011320754716981131,0.009433962264150943,Peak,Thursday,October
2024-10-17 09:00:00,80,306,3,1,390,103,157,5,2,267,25.6,91,55,3.5,657,False,9,183,463,8,3,2024-10-17,False,False,False,0.7047184170471842,0.2785388127853881,0.0121765601217656,0.0045662100456621,Shoulder,Thursday,October
2024-10-17 10:00:00,65,418,1,1,485,86,166,5,0,257,26.5,87,51,6.2,742,False,10,151,584,6,1,2024-10-17,False,False,False,0.7870619946091644,0.20350404312668463,0.008086253369272238,0.0013477088948787063,Shoulder,Thursday,October
2024-10-17 11:00:00,47,379,1,0,427,116,197,6,1,320,28.1,80,3,4.8,747,False,11,163,576,7,1,2024-10-17,False,False,False,0.7710843373493976,0.2182061579651941,0.009370816599732263,0.0013386880856760374,Peak,Thursday,October
2024-10-17 12:00:00,71,257,2,1,331,90,158,4,4,256,28.8,75,3,7.1,587,False,12,161,415,6,5,2024-10-17,False,False,False,0.706984667802385,0.27427597955706984,0.010221465076660987,0.008517887563884156,Peak,Thursday,October
2024-10-17 13:00:00,69,421,2,3,495,145,161,5,1,312,29.0,73,3,6.0,807,False,13,214,582,7,4,2024-10-17,False,False,False,0.7211895910780669,0.265179677819083,0.008674101610904586,0.004956629491945477,Peak,Thursday,October
2024-10-17 14:00:00,72,432,1,1,506,81,156,5,0,242,29.8,71,3,6.8,748,False,14,153,588,6,1,2024-10-17,False,False,False,0.786096256684492,0.20454545454545456,0.008021390374331552,0.001336898395721925,Peak,Thursday,October
2024-10-17 15:00:00,81,503,2,1,587,125,107,3,1,236,30.1,68,3,8.5,823,False,15,206,610,5,2,2024-10-17,False,False,False,0.741190765492102,0.2503037667071689,0.006075334143377886,0.002430133657351154,Peak,Thursday,October
2024-10-17 16:00:00,68,466,2,1,537,85,195,6,3,289,29.7,69,2,11.1,826,False,16,153,661,8,4,2024-10-17,False,False,False,0.8002421307506054,0.18523002421307505,0.009685230024213076,0.004842615012106538,Peak,Thursday,October
2024-10-17 17:00:00,70,423,2,0,495,110,164,3,2,279,29.2,74,2,9.7,774,False,17,180,587,5,2,2024-10-17,False,False,False,0.7583979328165374,0.23255813953488372,0.006459948320413436,0.002583979328165375,Peak,Thursday,October
2024-10-17 18:00:00,68,358,2,0,428,72,117,7,0,196,28.7,77,1,7.8,624,False,18,140,475,9,0,2024-10-17,False,False,False,0.7612179487179487,0.22435897435897437,0.014423076923076924,0.0,Peak,Thursday,October
2024-10-17 19:00:00,85,440,2,3,530,136,190,5,1,332,27.6,84,3,3.5,862,False,19,221,630,7,4,2024-10-17,False,False,False,0.7308584686774942,0.25638051044083526,0.008120649651972157,0.004640371229698376,Peak,Thursday,October
2024-10-17 20:00:00,70,439,1,1,511,89,151,3,1,244,27.4,85,3,5.1,755,False,20,159,590,4,2,2024-10-17,False,False,False,0.7814569536423841,0.21059602649006623,0.005298013245033113,0.0026490066225165563,Shoulder,Thursday,October
2024-10-17 21:00:00,76,324,3,2,405,102,188,5,2,297,26.2,85,51,3.9,702,False,21,178,512,8,4,2024-10-17,False,False,False,0.7293447293447294,0.2535612535612536,0.011396011396011397,0.005698005698005698,Shoulder,Thursday,October
2024-10-17 22:00:00,69,317,3,1,390,124,184,6,1,315,26.1,85,3,6.0,705,False,22,193,501,9,2,2024-10-17,False,False,False,0.7106382978723405,0.27375886524822696,0.01276595744680851,0.0028368794326241137,Shoulder,Thursday,October
2024-10-17 23:00:00,75,422,2,2,501,90,150,8,3,251,25.6,88,3,2.7,752,False,23,165,572,10,5,2024-10-17,False,False,False,0.7606382978723404,0.21941489361702127,0.013297872340425532,0.006648936170212766,Shoulder,Thursday,October
2024-10-18 00:00:00,190,402,9,1,602,147,618,5,2,772,25.5,87,3,5.8,1374,False,0,337,1020,14,3,2024-10-18,False,False,True,0.74235807860262,0.24526928675400292,0.010189228529839884,0.002183406113537118,Off-Peak,Friday,October
2024-10-18 01:00:00,146,483,8,4,641,166,512,8,1,687,25.2,88,3,4.0,1328,False,1,312,995,16,5,2024-10-18,False,False,False,0.7492469879518072,0.23493975903614459,0.012048192771084338,0.0037650602409638554,Off-Peak,Friday,October
2024-10-18 02:00:00,158,483,7,1,649,147,490,6,3,646,25.0,89,3,4.5,1295,False,2,305,973,13,4,2024-10-18,False,False,False,0.7513513513513513,0.23552123552123552,0.010038610038610039,0.003088803088803089,Off-Peak,Friday,October
2024-10-18 03:00:00,170,462,10,3,645,108,549,8,1,666,24.7,92,3,2.7,1311,False,3,278,1011,18,4,2024-10-18,False,False,False,0.7711670480549199,0.2120518688024409,0.013729977116704805,0.0030511060259344014,Off-Peak,Friday,October
2024-10-18 04:00:00,142,485,7,3,637,170,548,7,2,727,24.6,94,2,1.7,1364,False,4,312,1033,14,5,2024-10-18,False,False,False,0.7573313782991202,0.2287390029325513,0.010263929618768328,0.0036656891495601175,Off-Peak,Friday,October
2024-10-18 05:00:00,192,464,10,1,667,144,499,4,1,648,24.4,93,2,3.5,1315,False,5,336,963,14,2,2024-10-18,False,False,False,0.7323193916349809,0.2555133079847909,0.01064638783269962,0.001520912547528517,Shoulder,Friday,October
2024-10-18 06:00:00,123,659,10,2,794,112,520,8,2,642,24.2,94,1,2.4,1436,False,6,235,1179,18,4,2024-10-18,False,False,True,0.8210306406685237,0.16364902506963788,0.012534818941504178,0.002785515320334262,Shoulder,Friday,October
2024-10-18 07:00:00,165,356,6,1,528,138,503,6,3,650,24.2,96,61,10.5,1178,False,7,303,859,12,4,2024-10-18,False,False,False,0.7292020373514432,0.25721561969439727,0.010186757215619695,0.003395585738539898,Peak,Friday,October
2024-10-18 08:00:00,136,369,11,3,519,96,520,7,1,624,24.8,94,51,6.9,1143,False,8,232,889,18,4,2024-10-18,False,False,False,0.7777777777777778,0.20297462817147857,0.015748031496062992,0.003499562554680665,Peak,Friday,October
2024-10-18 09:00:00,104,476,9,2,591,147,370,6,3,526,25.7,83,3,6.9,1117,False,9,251,846,15,5,2024-10-18,False,False,False,0.7573858549686661,0.22470904207699194,0.01342882721575649,0.004476275738585497,Shoulder,Friday,October
2024-10-18 10:00:00,145,473,8,4,630,74,568,7,0,649,27.4,73,3,6.0,1279,False,10,219,1041,15,4,2024-10-18,False,False,False,0.8139171227521501,0.1712275215011728,0.011727912431587178,0.003127443315089914,Shoulder,Friday,October
2024-10-18 11:00:00,170,509,8,3,690,132,432,7,1,572,28.8,69,1,4.5,1262,False,11,302,941,15,4,2024-10-18,False,False,False,0.7456418383518225,0.2393026941362916,0.011885895404120444,0.003169572107765452,Peak,Friday,October
2024-10-18 12:00:00,212,423,9,4,648,125,455,6,1,587,30.4,64,2,2.2,1235,False,12,337,878,15,5,2024-10-18,False,False,False,0.7109311740890688,0.2728744939271255,0.012145748987854251,0.004048582995951417,Peak,Friday,October
2024-10-18 13:00:00,202,557,10,2,771,139,453,7,1,600,30.9,62,2,6.7,1371,False,13,341,1010,17,3,2024-10-18,False,False,False,0.7366885485047411,0.2487235594456601,0.012399708242159009,0.002188183807439825,Peak,Friday,October
2024-10-18 14:00:00,95,441,9,3,548,142,608,8,2,760,30.9,64,2,8.3,1308,False,14,237,1049,17,5,2024-10-18,False,False,False,0.8019877675840978,0.1811926605504587,0.012996941896024464,0.00382262996941896,Peak,Friday,October
2024-10-18 15:00:00,175,493,6,1,675,135,353,7,2,497,30.6,66,3,9.8,1172,False,15,310,846,13,3,2024-10-18,False,False,False,0.7218430034129693,0.2645051194539249,0.011092150170648464,0.002559726962457338,Peak,Friday,October
2024-10-18 16:00:00,214,521,10,2,747,120,435,7,1,563,29.9,70,3,10.0,1310,False,16,334,956,17,3,2024-10-18,False,False,False,0.7297709923664122,0.2549618320610687,0.012977099236641221,0.0022900763358778627,Peak,Friday,October
2024-10-18 17:00:00,126,466,9,1,602,124,268,8,2,402,29.3,71,3,8.1,1004,False,17,250,734,17,3,2024-10-18,False,False,False,0.7310756972111554,0.24900398406374502,0.01693227091633466,0.00298804780876494,Peak,Friday,October
2024-10-18 18:00:00,170,266,8,2,446,125,377,7,1,510,28.9,71,3,6.9,956,False,18,295,643,15,3,2024-10-18,False,False,False,0.6725941422594143,0.30857740585774057,0.015690376569037656,0.0031380753138075313,Peak,Friday,October
2024-10-18 19:00:00,216,252,5,4,477,151,558,7,3,719,28.1,75,3,7.7,1196,False,19,367,810,12,7,2024-10-18,False,False,False,0.677257525083612,0.3068561872909699,0.010033444816053512,0.005852842809364548,Peak,Friday,October
2024-10-18 20:00:00,215,388,6,2,611,136,489,6,1,632,27.7,77,3,5.9,1243,False,20,351,877,12,3,2024-10-18,False,False,False,0.7055510860820595,0.2823813354786806,0.009654062751407884,0.002413515687851971,Shoulder,Friday,October
2024-10-18 21:00:00,187,515,8,1,711,100,424,8,1,533,26.7,85,3,2.7,1244,False,21,287,939,16,2,2024-10-18,False,False,False,0.7548231511254019,0.23070739549839228,0.012861736334405145,0.001607717041800643,Shoulder,Friday,October
2024-10-18 22:00:00,182,573,8,3,766,139,505,5,1,650,26.4,84,3,3.3,1416,False,22,321,1078,13,4,2024-10-18,False,False,True,0.7612994350282486,0.2266949152542373,0.009180790960451978,0.002824858757062147,Shoulder,Friday,October
2024-10-18 23:00:00,219,600,9,2,830,126,474,7,1,608,26.0,84,3,5.8,1438,False,23,345,1074,16,3,2024-10-18,False,False,True,0.7468706536856745,0.23991655076495133,0.011126564673157162,0.002086230876216968,Shoulder,Friday,October
2024-10-19 00:00:00,194,709,6,3,912,98,459,5,0,562,25.5,88,3,3.5,1474,True,0,292,1168,11,3,2024-10-19,False,False,True,0.7924016282225237,0.19810040705563092,0.007462686567164179,0.0020352781546811396,Off-Peak,Saturday,October
2024-10-19 01:00:00,197,500,8,2,707,70,349,5,0,424,25.4,87,3,3.6,1131,True,1,267,849,13,2,2024-10-19,False,False,False,0.7506631299734748,0.23607427055702918,0.011494252873563218,0.0017683465959328027,Off-Peak,Saturday,October
2024-10-19 02:00:00,184,403,8,2,597,95,552,4,0,651,25.2,87,3,4.0,1248,True,2,279,955,12,2,2024-10-19,False,False,False,0.7652243589743589,0.22355769230769232,0.009615384615384616,0.0016025641025641025,Off-Peak,Saturday,October
2024-10-19 03:00:00,157,573,11,4,745,92,360,5,0,457,24.8,89,3,3.1,1202,True,3,249,933,16,4,2024-10-19,False,False,False,0.7762063227953411,0.20715474209650583,0.013311148086522463,0.0033277870216306157,Off-Peak,Saturday,October
2024-10-19 04:00:00,182,455,9,2,648,69,472,3,2,546,24.9,87,3,4.2,1194,True,4,251,927,12,4,2024-10-19,False,False,False,0.7763819095477387,0.2102177554438861,0.010050251256281407,0.0033500837520938024,Off-Peak,Saturday,October
2024-10-19 05:00:00,211,493,7,2,713,107,436,4,0,547,24.4,90,3,3.9,1260,True,5,318,929,11,2,2024-10-19,False,False,False,0.7373015873015873,0.2523809523809524,0.00873015873015873,0.0015873015873015873,Shoulder,Saturday,October
2024-10-19 06:00:00,159,250,6,2,417,100,468,4,0,572,24.4,91,3,4.6,989,True,6,259,718,10,2,2024-10-19,False,False,False,0.7259858442871587,0.26188068756319516,0.010111223458038422,0.0020222446916076846,Shoulder,Saturday,October
2024-10-19 07:00:00,213,454,8,3,678,116,365,3,0,484,24.3,91,3,5.0,1162,True,7,329,819,11,3,2024-10-19,False,False,False,0.7048192771084337,0.28313253012048195,0.00946643717728055,0.0025817555938037868,Peak,Saturday,October
2024-10-19 08:00:00,174,401,9,3,587,94,368,5,1,468,25.5,88,2,5.6,1055,True,8,268,769,14,4,2024-10-19,False,False,False,0.728909952606635,0.25402843601895736,0.013270142180094787,0.0037914691943127963,Peak,Saturday,October
2024-10-19 09:00:00,167,485,14,4,670,96,409,4,0,509,27.4,82,51,3.6,1179,True,9,263,894,18,4,2024-10-19,False,False,False,0.7582697201017812,0.22307039864291772,0.015267175572519083,0.0033927056827820186,Shoulder,Saturday,October
2024-10-19 10:00:00,178,312,11,2,503,90,475,4,1,570,27.6,82,51,3.8,1073,True,10,268,787,15,3,2024-10-19,False,False,False,0.7334575955265611,0.24976700838769805,0.013979496738117428,0.0027958993476234857,Shoulder,Saturday,October
2024-10-19 11:00:00,203,636,8,3,850,108,396,2,1,507,28.8,76,2,2.1,1357,True,11,311,1032,10,4,2024-10-19,False,False,False,0.7605011053795137,0.22918201915991157,0.007369196757553427,0.0029476787030213707,Peak,Saturday,October
2024-10-19 12:00:00,218,534,8,2,762,72,390,5,3,470,30.1,74,3,2.5,1232,True,12,290,924,13,5,2024-10-19,False,False,False,0.75,0.2353896103896104,0.010551948051948052,0.004058441558441558,Peak,Saturday,October
2024-10-19 13:00:00,200,394,7,2,603,98,498,4,0,600,31.0,71,3,4.5,1203,True,13,298,892,11,2,2024-10-19,False,False,False,0.741479634247714,0.24771404821280132,0.00914380714879468,0.0016625103906899418,Peak,Saturday,October
2024-10-19 14:00:00,163,488,10,2,663,95,336,6,1,438,31.2,68,3,7.3,1101,True,14,258,824,16,3,2024-10-19,False,False,False,0.7484105358764759,0.23433242506811988,0.014532243415077202,0.0027247956403269754,Peak,Saturday,October
2024-10-19 15:00:00,201,300,7,1,509,123,460,7,0,590,29.1,77,53,11.4,1099,True,15,324,760,14,1,2024-10-19,False,False,False,0.6915377616014559,0.2948134667879891,0.012738853503184714,0.0009099181073703367,Peak,Saturday,October
2024-10-19 16:00:00,190,408,9,2,609,87,427,4,0,518,29.4,75,3,8.4,1127,True,16,277,835,13,2,2024-10-19,False,False,False,0.7409050576752441,0.24578527062999111,0.011535048802129548,0.001774622892635315,Peak,Saturday,October
2024-10-19 17:00:00,187,328,5,5,525,113,445,4,0,562,28.8,74,3,7.1,1087,True,17,300,773,9,5,2024-10-19,False,False,False,0.7111315547378105,0.27598896044158233,0.00827966881324747,0.004599816007359705,Peak,Saturday,October
2024-10-19 18:00:00,191,664,8,4,867,114,452,4,1,571,28.5,76,3,5.5,1438,True,18,305,1116,12,5,2024-10-19,False,False,True,0.7760778859527121,0.2121001390820584,0.008344923504867872,0.0034770514603616135,Peak,Saturday,October
2024-10-19 19:00:00,193,434,6,3,636,85,357,4,0,446,27.7,81,3,5.0,1082,True,19,278,791,10,3,2024-10-19,False,False,False,0.7310536044362292,0.25693160813308685,0.009242144177449169,0.0027726432532347504,Peak,Saturday,October
2024-10-19 20:00:00,147,727,4,2,880,117,502,4,2,625,27.3,84,3,6.2,1505,True,20,264,1229,8,4,2024-10-19,False,False,True,0.8166112956810632,0.17541528239202658,0.0053156146179402,0.0026578073089701,Shoulder,Saturday,October
2024-10-19 21:00:00,191,318,10,1,520,61,439,5,0,505,27.6,84,3,7.8,1025,True,21,252,757,15,1,2024-10-19,False,False,False,0.7385365853658536,0.24585365853658536,0.014634146341463415,0.000975609756097561,Shoulder,Saturday,October
2024-10-19 22:00:00,101,563,7,4,675,100,245,6,1,352,27.2,87,3,7.9,1027,True,22,201,808,13,5,2024-10-19,False,False,False,0.7867575462512172,0.19571567672833495,0.012658227848101266,0.004868549172346641,Shoulder,Saturday,October
2024-10-19 23:00:00,196,544,8,2,750,117,605,3,0,725,26.7,89,3,8.4,1475,True,23,313,1149,11,2,2024-10-19,False,False,True,0.7789830508474577,0.2122033898305085,0.007457627118644068,0.0013559322033898306,Shoulder,Saturday,October
2024-10-20 00:00:00,190,493,8,1,692,155,657,9,6,827,26.3,89,3,9.5,1519,True,0,345,1150,17,7,2024-10-20,False,False,True,0.7570770243581304,0.2271231073074391,0.01119157340355497,0.004608294930875576,Off-Peak,Sunday,October
2024-10-20 01:00:00,91,669,6,1,767,269,475,7,2,753,26.1,88,3,9.0,1520,True,1,360,1144,13,3,2024-10-20,False,False,True,0.7526315789473684,0.23684210526315788,0.008552631578947369,0.001973684210526316,Off-Peak,Sunday,October
2024-10-20 02:00:00,113,583,4,0,700,179,538,6,2,725,25.5,90,3,6.2,1425,True,2,292,1121,10,2,2024-10-20,False,False,True,0.7866666666666666,0.20491228070175438,0.007017543859649123,0.0014035087719298245,Off-Peak,Sunday,October
2024-10-20 03:00:00,162,716,7,2,887,184,513,5,4,706,23.6,94,51,15.9,1593,True,3,346,1229,12,6,2024-10-20,False,False,True,0.7715003138731952,0.21720025109855617,0.007532956685499058,0.003766478342749529,Off-Peak,Sunday,October
2024-10-20 04:00:00,150,638,3,1,792,128,539,9,1,677,23.5,92,53,13.0,1469,True,4,278,1177,12,2,2024-10-20,False,False,True,0.8012253233492171,0.18924438393464943,0.008168822328114363,0.0013614703880190605,Off-Peak,Sunday,October
2024-10-20 05:00:00,122,370,7,1,500,107,672,7,1,787,24.1,94,51,4.4,1287,True,5,229,1042,14,2,2024-10-20,False,False,False,0.8096348096348096,0.17793317793317792,0.010878010878010878,0.001554001554001554,Shoulder,Sunday,October
2024-10-20 06:00:00,117,550,5,2,674,214,482,6,2,704,24.3,94,51,5.6,1378,True,6,331,1032,11,4,2024-10-20,False,False,True,0.7489114658925979,0.24020319303338172,0.007982583454281567,0.002902757619738752,Shoulder,Sunday,October
2024-10-20 07:00:00,183,533,7,1,724,177,471,10,3,661,24.2,97,3,3.3,1385,True,7,360,1004,17,4,2024-10-20,False,False,True,0.7249097472924187,0.259927797833935,0.01227436823104693,0.002888086642599278,Peak,Sunday,October
2024-10-20 08:00:00,109,550,7,0,666,205,536,7,3,751,25.0,94,3,2.1,1417,True,8,314,1086,14,3,2024-10-20,False,False,True,0.766407904022583,0.22159491884262528,0.009880028228652082,0.002117148906139732,Peak,Sunday,October
2024-10-20 09:00:00,86,555,7,2,650,262,452,8,2,724,25.1,87,51,6.0,1374,True,9,348,1007,15,4,2024-10-20,False,False,True,0.7328966521106259,0.25327510917030566,0.010917030567685589,0.002911208151382824,Shoulder,Sunday,October
2024-10-20 10:00:00,121,519,8,1,649,188,428,9,2,627,26.0,85,3,5.2,1276,True,10,309,947,17,3,2024-10-20,False,False,False,0.7421630094043887,0.2421630094043887,0.013322884012539185,0.0023510971786833857,Shoulder,Sunday,October
2024-10-20 11:00:00,185,575,5,1,766,184,369,8,3,564,27.5,78,3,4.8,1330,True,11,369,944,13,4,2024-10-20,False,False,False,0.7097744360902256,0.2774436090225564,0.009774436090225564,0.0030075187969924814,Peak,Sunday,October
2024-10-20 12:00:00,157,545,7,1,710,166,644,8,4,822,29.3,71,3,2.5,1532,True,12,323,1189,15,5,2024-10-20,False,False,True,0.7761096605744126,0.2108355091383812,0.0097911227154047,0.0032637075718015664,Peak,Sunday,October
2024-10-20 13:00:00,149,577,5,1,732,113,400,10,1,524,29.5,70,3,6.3,1256,True,13,262,977,15,2,2024-10-20,False,False,False,0.7778662420382165,0.2085987261146497,0.01194267515923567,0.0015923566878980893,Peak,Sunday,October
2024-10-20 14:00:00,75,554,6,2,637,194,471,8,1,674,30.3,65,3,9.2,1311,True,14,269,1025,14,3,2024-10-20,False,False,False,0.7818459191456903,0.2051868802440885,0.010678871090770405,0.002288329519450801,Peak,Sunday,October
2024-10-20 15:00:00,125,568,3,1,697,178,433,8,3,622,29.6,68,3,7.8,1319,True,15,303,1001,11,4,2024-10-20,False,False,False,0.7589082638362395,0.22971948445792267,0.008339651250947688,0.003032600454890068,Peak,Sunday,October
2024-10-20 16:00:00,124,613,5,1,743,291,395,10,4,700,29.4,70,3,7.0,1443,True,16,415,1008,15,5,2024-10-20,False,False,True,0.6985446985446986,0.2875952875952876,0.010395010395010396,0.003465003465003465,Peak,Sunday,October
2024-10-20 17:00:00,147,606,7,0,760,207,529,8,3,747,29.7,68,2,7.7,1507,True,17,354,1135,15,3,2024-10-20,False,False,True,0.7531519575315195,0.23490378234903783,0.009953550099535502,0.0019907100199071004,Peak,Sunday,October
2024-10-20 18:00:00,123,506,6,2,637,186,464,3,1,654,29.1,71,2,5.3,1291,True,18,309,970,9,3,2024-10-20,False,False,False,0.7513555383423702,0.2393493415956623,0.006971340046475601,0.0023237800154918666,Peak,Sunday,October
2024-10-20 19:00:00,115,639,6,1,761,59,507,14,5,585,27.1,83,3,5.9,1346,True,19,174,1146,20,6,2024-10-20,False,False,False,0.8514115898959881,0.12927191679049035,0.014858841010401188,0.004457652303120356,Peak,Sunday,October
2024-10-20 20:00:00,146,430,7,1,584,155,385,7,2,549,27.3,79,2,4.4,1133,True,20,301,815,14,3,2024-10-20,False,False,False,0.7193292144748455,0.265666372462489,0.01235657546337158,0.00264783759929391,Shoulder,Sunday,October
2024-10-20 21:00:00,151,601,5,2,759,201,320,10,3,534,27.3,67,3,5.1,1293,True,21,352,921,15,5,2024-10-20,False,False,False,0.7122969837587007,0.2722351121423047,0.01160092807424594,0.0038669760247486465,Shoulder,Sunday,October
2024-10-20 22:00:00,150,618,5,1,774,188,270,9,2,469,26.7,73,3,4.4,1243,True,22,338,888,14,3,2024-10-20,False,False,False,0.7144006436041834,0.2719227674979887,0.011263073209975865,0.002413515687851971,Shoulder,Sunday,October
2024-10-20 23:00:00,187,755,8,2,952,174,361,6,1,542,26.6,71,3,4.8,1494,True,23,361,1116,14,3,2024-10-20,False,False,True,0.7469879518072289,0.24163319946452477,0.009370816599732263,0.002008032128514056,Shoulder,Sunday,October
2024-10-21 00:00:00,59,413,4,1,477,89,115,4,2,210,26.6,73,3,6.1,687,False,0,148,528,8,3,2024-10-21,False,False,False,0.7685589519650655,0.21542940320232898,0.011644832605531296,0.004366812227074236,Off-Peak,Monday,October
2024-10-21 01:00:00,100,341,5,2,448,122,142,5,1,270,26.3,75,3,6.5,718,False,1,222,483,10,3,2024-10-21,False,False,False,0.6727019498607242,0.30919220055710306,0.013927576601671309,0.004178272980501393,Off-Peak,Monday,October
2024-10-21 02:00:00,101,564,7,3,675,94,140,8,3,245,26.0,77,3,8.8,920,False,2,195,704,15,6,2024-10-21,False,False,False,0.7652173913043478,0.21195652173913043,0.016304347826086956,0.006521739130434782,Off-Peak,Monday,October
2024-10-21 03:00:00,91,447,8,0,546,105,129,6,0,240,25.9,79,2,9.9,786,False,3,196,576,14,0,2024-10-21,False,False,False,0.732824427480916,0.24936386768447838,0.017811704834605598,0.0,Off-Peak,Monday,October
2024-10-21 04:00:00,138,322,8,2,470,90,129,5,1,225,25.6,80,3,10.9,695,False,4,228,451,13,3,2024-10-21,False,False,False,0.6489208633093525,0.32805755395683456,0.01870503597122302,0.004316546762589928,Off-Peak,Monday,October
2024-10-21 05:00:00,122,429,5,2,558,104,188,4,0,296,25.6,81,3,9.9,854,False,5,226,617,9,2,2024-10-21,False,False,False,0.7224824355971897,0.2646370023419204,0.01053864168618267,0.00234192037470726,Shoulder,Monday,October
2024-10-21 06:00:00,100,358,7,0,465,111,151,6,1,269,25.4,83,3,9.9,734,False,6,211,509,13,1,2024-10-21,False,False,False,0.6934604904632152,0.28746594005449594,0.017711171662125342,0.0013623978201634877,Shoulder,Monday,October
2024-10-21 07:00:00,63,356,5,2,426,122,162,7,1,292,25.2,84,3,11.8,718,False,7,185,518,12,3,2024-10-21,False,False,False,0.7214484679665738,0.2576601671309192,0.016713091922005572,0.004178272980501393,Peak,Monday,October
2024-10-21 08:00:00,123,213,7,1,344,107,168,6,4,285,26.1,82,3,10.9,629,False,8,230,381,13,5,2024-10-21,False,False,False,0.6057233704292527,0.3656597774244833,0.02066772655007949,0.00794912559618442,Peak,Monday,October
2024-10-21 09:00:00,94,285,10,0,389,125,101,4,2,232,27.8,81,1,8.1,621,False,9,219,386,14,2,2024-10-21,False,False,False,0.6215780998389694,0.3526570048309179,0.02254428341384863,0.00322061191626409,Shoulder,Monday,October
2024-10-21 10:00:00,164,354,11,0,529,96,147,2,1,246,29.8,70,3,6.2,775,False,10,260,501,13,1,2024-10-21,False,False,False,0.6464516129032258,0.33548387096774196,0.016774193548387096,0.0012903225806451613,Shoulder,Monday,October
2024-10-21 11:00:00,101,358,7,1,467,110,149,8,1,268,30.9,61,2,2.6,735,False,11,211,507,15,2,2024-10-21,False,False,False,0.689795918367347,0.2870748299319728,0.02040816326530612,0.0027210884353741495,Peak,Monday,October
2024-10-21 12:00:00,152,328,10,1,491,107,158,2,3,270,31.7,58,2,6.1,761,False,12,259,486,12,4,2024-10-21,False,False,False,0.6386333771353482,0.3403416557161629,0.01576872536136662,0.005256241787122208,Peak,Monday,October
2024-10-21 13:00:00,158,358,7,0,523,131,96,5,2,234,31.7,59,0,11.0,757,False,13,289,454,12,2,2024-10-21,False,False,False,0.5997357992073976,0.3817701453104359,0.015852047556142668,0.002642007926023778,Peak,Monday,October
2024-10-21 14:00:00,143,356,5,0,504,126,144,6,2,278,31.2,63,0,12.1,782,False,14,269,500,11,2,2024-10-21,False,False,False,0.639386189258312,0.34398976982097185,0.014066496163682864,0.0025575447570332483,Peak,Monday,October
2024-10-21 15:00:00,95,438,8,2,543,116,162,6,2,286,31.1,62,0,10.3,829,False,15,211,600,14,4,2024-10-21,False,False,False,0.7237635705669482,0.2545235223160434,0.016887816646562123,0.0048250904704463205,Peak,Monday,October
2024-10-21 16:00:00,143,357,6,0,506,117,138,8,1,264,31.0,64,0,9.4,770,False,16,260,495,14,1,2024-10-21,False,False,False,0.6428571428571429,0.33766233766233766,0.01818181818181818,0.0012987012987012987,Peak,Monday,October
2024-10-21 17:00:00,120,575,6,0,701,72,92,5,1,170,30.5,65,0,8.8,871,False,17,192,667,11,1,2024-10-21,False,False,False,0.7657864523536165,0.22043628013777267,0.012629161882893225,0.001148105625717566,Peak,Monday,October
2024-10-21 18:00:00,141,371,6,2,520,121,147,4,1,273,29.8,69,0,5.0,793,False,18,262,518,10,3,2024-10-21,False,False,False,0.6532156368221942,0.33039092055485497,0.012610340479192938,0.0037831021437578815,Peak,Monday,October
2024-10-21 19:00:00,118,308,5,2,433,64,155,6,2,227,27.6,82,0,5.9,660,False,19,182,463,11,4,2024-10-21,False,False,False,0.7015151515151515,0.27575757575757576,0.016666666666666666,0.006060606060606061,Peak,Monday,October
2024-10-21 20:00:00,131,409,7,1,548,80,166,3,1,250,27.2,81,0,5.5,798,False,20,211,575,10,2,2024-10-21,False,False,False,0.7205513784461153,0.2644110275689223,0.012531328320802004,0.002506265664160401,Shoulder,Monday,October
2024-10-21 21:00:00,137,540,9,1,687,82,165,6,2,255,27.0,80,3,5.8,942,False,21,219,705,15,3,2024-10-21,False,False,False,0.7484076433121019,0.23248407643312102,0.01592356687898089,0.0031847133757961785,Shoulder,Monday,October
2024-10-21 22:00:00,100,342,6,0,448,101,111,5,1,218,27.0,79,3,6.1,666,False,22,201,453,11,1,2024-10-21,False,False,False,0.6801801801801802,0.30180180180180183,0.016516516516516516,0.0015015015015015015,Shoulder,Monday,October
2024-10-21 23:00:00,143,457,7,1,608,99,116,5,0,220,26.9,76,3,6.0,828,False,23,242,573,12,1,2024-10-21,False,False,False,0.6920289855072463,0.2922705314009662,0.014492753623188406,0.0012077294685990338,Shoulder,Monday,October
2024-10-22 00:00:00,74,407,9,1,491,108,165,4,0,277,26.3,82,3,6.1,768,False,0,182,572,13,1,2024-10-22,False,False,False,0.7447916666666666,0.23697916666666666,0.016927083333333332,0.0013020833333333333,Off-Peak,Tuesday,October
2024-10-22 01:00:00,94,295,5,0,394,71,80,7,1,159,26.6,74,3,7.1,553,False,1,165,375,12,1,2024-10-22,False,False,False,0.6781193490054249,0.298372513562387,0.0216998191681736,0.0018083182640144665,Off-Peak,Tuesday,October
2024-10-22 02:00:00,69,248,4,1,322,81,165,3,0,249,26.3,75,3,7.2,571,False,2,150,413,7,1,2024-10-22,False,False,False,0.723292469352014,0.2626970227670753,0.012259194395796848,0.0017513134851138354,Off-Peak,Tuesday,October
2024-10-22 03:00:00,84,416,4,1,505,94,130,6,3,233,25.8,78,3,5.3,738,False,3,178,546,10,4,2024-10-22,False,False,False,0.7398373983739838,0.24119241192411925,0.013550135501355014,0.005420054200542005,Off-Peak,Tuesday,October
2024-10-22 04:00:00,73,259,5,1,338,132,155,5,2,294,24.8,85,3,3.4,632,False,4,205,414,10,3,2024-10-22,False,False,False,0.6550632911392406,0.32436708860759494,0.015822784810126583,0.004746835443037975,Off-Peak,Tuesday,October
2024-10-22 05:00:00,86,314,2,1,403,120,139,5,3,267,24.7,89,3,4.3,670,False,5,206,453,7,4,2024-10-22,False,False,False,0.6761194029850747,0.3074626865671642,0.010447761194029851,0.005970149253731343,Shoulder,Tuesday,October
2024-10-22 06:00:00,89,435,4,0,528,105,123,5,1,234,24.0,92,3,6.2,762,False,6,194,558,9,1,2024-10-22,False,False,False,0.7322834645669292,0.2545931758530184,0.011811023622047244,0.0013123359580052493,Shoulder,Tuesday,October
2024-10-22 07:00:00,81,364,5,4,454,135,135,5,4,279,24.0,91,3,3.8,733,False,7,216,499,10,8,2024-10-22,False,False,False,0.6807639836289222,0.2946793997271487,0.013642564802182811,0.010914051841746248,Peak,Tuesday,October
2024-10-22 08:00:00,102,381,4,0,487,108,128,4,3,243,25.4,87,3,4.2,730,False,8,210,509,8,3,2024-10-22,False,False,False,0.6972602739726027,0.2876712328767123,0.010958904109589041,0.00410958904109589,Peak,Tuesday,October
2024-10-22 09:00:00,93,383,7,2,485,129,99,5,1,234,28.1,79,2,4.3,719,False,9,222,482,12,3,2024-10-22,False,False,False,0.6703755215577191,0.3087621696801113,0.016689847009735744,0.004172461752433936,Shoulder,Tuesday,October
2024-10-22 10:00:00,88,376,6,1,471,129,174,6,2,311,29.5,74,2,4.6,782,False,10,217,550,12,3,2024-10-22,False,False,False,0.7033248081841432,0.2774936061381074,0.015345268542199489,0.0038363171355498722,Shoulder,Tuesday,October
2024-10-22 11:00:00,126,249,6,0,381,92,86,6,1,185,30.2,71,51,2.9,566,False,11,218,335,12,1,2024-10-22,False,False,False,0.5918727915194346,0.38515901060070673,0.02120141342756184,0.0017667844522968198,Peak,Tuesday,October
2024-10-22 12:00:00,85,309,4,0,398,100,178,5,0,283,31.1,66,51,6.7,681,False,12,185,487,9,0,2024-10-22,False,False,False,0.7151248164464024,0.27165932452276065,0.013215859030837005,0.0,Peak,Tuesday,October
2024-10-22 13:00:00,72,393,3,0,468,99,174,6,0,279,31.5,64,51,9.8,747,False,13,171,567,9,0,2024-10-22,False,False,False,0.7590361445783133,0.2289156626506024,0.012048192771084338,0.0,Peak,Tuesday,October
2024-10-22 14:00:00,75,382,4,1,462,136,151,4,1,292,31.3,68,51,11.1,754,False,14,211,533,8,2,2024-10-22,False,False,False,0.7068965517241379,0.27984084880636606,0.010610079575596816,0.002652519893899204,Peak,Tuesday,October
2024-10-22 15:00:00,86,353,4,0,443,131,84,6,1,222,31.4,68,51,11.3,665,False,15,217,437,10,1,2024-10-22,False,False,False,0.6571428571428571,0.3263157894736842,0.015037593984962405,0.0015037593984962407,Peak,Tuesday,October
2024-10-22 16:00:00,81,329,2,2,414,124,146,7,2,279,31.3,67,1,11.5,693,False,16,205,475,9,4,2024-10-22,False,False,False,0.6854256854256854,0.2958152958152958,0.012987012987012988,0.005772005772005772,Peak,Tuesday,October
2024-10-22 17:00:00,105,330,5,1,441,122,126,4,2,254,30.8,67,1,10.5,695,False,17,227,456,9,3,2024-10-22,False,False,False,0.6561151079136691,0.32661870503597124,0.012949640287769784,0.004316546762589928,Peak,Tuesday,October
2024-10-22 18:00:00,102,432,5,0,539,136,151,5,2,294,30.0,71,3,7.8,833,False,18,238,583,10,2,2024-10-22,False,False,False,0.6998799519807923,0.2857142857142857,0.012004801920768308,0.0024009603841536613,Peak,Tuesday,October
2024-10-22 19:00:00,63,278,5,0,346,119,158,5,2,284,28.5,80,3,6.6,630,False,19,182,436,10,2,2024-10-22,False,False,False,0.692063492063492,0.28888888888888886,0.015873015873015872,0.0031746031746031746,Peak,Tuesday,October
2024-10-22 20:00:00,78,373,7,2,460,113,131,5,0,249,27.8,86,1,6.7,709,False,20,191,504,12,2,2024-10-22,False,False,False,0.7108603667136812,0.2693935119887165,0.01692524682651622,0.0028208744710860366,Shoulder,Tuesday,October
2024-10-22 21:00:00,68,356,4,0,428,73,185,8,1,267,28.4,84,3,9.1,695,False,21,141,541,12,1,2024-10-22,False,False,False,0.7784172661870503,0.20287769784172663,0.017266187050359712,0.0014388489208633094,Shoulder,Tuesday,October
2024-10-22 22:00:00,86,368,5,2,461,102,188,4,2,296,28.2,84,3,8.1,757,False,22,188,556,9,4,2024-10-22,False,False,False,0.7344782034346103,0.24834874504623514,0.011889035667107,0.005284015852047556,Shoulder,Tuesday,October
2024-10-22 23:00:00,111,380,2,1,494,73,183,3,1,260,27.7,85,3,9.3,754,False,23,184,563,5,2,2024-10-22,False,False,False,0.746684350132626,0.2440318302387268,0.006631299734748011,0.002652519893899204,Shoulder,Tuesday,October
2024-10-23 00:00:00,52,525,5,4,586,123,104,4,2,233,27.4,84,3,8.9,819,False,0,175,629,9,6,2024-10-23,False,False,False,0.7680097680097681,0.21367521367521367,0.01098901098901099,0.007326007326007326,Off-Peak,Wednesday,October
2024-10-23 01:00:00,91,448,7,2,548,98,127,6,1,232,26.7,85,3,8.6,780,False,1,189,575,13,3,2024-10-23,False,False,False,0.7371794871794872,0.2423076923076923,0.016666666666666666,0.0038461538461538464,Off-Peak,Wednesday,October
2024-10-23 02:00:00,79,413,8,1,501,102,114,5,1,222,26.0,89,3,4.4,723,False,2,181,527,13,2,2024-10-23,False,False,False,0.7289073305670816,0.2503457814661134,0.017980636237897647,0.0027662517289073307,Off-Peak,Wednesday,October
2024-10-23 03:00:00,99,390,6,0,495,116,132,3,2,253,25.4,93,3,4.1,748,False,3,215,522,9,2,2024-10-23,False,False,False,0.6978609625668449,0.2874331550802139,0.012032085561497326,0.00267379679144385,Off-Peak,Wednesday,October
2024-10-23 04:00:00,76,332,5,3,416,120,185,4,3,312,24.9,96,2,4.8,728,False,4,196,517,9,6,2024-10-23,False,False,False,0.7101648351648352,0.2692307692307692,0.012362637362637362,0.008241758241758242,Off-Peak,Wednesday,October
2024-10-23 05:00:00,117,190,3,2,312,142,163,6,1,312,24.5,97,3,5.2,624,False,5,259,353,9,3,2024-10-23,False,False,False,0.5657051282051282,0.4150641025641026,0.014423076923076924,0.004807692307692308,Shoulder,Wednesday,October
2024-10-23 06:00:00,82,220,6,1,309,111,175,6,2,294,24.6,96,2,4.2,603,False,6,193,395,12,3,2024-10-23,False,False,False,0.6550580431177446,0.3200663349917081,0.01990049751243781,0.004975124378109453,Shoulder,Wednesday,October
2024-10-23 07:00:00,81,453,5,1,540,95,171,7,1,274,24.5,96,3,6.5,814,False,7,176,624,12,2,2024-10-23,False,False,False,0.7665847665847666,0.21621621621621623,0.014742014742014743,0.002457002457002457,Peak,Wednesday,October
2024-10-23 08:00:00,116,522,2,1,641,115,164,6,1,286,26.0,91,3,6.1,927,False,8,231,686,8,2,2024-10-23,False,False,False,0.7400215749730313,0.24919093851132687,0.008629989212513484,0.002157497303128371,Peak,Wednesday,October
2024-10-23 09:00:00,101,411,5,1,518,99,102,4,2,207,27.7,78,1,8.0,725,False,9,200,513,9,3,2024-10-23,False,False,False,0.7075862068965517,0.27586206896551724,0.012413793103448275,0.004137931034482759,Shoulder,Wednesday,October
2024-10-23 10:00:00,76,385,6,1,468,125,118,3,0,246,29.4,75,0,6.9,714,False,10,201,503,9,1,2024-10-23,False,False,False,0.7044817927170869,0.2815126050420168,0.012605042016806723,0.0014005602240896359,Shoulder,Wednesday,October
2024-10-23 11:00:00,94,428,5,2,529,124,151,4,1,280,31.0,67,51,6.3,809,False,11,218,579,9,3,2024-10-23,False,False,False,0.715698393077874,0.2694684796044499,0.011124845488257108,0.003708281829419036,Peak,Wednesday,October
2024-10-23 12:00:00,101,391,4,0,496,128,187,4,2,321,32.2,60,3,8.7,817,False,12,229,578,8,2,2024-10-23,False,False,False,0.7074663402692778,0.2802937576499388,0.009791921664626682,0.0024479804161566705,Peak,Wednesday,October
2024-10-23 13:00:00,87,576,6,1,670,63,135,5,2,205,32.6,57,3,11.3,875,False,13,150,711,11,3,2024-10-23,False,False,False,0.8125714285714286,0.17142857142857143,0.012571428571428572,0.0034285714285714284,Peak,Wednesday,October
2024-10-23 14:00:00,84,275,4,0,363,99,107,6,2,214,32.8,56,3,11.9,577,False,14,183,382,10,2,2024-10-23,False,False,False,0.6620450606585788,0.317157712305026,0.01733102253032929,0.0034662045060658577,Peak,Wednesday,October
2024-10-23 15:00:00,117,429,6,2,554,133,135,4,0,272,32.1,61,3,13.6,826,False,15,250,564,10,2,2024-10-23,False,False,False,0.6828087167070218,0.3026634382566586,0.012106537530266344,0.002421307506053269,Peak,Wednesday,October
2024-10-23 16:00:00,99,403,6,0,508,99,96,6,2,203,31.7,65,3,13.6,711,False,16,198,499,12,2,2024-10-23,False,False,False,0.7018284106891702,0.27848101265822783,0.016877637130801686,0.0028129395218002813,Peak,Wednesday,October
2024-10-23 17:00:00,62,554,4,1,621,107,102,3,2,214,31.1,69,3,13.4,835,False,17,169,656,7,3,2024-10-23,False,False,False,0.7856287425149701,0.20239520958083831,0.008383233532934131,0.003592814371257485,Peak,Wednesday,October
2024-10-23 18:00:00,55,486,6,1,548,92,154,4,2,252,30.2,73,3,12.4,800,False,18,147,640,10,3,2024-10-23,False,False,False,0.8,0.18375,0.0125,0.00375,Peak,Wednesday,October
2024-10-23 19:00:00,94,479,6,1,580,110,219,5,1,335,29.2,77,3,10.3,915,False,19,204,698,11,2,2024-10-23,False,False,False,0.7628415300546448,0.22295081967213115,0.012021857923497269,0.002185792349726776,Peak,Wednesday,October
2024-10-23 20:00:00,111,524,6,2,643,103,146,2,2,253,28.8,79,3,10.5,896,False,20,214,670,8,4,2024-10-23,False,False,False,0.7477678571428571,0.23883928571428573,0.008928571428571428,0.004464285714285714,Shoulder,Wednesday,October
2024-10-23 21:00:00,83,475,8,1,567,106,152,5,0,263,28.5,78,3,8.7,830,False,21,189,627,13,1,2024-10-23,False,False,False,0.755421686746988,0.22771084337349398,0.01566265060240964,0.0012048192771084338,Shoulder,Wednesday,October
2024-10-23 22:00:00,109,425,8,0,542,105,175,5,0,285,28.3,81,3,9.2,827,False,22,214,600,13,0,2024-10-23,False,False,False,0.7255139056831923,0.2587666263603386,0.015719467956469165,0.0,Shoulder,Wednesday,October
2024-10-23 23:00:00,149,398,5,0,552,105,102,5,1,213,28.1,81,3,10.3,765,False,23,254,500,10,1,2024-10-23,False,False,False,0.6535947712418301,0.33202614379084966,0.013071895424836602,0.00130718954248366,Shoulder,Wednesday,October
2024-10-24 00:00:00,117,410,3,0,530,96,141,6,1,244,27.2,84,3,9.1,774,False,0,213,551,9,1,2024-10-24,False,False,False,0.7118863049095607,0.2751937984496124,0.011627906976744186,0.0012919896640826874,Off-Peak,Thursday,October
2024-10-24 01:00:00,79,412,2,0,493,90,95,6,2,193,26.2,82,3,8.7,686,False,1,169,507,8,2,2024-10-24,False,False,False,0.739067055393586,0.24635568513119532,0.011661807580174927,0.0029154518950437317,Off-Peak,Thursday,October
2024-10-24 02:00:00,60,440,3,0,503,75,176,4,2,257,26.0,83,3,11.3,760,False,2,135,616,7,2,2024-10-24,False,False,False,0.8105263157894737,0.17763157894736842,0.009210526315789473,0.002631578947368421,Off-Peak,Thursday,October
2024-10-24 03:00:00,96,455,2,1,554,99,177,4,1,281,25.9,87,3,11.5,835,False,3,195,632,6,2,2024-10-24,False,False,False,0.7568862275449102,0.23353293413173654,0.00718562874251497,0.0023952095808383233,Off-Peak,Thursday,October
2024-10-24 04:00:00,115,484,3,0,602,133,108,4,1,246,26.0,87,3,9.9,848,False,4,248,592,7,1,2024-10-24,False,False,False,0.6981132075471698,0.29245283018867924,0.008254716981132075,0.0011792452830188679,Off-Peak,Thursday,October
2024-10-24 05:00:00,109,334,1,1,445,86,133,4,2,225,25.9,88,3,8.3,670,False,5,195,467,5,3,2024-10-24,False,False,False,0.6970149253731344,0.291044776119403,0.007462686567164179,0.004477611940298508,Shoulder,Thursday,October
2024-10-24 06:00:00,84,255,2,0,341,133,192,4,2,331,25.6,90,3,5.0,672,False,6,217,447,6,2,2024-10-24,False,False,False,0.6651785714285714,0.3229166666666667,0.008928571428571428,0.002976190476190476,Shoulder,Thursday,October
2024-10-24 07:00:00,126,468,2,0,596,143,76,4,1,224,25.1,92,3,3.6,820,False,7,269,544,6,1,2024-10-24,False,False,False,0.6634146341463415,0.3280487804878049,0.007317073170731708,0.0012195121951219512,Peak,Thursday,October
2024-10-24 08:00:00,130,421,4,2,557,94,162,6,1,263,26.2,89,3,3.8,820,False,8,224,583,10,3,2024-10-24,False,False,False,0.7109756097560975,0.2731707317073171,0.012195121951219513,0.003658536585365854,Peak,Thursday,October
2024-10-24 09:00:00,118,473,2,0,593,80,173,4,2,259,28.4,81,2,5.0,852,False,9,198,646,6,2,2024-10-24,False,False,False,0.7582159624413145,0.2323943661971831,0.007042253521126761,0.002347417840375587,Shoulder,Thursday,October
2024-10-24 10:00:00,99,512,1,4,616,140,152,7,1,300,29.9,75,3,5.6,916,False,10,239,664,8,5,2024-10-24,False,False,False,0.7248908296943232,0.2609170305676856,0.008733624454148471,0.0054585152838427945,Shoulder,Thursday,October
2024-10-24 11:00:00,135,407,1,3,546,94,155,3,1,253,30.6,72,2,4.4,799,False,11,229,562,4,4,2024-10-24,False,False,False,0.7033792240300375,0.28660826032540676,0.0050062578222778474,0.0050062578222778474,Peak,Thursday,October
2024-10-24 12:00:00,40,261,2,2,305,132,164,7,0,303,31.0,69,3,7.5,608,False,12,172,425,9,2,2024-10-24,False,False,False,0.6990131578947368,0.28289473684210525,0.014802631578947368,0.003289473684210526,Peak,Thursday,October
2024-10-24 13:00:00,101,556,3,0,660,99,161,6,1,267,29.0,78,63,7.1,927,False,13,200,717,9,1,2024-10-24,False,False,False,0.7734627831715211,0.21574973031283712,0.009708737864077669,0.0010787486515641855,Peak,Thursday,October
2024-10-24 14:00:00,75,439,2,0,516,88,119,4,1,212,29.8,77,51,7.6,728,False,14,163,558,6,1,2024-10-24,False,False,False,0.7664835164835165,0.2239010989010989,0.008241758241758242,0.0013736263736263737,Peak,Thursday,October
2024-10-24 15:00:00,113,311,3,0,427,68,147,5,2,222,28.5,79,63,11.0,649,False,15,181,458,8,2,2024-10-24,False,False,False,0.7057010785824345,0.27889060092449924,0.012326656394453005,0.0030816640986132513,Peak,Thursday,October
2024-10-24 16:00:00,93,495,2,0,590,155,88,3,0,246,28.8,77,51,14.2,836,False,16,248,583,5,0,2024-10-24,False,False,False,0.6973684210526315,0.2966507177033493,0.005980861244019139,0.0,Peak,Thursday,October
2024-10-24 17:00:00,109,461,3,2,575,123,130,6,1,260,28.2,80,3,8.5,835,False,17,232,591,9,3,2024-10-24,False,False,False,0.7077844311377246,0.2778443113772455,0.010778443113772455,0.003592814371257485,Peak,Thursday,October
2024-10-24 18:00:00,109,370,2,1,482,99,113,4,3,219,28.2,81,3,5.3,701,False,18,208,483,6,4,2024-10-24,False,False,False,0.6890156918687589,0.2967189728958631,0.008559201141226819,0.005706134094151213,Peak,Thursday,October
2024-10-24 19:00:00,95,494,2,1,592,67,162,5,2,236,27.3,88,3,5.6,828,False,19,162,656,7,3,2024-10-24,False,False,False,0.7922705314009661,0.1956521739130435,0.008454106280193236,0.0036231884057971015,Peak,Thursday,October
2024-10-24 20:00:00,83,287,3,0,373,123,185,5,4,317,27.5,84,3,4.7,690,False,20,206,472,8,4,2024-10-24,False,False,False,0.6840579710144927,0.2985507246376812,0.011594202898550725,0.005797101449275362,Shoulder,Thursday,October
2024-10-24 21:00:00,94,445,2,1,542,122,144,4,3,273,28.7,75,3,12.1,815,False,21,216,589,6,4,2024-10-24,False,False,False,0.7226993865030675,0.2650306748466258,0.007361963190184049,0.0049079754601227,Shoulder,Thursday,October
2024-10-24 22:00:00,105,387,2,0,494,129,153,4,0,286,28.2,78,3,11.3,780,False,22,234,540,6,0,2024-10-24,False,False,False,0.6923076923076923,0.3,0.007692307692307693,0.0,Shoulder,Thursday,October
2024-10-24 23:00:00,110,431,4,0,545,137,132,6,1,276,27.8,81,3,10.8,821,False,23,247,563,10,1,2024-10-24,False,False,False,0.6857490864799025,0.30085261875761266,0.012180267965895249,0.001218026796589525,Shoulder,Thursday,October
2024-10-25 00:00:00,143,421,5,1,570,216,327,9,5,557,27.4,82,3,9.0,1127,False,0,359,748,14,6,2024-10-25,False,False,False,0.6637089618456078,0.318544809228039,0.012422360248447204,0.005323868677905945,Off-Peak,Friday,October
2024-10-25 01:00:00,176,479,7,0,662,155,562,10,3,730,27.2,83,3,11.2,1392,False,1,331,1041,17,3,2024-10-25,False,False,True,0.7478448275862069,0.2377873563218391,0.01221264367816092,0.0021551724137931034,Off-Peak,Friday,October
2024-10-25 02:00:00,140,513,6,2,661,199,371,8,3,581,27.1,84,3,11.9,1242,False,2,339,884,14,5,2024-10-25,False,False,False,0.711755233494364,0.27294685990338163,0.011272141706924315,0.004025764895330112,Off-Peak,Friday,October
2024-10-25 03:00:00,152,622,7,1,782,184,550,13,3,750,26.5,85,3,11.3,1532,False,3,336,1172,20,4,2024-10-25,False,False,True,0.7650130548302873,0.2193211488250653,0.013054830287206266,0.0026109660574412533,Off-Peak,Friday,October
2024-10-25 04:00:00,132,593,7,1,733,191,453,9,2,655,26.3,85,3,11.4,1388,False,4,323,1046,16,3,2024-10-25,False,False,True,0.7536023054755043,0.23270893371757925,0.011527377521613832,0.002161383285302594,Off-Peak,Friday,October
2024-10-25 05:00:00,129,519,5,0,653,159,577,7,2,745,26.0,87,3,9.3,1398,False,5,288,1096,12,2,2024-10-25,False,False,True,0.7839771101573677,0.20600858369098712,0.008583690987124463,0.001430615164520744,Shoulder,Friday,October
2024-10-25 06:00:00,149,521,5,0,675,164,515,7,2,688,26.0,87,3,10.5,1363,False,6,313,1036,12,2,2024-10-25,False,False,False,0.76008804108584,0.22964049889948643,0.00880410858400587,0.001467351430667645,Shoulder,Friday,October
2024-10-25 07:00:00,111,394,7,0,512,177,489,10,1,677,26.1,88,2,14.0,1189,False,7,288,883,17,1,2024-10-25,False,False,False,0.7426408746846089,0.24222035323801513,0.014297729184188394,0.0008410428931875525,Peak,Friday,October
2024-10-25 08:00:00,103,421,8,1,533,168,369,11,1,549,26.8,85,3,17.0,1082,False,8,271,790,19,2,2024-10-25,False,False,False,0.7301293900184843,0.25046210720887246,0.01756007393715342,0.0018484288354898336,Peak,Friday,October
2024-10-25 09:00:00,66,562,6,0,634,167,652,7,3,829,28.4,78,3,8.8,1463,False,9,233,1214,13,3,2024-10-25,False,False,True,0.8298017771701982,0.15926179084073822,0.00888585099111415,0.002050580997949419,Shoulder,Friday,October
2024-10-25 10:00:00,140,575,5,1,721,144,304,8,3,459,29.5,72,3,13.5,1180,False,10,284,879,13,4,2024-10-25,False,False,False,0.7449152542372881,0.24067796610169492,0.011016949152542373,0.003389830508474576,Shoulder,Friday,October
2024-10-25 11:00:00,171,566,5,1,743,184,542,5,3,734,30.5,66,3,16.9,1477,False,11,355,1108,10,4,2024-10-25,False,False,True,0.7501692620176033,0.24035206499661477,0.006770480704129994,0.002708192281651997,Peak,Friday,October
2024-10-25 12:00:00,143,552,4,1,700,147,351,8,3,509,31.0,65,3,16.3,1209,False,12,290,903,12,4,2024-10-25,False,False,False,0.7468982630272953,0.23986765922249792,0.009925558312655087,0.0033085194375516956,Peak,Friday,October
2024-10-25 13:00:00,171,241,4,0,416,187,499,10,1,697,30.1,67,53,18.6,1113,False,13,358,740,14,1,2024-10-25,False,False,False,0.6648697214734951,0.3216531895777179,0.012578616352201259,0.0008984725965858042,Peak,Friday,October
2024-10-25 14:00:00,119,529,6,1,655,109,489,8,2,608,29.9,71,3,14.5,1263,False,14,228,1018,14,3,2024-10-25,False,False,False,0.8060174188440221,0.18052256532066507,0.011084718923198733,0.0023752969121140144,Peak,Friday,October
2024-10-25 15:00:00,156,532,9,0,697,167,548,6,1,722,30.6,68,3,17.8,1419,False,15,323,1080,15,1,2024-10-25,False,False,True,0.7610993657505285,0.22762508809020437,0.010570824524312896,0.0007047216349541931,Peak,Friday,October
2024-10-25 16:00:00,108,528,7,0,643,182,486,10,4,682,30.1,70,3,17.7,1325,False,16,290,1014,17,4,2024-10-25,False,False,False,0.7652830188679245,0.2188679245283019,0.012830188679245283,0.0030188679245283017,Peak,Friday,October
2024-10-25 17:00:00,112,376,9,0,497,166,367,8,4,545,29.1,75,3,16.3,1042,False,17,278,743,17,4,2024-10-25,False,False,False,0.7130518234165067,0.2667946257197697,0.016314779270633396,0.003838771593090211,Peak,Friday,October
2024-10-25 18:00:00,131,682,6,0,819,217,478,6,2,703,28.6,77,3,13.9,1522,False,18,348,1160,12,2,2024-10-25,False,False,True,0.7621550591327201,0.22864651773981604,0.00788436268068331,0.001314060446780552,Peak,Friday,October
2024-10-25 19:00:00,135,455,7,3,600,171,364,12,5,552,27.9,80,3,14.5,1152,False,19,306,819,19,8,2024-10-25,False,False,False,0.7109375,0.265625,0.016493055555555556,0.006944444444444444,Peak,Friday,October
2024-10-25 20:00:00,147,526,7,1,681,147,506,8,1,662,27.3,82,3,12.3,1343,False,20,294,1032,15,2,2024-10-25,False,False,False,0.7684288905435592,0.21891288160833955,0.011169024571854059,0.0014892032762472078,Shoulder,Friday,October
2024-10-25 21:00:00,159,483,4,0,646,181,485,8,1,675,26.7,84,3,12.9,1321,False,21,340,968,12,1,2024-10-25,False,False,False,0.732778198334595,0.2573807721423164,0.009084027252081756,0.000757002271006813,Shoulder,Friday,October
2024-10-25 22:00:00,135,361,6,2,504,245,590,9,2,846,26.8,84,3,12.9,1350,False,22,380,951,15,4,2024-10-25,False,False,False,0.7044444444444444,0.2814814814814815,0.011111111111111112,0.002962962962962963,Shoulder,Friday,October
2024-10-25 23:00:00,158,471,6,0,635,210,462,7,1,680,26.6,84,3,12.6,1315,False,23,368,933,13,1,2024-10-25,False,False,False,0.7095057034220532,0.2798479087452472,0.00988593155893536,0.0007604562737642585,Shoulder,Friday,October
2024-10-26 00:00:00,126,626,7,0,759,164,343,5,1,513,26.4,84,3,11.3,1272,True,0,290,969,12,1,2024-10-26,False,False,False,0.7617924528301887,0.2279874213836478,0.009433962264150943,0.0007861635220125787,Off-Peak,Saturday,October
2024-10-26 01:00:00,123,482,14,2,621,147,375,6,3,531,26.4,82,3,12.1,1152,True,1,270,857,20,5,2024-10-26,False,False,False,0.7439236111111112,0.234375,0.017361111111111112,0.004340277777777778,Off-Peak,Saturday,October
2024-10-26 02:00:00,87,657,11,0,755,166,588,9,1,764,26.4,81,3,12.2,1519,True,2,253,1245,20,1,2024-10-26,False,False,True,0.8196181698485846,0.16655694535878868,0.013166556945358789,0.0006583278472679394,Off-Peak,Saturday,October
2024-10-26 03:00:00,187,766,8,0,961,238,586,6,2,832,26.2,82,3,13.2,1793,True,3,425,1352,14,2,2024-10-26,False,False,True,0.7540435025097602,0.23703290574456218,0.007808142777467931,0.0011154489682097045,Off-Peak,Saturday,October
2024-10-26 04:00:00,121,600,6,2,729,122,312,10,2,446,26.2,82,51,15.6,1175,True,4,243,912,16,4,2024-10-26,False,False,False,0.7761702127659574,0.20680851063829786,0.013617021276595745,0.003404255319148936,Off-Peak,Saturday,October
2024-10-26 05:00:00,110,653,9,1,773,176,548,6,2,732,25.9,84,3,17.7,1505,True,5,286,1201,15,3,2024-10-26,False,False,True,0.7980066445182724,0.19003322259136213,0.009966777408637873,0.0019933554817275745,Shoulder,Saturday,October
2024-10-26 06:00:00,128,365,8,0,501,173,392,7,1,573,25.8,85,3,13.8,1074,True,6,301,757,15,1,2024-10-26,False,False,False,0.7048417132216015,0.2802607076350093,0.013966480446927373,0.000931098696461825,Shoulder,Saturday,October
2024-10-26 07:00:00,128,765,10,3,906,145,357,6,3,511,25.7,87,51,10.7,1417,True,7,273,1122,16,6,2024-10-26,False,False,True,0.7918136908962597,0.1926605504587156,0.011291460832745237,0.004234297812279464,Peak,Saturday,October
2024-10-26 08:00:00,206,621,7,2,836,144,594,9,3,750,26.1,87,3,10.3,1586,True,8,350,1215,16,5,2024-10-26,False,False,True,0.766078184110971,0.22068095838587642,0.01008827238335435,0.0031525851197982345,Peak,Saturday,October
2024-10-26 09:00:00,162,434,8,1,605,210,432,9,1,652,27.8,81,3,12.6,1257,True,9,372,866,17,2,2024-10-26,False,False,False,0.6889419252187748,0.29594272076372313,0.013524264120922832,0.0015910898965791568,Shoulder,Saturday,October
2024-10-26 10:00:00,103,390,7,0,500,209,526,6,4,745,28.9,72,2,15.6,1245,True,10,312,916,13,4,2024-10-26,False,False,False,0.7357429718875502,0.25060240963855424,0.010441767068273093,0.00321285140562249,Shoulder,Saturday,October
2024-10-26 11:00:00,205,520,12,2,739,155,533,11,4,703,30.1,69,3,16.5,1442,True,11,360,1053,23,6,2024-10-26,False,False,True,0.7302357836338419,0.24965325936199723,0.0159500693481276,0.004160887656033287,Peak,Saturday,October
2024-10-26 12:00:00,135,594,9,0,738,201,443,11,3,658,30.8,67,3,15.6,1396,True,12,336,1037,20,3,2024-10-26,False,False,True,0.7428366762177651,0.24068767908309455,0.014326647564469915,0.002148997134670487,Peak,Saturday,October
2024-10-26 13:00:00,164,775,7,0,946,180,537,10,2,729,31.4,64,0,15.6,1675,True,13,344,1312,17,2,2024-10-26,False,False,True,0.7832835820895523,0.20537313432835821,0.010149253731343283,0.0011940298507462687,Peak,Saturday,October
2024-10-26 14:00:00,180,433,10,0,623,167,602,9,3,781,32.1,59,0,16.3,1404,True,14,347,1035,19,3,2024-10-26,False,False,True,0.7371794871794872,0.24715099715099714,0.013532763532763533,0.002136752136752137,Peak,Saturday,October
2024-10-26 15:00:00,122,565,11,2,700,225,557,6,2,790,32.0,60,2,16.1,1490,True,15,347,1122,17,4,2024-10-26,False,False,True,0.7530201342281879,0.23288590604026846,0.011409395973154362,0.0026845637583892616,Peak,Saturday,October
2024-10-26 16:00:00,185,691,10,0,886,229,324,8,2,563,31.2,66,3,17.7,1449,True,16,414,1015,18,2,2024-10-26,False,False,True,0.7004830917874396,0.2857142857142857,0.012422360248447204,0.0013802622498274672,Peak,Saturday,October
2024-10-26 17:00:00,130,587,10,1,728,231,354,9,2,596,30.4,69,1,18.4,1324,True,17,361,941,19,3,2024-10-26,False,False,False,0.7107250755287009,0.2726586102719033,0.014350453172205438,0.0022658610271903325,Peak,Saturday,October
2024-10-26 18:00:00,125,312,9,0,446,178,503,7,2,690,30.0,69,1,15.4,1136,True,18,303,815,16,2,2024-10-26,False,False,False,0.7174295774647887,0.26672535211267606,0.014084507042253521,0.0017605633802816902,Peak,Saturday,October
2024-10-26 19:00:00,134,546,8,0,688,175,515,10,3,703,29.3,74,0,14.3,1391,True,19,309,1061,18,3,2024-10-26,False,False,True,0.7627606038820992,0.22214234363767074,0.012940330697340043,0.002156721782890007,Peak,Saturday,October
2024-10-26 20:00:00,122,704,8,2,836,161,361,11,4,537,28.9,74,1,15.9,1373,True,20,283,1065,19,6,2024-10-26,False,False,False,0.775673707210488,0.20611798980335033,0.013838310269482883,0.004369992716678805,Shoulder,Saturday,October
2024-10-26 21:00:00,129,524,8,0,661,180,410,6,4,600,28.2,75,3,15.0,1261,True,21,309,934,14,4,2024-10-26,False,False,False,0.7406819984139572,0.24504361617763679,0.011102299762093577,0.0031720856463124504,Shoulder,Saturday,October
2024-10-26 22:00:00,170,496,8,0,674,117,516,5,1,639,27.5,77,2,16.0,1313,True,22,287,1012,13,1,2024-10-26,False,False,False,0.7707539984767707,0.21858339680121858,0.009900990099009901,0.0007616146230007616,Shoulder,Saturday,October
2024-10-26 23:00:00,134,445,8,1,588,169,636,10,3,818,27.0,76,3,15.3,1406,True,23,303,1081,18,4,2024-10-26,False,False,True,0.7688477951635846,0.2155049786628734,0.012802275960170697,0.002844950213371266,Shoulder,Saturday,October
2024-10-27 00:00:00,175,502,12,0,689,133,509,9,1,652,26.6,76,3,14.9,1341,True,0,308,1011,21,1,2024-10-27,False,False,False,0.7539149888143176,0.2296793437733035,0.015659955257270694,0.0007457121551081282,Off-Peak,Sunday,October
2024-10-27 01:00:00,126,510,12,2,650,161,601,8,4,774,26.4,77,3,15.7,1424,True,1,287,1111,20,6,2024-10-27,False,False,True,0.7801966292134831,0.20154494382022473,0.014044943820224719,0.004213483146067416,Off-Peak,Sunday,October
2024-10-27 02:00:00,108,437,12,1,558,148,624,7,1,780,26.1,79,3,14.4,1338,True,2,256,1061,19,2,2024-10-27,False,False,False,0.7929745889387145,0.19133034379671152,0.014200298953662182,0.0014947683109118087,Off-Peak,Sunday,October
2024-10-27 03:00:00,77,594,9,0,680,176,591,9,2,778,25.9,81,3,15.3,1458,True,3,253,1185,18,2,2024-10-27,False,False,True,0.8127572016460906,0.17352537722908093,0.012345679012345678,0.0013717421124828531,Off-Peak,Sunday,October
2024-10-27 04:00:00,138,569,9,1,717,168,509,9,1,687,25.7,85,3,15.9,1404,True,4,306,1078,18,2,2024-10-27,False,False,True,0.7678062678062678,0.21794871794871795,0.01282051282051282,0.0014245014245014246,Off-Peak,Sunday,October
2024-10-27 05:00:00,85,408,11,0,504,193,528,9,3,733,25.6,88,3,15.2,1237,True,5,278,936,20,3,2024-10-27,False,False,False,0.7566693613581245,0.22473726758286175,0.016168148746968473,0.002425222312045271,Shoulder,Sunday,October
2024-10-27 06:00:00,151,485,10,1,647,185,511,8,2,706,25.6,90,3,15.7,1353,True,6,336,996,18,3,2024-10-27,False,False,False,0.7361419068736141,0.24833702882483372,0.013303769401330377,0.0022172949002217295,Shoulder,Sunday,October
2024-10-27 07:00:00,158,519,12,1,690,244,393,7,1,645,25.5,91,3,14.6,1335,True,7,402,912,19,2,2024-10-27,False,False,False,0.6831460674157304,0.30112359550561796,0.014232209737827715,0.00149812734082397,Peak,Sunday,October
2024-10-27 08:00:00,113,635,11,0,759,215,427,9,1,652,26.3,87,3,15.5,1411,True,8,328,1062,20,1,2024-10-27,False,False,True,0.7526576895818569,0.23245924875974486,0.014174344436569808,0.0007087172218284905,Peak,Sunday,October
2024-10-27 09:00:00,132,368,12,0,512,196,318,8,3,525,28.0,77,2,16.2,1037,True,9,328,686,20,3,2024-10-27,False,False,False,0.6615236258437801,0.3162970106075217,0.019286403085824494,0.0028929604628736743,Shoulder,Sunday,October
2024-10-27 10:00:00,151,466,9,0,626,167,532,7,2,708,29.4,73,3,18.0,1334,True,10,318,998,16,2,2024-10-27,False,False,False,0.7481259370314842,0.2383808095952024,0.01199400299850075,0.0014992503748125937,Shoulder,Sunday,October
2024-10-27 11:00:00,142,482,12,0,636,206,377,10,2,595,30.6,67,3,18.2,1231,True,11,348,859,22,2,2024-10-27,False,False,False,0.6978066612510154,0.2826969943135662,0.017871649065800164,0.0016246953696181965,Peak,Sunday,October
2024-10-27 12:00:00,139,859,6,0,1004,114,401,7,3,525,31.4,63,3,17.0,1529,True,12,253,1260,13,3,2024-10-27,False,False,True,0.8240680183126227,0.16546762589928057,0.008502289077828646,0.001962066710268149,Peak,Sunday,October
2024-10-27 13:00:00,174,522,12,0,708,185,344,9,3,541,31.9,59,3,17.7,1249,True,13,359,866,21,3,2024-10-27,False,False,False,0.6933546837469976,0.28742994395516414,0.016813450760608487,0.0024019215372297837,Peak,Sunday,October
2024-10-27 14:00:00,123,583,11,1,718,175,385,7,3,570,31.8,60,3,18.2,1288,True,14,298,968,18,4,2024-10-27,False,False,False,0.7515527950310559,0.23136645962732919,0.013975155279503106,0.003105590062111801,Peak,Sunday,October
2024-10-27 15:00:00,171,531,10,0,712,146,399,10,2,557,31.2,64,3,18.6,1269,True,15,317,930,20,2,2024-10-27,False,False,False,0.7328605200945626,0.24980299448384555,0.015760441292356184,0.0015760441292356187,Peak,Sunday,October
2024-10-27 16:00:00,105,743,12,1,861,147,570,8,2,727,30.9,65,3,17.5,1588,True,16,252,1313,20,3,2024-10-27,False,False,True,0.8268261964735516,0.15869017632241814,0.012594458438287154,0.001889168765743073,Peak,Sunday,October
2024-10-27 17:00:00,165,644,10,0,819,163,472,7,2,644,30.9,64,3,16.6,1463,True,17,328,1116,17,2,2024-10-27,False,False,True,0.7628161312371838,0.22419685577580314,0.01161995898838004,0.001367053998632946,Peak,Sunday,October
2024-10-27 18:00:00,156,543,12,1,712,208,661,7,3,879,30.3,66,3,14.5,1591,True,18,364,1204,19,4,2024-10-27,False,False,True,0.7567567567567568,0.22878692646134507,0.011942174732872407,0.00251414204902577,Peak,Sunday,October
2024-10-27 19:00:00,126,589,10,2,727,220,502,8,3,733,29.3,72,3,12.3,1460,True,19,346,1091,18,5,2024-10-27,False,False,True,0.7472602739726028,0.236986301369863,0.012328767123287671,0.003424657534246575,Peak,Sunday,October
2024-10-27 20:00:00,129,575,7,1,712,199,509,6,3,717,28.4,77,3,12.6,1429,True,20,328,1084,13,4,2024-10-27,False,False,True,0.7585724282715185,0.22953114065780267,0.009097270818754374,0.0027991602519244225,Shoulder,Sunday,October
2024-10-27 21:00:00,130,641,12,2,785,131,345,10,4,490,29.1,71,0,12.9,1275,True,21,261,986,22,6,2024-10-27,False,False,False,0.7733333333333333,0.20470588235294118,0.017254901960784313,0.004705882352941176,Shoulder,Sunday,October
2024-10-27 22:00:00,136,483,10,1,630,158,484,11,2,655,28.5,71,1,13.0,1285,True,22,294,967,21,3,2024-10-27,False,False,False,0.7525291828793774,0.22879377431906614,0.01634241245136187,0.0023346303501945525,Shoulder,Sunday,October
2024-10-27 23:00:00,147,430,10,1,588,191,644,6,2,843,28.0,74,0,13.8,1431,True,23,338,1074,16,3,2024-10-27,False,False,True,0.750524109014675,0.23619846261355695,0.011180992313067784,0.0020964360587002098,Shoulder,Sunday,October
2024-10-28 00:00:00,72,570,4,0,646,213,221,7,1,442,27.4,77,1,11.5,1088,False,0,285,791,11,1,2024-10-28,False,False,False,0.7270220588235294,0.2619485294117647,0.01011029411764706,0.0009191176470588235,Off-Peak,Monday,October
2024-10-28 01:00:00,93,611,6,0,710,189,260,11,2,462,27.1,77,2,12.6,1172,False,1,282,871,17,2,2024-10-28,False,False,False,0.7431740614334471,0.24061433447098976,0.014505119453924915,0.0017064846416382253,Off-Peak,Monday,October
2024-10-28 02:00:00,189,460,5,1,655,128,296,8,2,434,26.9,78,3,13.0,1089,False,2,317,756,13,3,2024-10-28,False,False,False,0.6942148760330579,0.2910927456382002,0.011937557392102846,0.0027548209366391185,Off-Peak,Monday,October
2024-10-28 03:00:00,125,381,7,0,513,191,235,10,3,439,26.8,78,1,13.8,952,False,3,316,616,17,3,2024-10-28,False,False,False,0.6470588235294118,0.3319327731092437,0.017857142857142856,0.0031512605042016808,Off-Peak,Monday,October
2024-10-28 04:00:00,143,342,5,0,490,202,271,9,2,484,26.7,78,1,14.6,974,False,4,345,613,14,2,2024-10-28,False,False,False,0.6293634496919918,0.3542094455852156,0.014373716632443531,0.002053388090349076,Off-Peak,Monday,October
2024-10-28 05:00:00,117,525,5,0,647,186,226,5,2,419,26.6,77,2,14.6,1066,False,5,303,751,10,2,2024-10-28,False,False,False,0.7045028142589118,0.28424015009380865,0.009380863039399626,0.001876172607879925,Shoulder,Monday,October
2024-10-28 06:00:00,146,340,6,1,493,103,312,7,1,423,26.4,78,3,15.7,916,False,6,249,652,13,2,2024-10-28,False,False,False,0.7117903930131004,0.2718340611353712,0.014192139737991267,0.002183406113537118,Shoulder,Monday,October
2024-10-28 07:00:00,119,533,6,2,660,118,301,7,3,429,26.4,81,3,15.5,1089,False,7,237,834,13,5,2024-10-28,False,False,False,0.7658402203856749,0.21763085399449036,0.011937557392102846,0.004591368227731864,Peak,Monday,October
2024-10-28 08:00:00,150,323,6,1,480,181,234,13,4,432,27.3,81,3,14.3,912,False,8,331,557,19,5,2024-10-28,False,False,False,0.6107456140350878,0.36293859649122806,0.020833333333333332,0.005482456140350877,Peak,Monday,October
2024-10-28 09:00:00,145,467,6,1,619,163,274,8,3,448,29.2,73,3,14.8,1067,False,9,308,741,14,4,2024-10-28,False,False,False,0.6944704779756327,0.28865979381443296,0.013120899718837863,0.0037488284910965324,Shoulder,Monday,October
2024-10-28 10:00:00,113,531,5,1,650,145,155,9,1,310,30.2,69,3,16.1,960,False,10,258,686,14,2,2024-10-28,False,False,False,0.7145833333333333,0.26875,0.014583333333333334,0.0020833333333333333,Shoulder,Monday,October
2024-10-28 11:00:00,119,384,5,1,509,181,234,8,3,426,31.3,65,3,14.8,935,False,11,300,618,13,4,2024-10-28,False,False,False,0.6609625668449198,0.32085561497326204,0.013903743315508022,0.0042780748663101605,Peak,Monday,October
2024-10-28 12:00:00,178,425,8,1,612,253,292,8,2,555,32.1,60,2,14.3,1167,False,12,431,717,16,3,2024-10-28,False,False,False,0.6143958868894601,0.3693230505569837,0.013710368466152529,0.002570694087403599,Peak,Monday,October
2024-10-28 13:00:00,107,453,7,1,568,155,185,8,2,350,32.6,58,0,15.7,918,False,13,262,638,15,3,2024-10-28,False,False,False,0.6949891067538126,0.28540305010893247,0.016339869281045753,0.0032679738562091504,Peak,Monday,October
2024-10-28 14:00:00,159,492,4,0,655,140,196,12,2,350,32.5,57,0,16.2,1005,False,14,299,688,16,2,2024-10-28,False,False,False,0.6845771144278607,0.2975124378109453,0.015920398009950248,0.001990049751243781,Peak,Monday,October
2024-10-28 15:00:00,132,489,6,0,627,222,255,7,3,487,32.3,58,0,15.8,1114,False,15,354,744,13,3,2024-10-28,False,False,False,0.6678635547576302,0.3177737881508079,0.011669658886894075,0.0026929982046678637,Peak,Monday,October
2024-10-28 16:00:00,120,346,3,2,471,176,204,6,2,388,31.9,60,0,13.7,859,False,16,296,550,9,4,2024-10-28,False,False,False,0.640279394644936,0.3445867287543655,0.010477299185098952,0.004656577415599534,Peak,Monday,October
2024-10-28 17:00:00,110,430,5,0,545,200,266,7,3,476,31.3,62,1,12.5,1021,False,17,310,696,12,3,2024-10-28,False,False,False,0.6816846229187071,0.3036238981390793,0.011753183153770812,0.002938295788442703,Peak,Monday,October
2024-10-28 18:00:00,102,484,4,2,592,208,228,8,2,446,30.6,65,0,12.3,1038,False,18,310,712,12,4,2024-10-28,False,False,False,0.6859344894026975,0.29865125240847784,0.011560693641618497,0.0038535645472061657,Peak,Monday,October
2024-10-28 19:00:00,146,382,5,1,534,198,255,8,2,463,29.7,67,3,12.6,997,False,19,344,637,13,3,2024-10-28,False,False,False,0.6389167502507522,0.34503510531594783,0.013039117352056168,0.003009027081243731,Peak,Monday,October
2024-10-28 20:00:00,138,403,5,0,546,219,308,8,3,538,29.3,74,0,12.2,1084,False,20,357,711,13,3,2024-10-28,False,False,False,0.6559040590405905,0.32933579335793356,0.011992619926199263,0.0027675276752767526,Shoulder,Monday,October
2024-10-28 21:00:00,78,568,4,0,650,164,224,6,3,397,28.8,72,3,11.3,1047,False,21,242,792,10,3,2024-10-28,False,False,False,0.7564469914040115,0.23113658070678128,0.009551098376313277,0.0028653295128939827,Shoulder,Monday,October
2024-10-28 22:00:00,74,566,6,2,648,161,253,9,2,425,28.2,73,1,12.2,1073,False,22,235,819,15,4,2024-10-28,False,False,False,0.7632805219012115,0.2190121155638397,0.013979496738117428,0.003727865796831314,Shoulder,Monday,October
2024-10-28 23:00:00,126,402,2,0,530,133,249,7,2,391,27.7,74,3,10.7,921,False,23,259,651,9,2,2024-10-28,False,False,False,0.7068403908794788,0.28121606948968514,0.009771986970684038,0.002171552660152009,Shoulder,Monday,October
2024-10-29 00:00:00,128,471,6,0,605,155,239,9,2,405,26.8,79,3,4.8,1010,False,0,283,710,15,2,2024-10-29,False,False,False,0.7029702970297029,0.2801980198019802,0.01485148514851485,0.0019801980198019802,Off-Peak,Tuesday,October
2024-10-29 01:00:00,124,556,5,1,686,196,234,9,1,440,26.9,77,3,7.2,1126,False,1,320,790,14,2,2024-10-29,False,False,False,0.7015985790408525,0.2841918294849023,0.012433392539964476,0.0017761989342806395,Off-Peak,Tuesday,October
2024-10-29 02:00:00,142,570,6,1,719,197,209,7,2,415,26.1,84,3,5.6,1134,False,2,339,779,13,3,2024-10-29,False,False,False,0.6869488536155203,0.29894179894179895,0.01146384479717813,0.0026455026455026454,Off-Peak,Tuesday,October
2024-10-29 03:00:00,131,511,5,1,648,194,224,5,2,425,26.1,81,3,6.2,1073,False,3,325,735,10,3,2024-10-29,False,False,False,0.684995340167754,0.30288909599254427,0.009319664492078284,0.0027958993476234857,Off-Peak,Tuesday,October
2024-10-29 04:00:00,88,387,6,0,481,124,274,9,2,409,26.2,83,3,9.9,890,False,4,212,661,15,2,2024-10-29,False,False,False,0.7426966292134831,0.23820224719101124,0.016853932584269662,0.0022471910112359553,Off-Peak,Tuesday,October
2024-10-29 05:00:00,153,435,5,0,593,120,181,6,2,309,26.3,85,3,12.5,902,False,5,273,616,11,2,2024-10-29,False,False,False,0.6829268292682927,0.3026607538802661,0.012195121951219513,0.0022172949002217295,Shoulder,Tuesday,October
2024-10-29 06:00:00,106,393,5,1,505,219,285,6,4,514,26.3,85,3,11.1,1019,False,6,325,678,11,5,2024-10-29,False,False,False,0.6653581943081452,0.31894013738959764,0.010794896957801767,0.004906771344455349,Shoulder,Tuesday,October
2024-10-29 07:00:00,127,384,3,1,515,241,238,8,2,489,26.2,84,3,10.9,1004,False,7,368,622,11,3,2024-10-29,False,False,False,0.6195219123505976,0.3665338645418327,0.010956175298804782,0.00298804780876494,Peak,Tuesday,October
2024-10-29 08:00:00,142,462,7,1,612,152,227,8,3,390,27.1,81,3,11.2,1002,False,8,294,689,15,4,2024-10-29,False,False,False,0.687624750499002,0.2934131736526946,0.014970059880239521,0.003992015968063872,Peak,Tuesday,October
2024-10-29 09:00:00,98,498,5,2,603,182,231,10,2,425,27.1,81,51,5.0,1028,False,9,280,729,15,4,2024-10-29,False,False,False,0.7091439688715954,0.2723735408560311,0.014591439688715954,0.0038910505836575876,Shoulder,Tuesday,October
2024-10-29 10:00:00,83,552,5,2,642,215,203,8,5,431,29.1,76,51,6.5,1073,False,10,298,755,13,7,2024-10-29,False,False,False,0.7036346691519105,0.2777260018639329,0.012115563839701771,0.0065237651444548,Shoulder,Tuesday,October
2024-10-29 11:00:00,159,554,6,1,720,166,266,8,4,444,30.8,69,51,11.2,1164,False,11,325,820,14,5,2024-10-29,False,False,False,0.7044673539518901,0.27920962199312716,0.012027491408934709,0.00429553264604811,Peak,Tuesday,October
2024-10-29 12:00:00,103,520,7,0,630,152,271,9,5,437,31.4,66,51,12.6,1067,False,12,255,791,16,5,2024-10-29,False,False,False,0.7413308341143393,0.23898781630740393,0.01499531396438613,0.004686035613870665,Peak,Tuesday,October
2024-10-29 13:00:00,123,468,6,0,597,172,265,10,2,449,31.8,63,51,12.1,1046,False,13,295,733,16,2,2024-10-29,False,False,False,0.7007648183556405,0.2820267686424474,0.015296367112810707,0.0019120458891013384,Peak,Tuesday,October
2024-10-29 14:00:00,89,471,5,2,567,193,174,11,2,380,32.0,62,3,13.3,947,False,14,282,645,16,4,2024-10-29,False,False,False,0.6810982048574445,0.29778247096092925,0.01689545934530095,0.004223864836325237,Peak,Tuesday,October
2024-10-29 15:00:00,88,434,6,0,528,161,337,9,1,508,31.8,62,3,14.2,1036,False,15,249,771,15,1,2024-10-29,False,False,False,0.7442084942084942,0.24034749034749034,0.01447876447876448,0.0009652509652509653,Peak,Tuesday,October
2024-10-29 16:00:00,120,518,7,1,646,175,275,10,3,463,31.8,61,3,12.5,1109,False,16,295,793,17,4,2024-10-29,False,False,False,0.715058611361587,0.2660054102795311,0.015329125338142471,0.0036068530207394047,Peak,Tuesday,October
2024-10-29 17:00:00,125,500,6,0,631,167,236,7,3,413,31.3,64,3,12.4,1044,False,17,292,736,13,3,2024-10-29,False,False,False,0.7049808429118773,0.2796934865900383,0.012452107279693486,0.0028735632183908046,Peak,Tuesday,October
2024-10-29 18:00:00,133,441,8,0,582,133,248,8,1,390,30.7,66,3,11.2,972,False,18,266,689,16,1,2024-10-29,False,False,False,0.7088477366255144,0.2736625514403292,0.01646090534979424,0.00102880658436214,Peak,Tuesday,October
2024-10-29 19:00:00,107,439,7,1,554,196,195,10,3,404,29.9,70,3,8.4,958,False,19,303,634,17,4,2024-10-29,False,False,False,0.6617954070981211,0.3162839248434238,0.017745302713987474,0.0041753653444676405,Peak,Tuesday,October
2024-10-29 20:00:00,136,631,6,1,774,157,249,8,1,415,29.3,72,3,10.4,1189,False,20,293,880,14,2,2024-10-29,False,False,False,0.7401177460050462,0.2464255677039529,0.011774600504625737,0.001682085786375105,Shoulder,Tuesday,October
2024-10-29 21:00:00,109,365,4,0,478,182,225,8,3,418,29.4,69,3,10.7,896,False,21,291,590,12,3,2024-10-29,False,False,False,0.6584821428571429,0.3247767857142857,0.013392857142857142,0.0033482142857142855,Shoulder,Tuesday,October
2024-10-29 22:00:00,152,453,7,0,612,162,228,7,1,398,29.2,70,3,13.2,1010,False,22,314,681,14,1,2024-10-29,False,False,False,0.6742574257425743,0.3108910891089109,0.013861386138613862,0.0009900990099009901,Shoulder,Tuesday,October
2024-10-29 23:00:00,80,327,4,0,411,193,295,11,2,501,28.6,72,3,11.7,912,False,23,273,622,15,2,2024-10-29,False,False,False,0.6820175438596491,0.2993421052631579,0.01644736842105263,0.0021929824561403508,Shoulder,Tuesday,October
2024-10-30 00:00:00,136,668,7,3,814,215,499,9,3,726,28.1,75,3,8.3,1540,False,0,351,1167,16,6,2024-10-30,False,False,True,0.7577922077922078,0.22792207792207791,0.01038961038961039,0.003896103896103896,Off-Peak,Wednesday,October
2024-10-30 01:00:00,152,707,8,1,868,277,661,10,3,951,27.6,79,3,7.7,1819,False,1,429,1368,18,4,2024-10-30,False,False,True,0.7520615722924684,0.23584387025838371,0.009895547003848268,0.0021990104452996153,Off-Peak,Wednesday,October
2024-10-30 02:00:00,135,679,7,3,824,217,656,12,4,889,27.1,83,3,8.2,1713,False,2,352,1335,19,7,2024-10-30,False,False,True,0.7793345008756567,0.20548744892002335,0.011091652072387624,0.004086398131932283,Off-Peak,Wednesday,October
2024-10-30 03:00:00,185,528,7,1,721,231,451,10,3,695,26.8,84,3,6.6,1416,False,3,416,979,17,4,2024-10-30,False,False,True,0.6913841807909604,0.2937853107344633,0.012005649717514125,0.002824858757062147,Off-Peak,Wednesday,October
2024-10-30 04:00:00,185,618,5,1,809,272,448,13,4,737,26.6,85,3,8.6,1546,False,4,457,1066,18,5,2024-10-30,False,False,True,0.6895213454075032,0.29560155239327296,0.01164294954721863,0.003234152652005175,Off-Peak,Wednesday,October
2024-10-30 05:00:00,165,528,6,0,699,159,620,11,2,792,26.7,86,3,9.5,1491,False,5,324,1148,17,2,2024-10-30,False,False,True,0.7699530516431925,0.21730382293762576,0.011401743796109993,0.0013413816230717639,Shoulder,Wednesday,October
2024-10-30 06:00:00,169,673,9,0,851,191,452,5,3,651,26.8,87,3,10.4,1502,False,6,360,1125,14,3,2024-10-30,False,False,True,0.7490013315579228,0.2396804260985353,0.009320905459387484,0.0019973368841544607,Shoulder,Wednesday,October
2024-10-30 07:00:00,156,731,5,5,897,250,547,6,1,804,26.8,86,3,10.9,1701,False,7,406,1278,11,6,2024-10-30,False,False,True,0.7513227513227513,0.23868312757201646,0.006466784244562022,0.003527336860670194,Peak,Wednesday,October
2024-10-30 08:00:00,141,534,7,2,684,195,167,12,3,377,27.4,82,3,11.4,1061,False,8,336,701,19,5,2024-10-30,False,False,False,0.6606974552309143,0.3166823751178134,0.017907634307257305,0.00471253534401508,Peak,Wednesday,October
2024-10-30 09:00:00,191,622,4,4,821,187,671,8,1,867,28.5,78,3,11.6,1688,False,9,378,1293,12,5,2024-10-30,False,False,True,0.7659952606635071,0.22393364928909953,0.0071090047393364926,0.002962085308056872,Shoulder,Wednesday,October
2024-10-30 10:00:00,134,582,5,4,725,179,503,10,1,693,29.9,71,3,13.2,1418,False,10,313,1085,15,5,2024-10-30,False,False,True,0.7651622002820875,0.22073342736248236,0.010578279266572637,0.003526093088857546,Shoulder,Wednesday,October
2024-10-30 11:00:00,140,675,7,1,823,195,689,10,2,896,31.4,63,3,14.7,1719,False,11,335,1364,17,3,2024-10-30,False,False,True,0.7934845840605003,0.1948807446189645,0.009889470622454915,0.0017452006980802793,Peak,Wednesday,October
2024-10-30 12:00:00,247,562,7,3,819,193,562,8,4,767,32.3,58,3,16.1,1586,False,12,440,1124,15,7,2024-10-30,False,False,True,0.7087011349306431,0.27742749054224464,0.009457755359394703,0.004413619167717529,Peak,Wednesday,October
2024-10-30 13:00:00,133,621,8,1,763,200,450,8,5,663,32.5,56,3,15.7,1426,False,13,333,1071,16,6,2024-10-30,False,False,True,0.7510518934081346,0.2335203366058906,0.011220196353436185,0.004207573632538569,Peak,Wednesday,October
2024-10-30 14:00:00,202,691,10,2,905,302,612,10,3,927,32.3,56,3,16.2,1832,False,14,504,1303,20,5,2024-10-30,False,False,True,0.7112445414847162,0.27510917030567683,0.010917030567685589,0.0027292576419213972,Peak,Wednesday,October
2024-10-30 15:00:00,161,781,7,2,951,190,609,9,2,810,32.2,58,3,17.7,1761,False,15,351,1390,16,4,2024-10-30,False,False,True,0.7893242475865985,0.19931856899488926,0.009085746734809767,0.002271436683702442,Peak,Wednesday,October
2024-10-30 16:00:00,125,691,4,3,823,232,674,10,1,917,32.3,57,3,15.8,1740,False,16,357,1365,14,4,2024-10-30,False,False,True,0.7844827586206896,0.20517241379310344,0.008045977011494253,0.0022988505747126436,Peak,Wednesday,October
2024-10-30 17:00:00,72,627,8,1,708,237,337,8,2,584,31.5,61,3,14.3,1292,False,17,309,964,16,3,2024-10-30,False,False,False,0.7461300309597523,0.23916408668730652,0.01238390092879257,0.0023219814241486067,Peak,Wednesday,October
2024-10-30 18:00:00,128,543,10,1,682,114,628,10,6,758,30.8,63,3,12.1,1440,False,18,242,1171,20,7,2024-10-30,False,False,True,0.8131944444444444,0.16805555555555557,0.013888888888888888,0.004861111111111111,Peak,Wednesday,October
2024-10-30 19:00:00,162,821,7,0,990,218,456,6,2,682,29.9,67,3,10.5,1672,False,19,380,1277,13,2,2024-10-30,False,False,True,0.763755980861244,0.22727272727272727,0.00777511961722488,0.0011961722488038277,Peak,Wednesday,October
2024-10-30 20:00:00,180,895,7,1,1083,147,399,6,1,553,29.3,70,3,10.1,1636,False,20,327,1294,13,2,2024-10-30,False,False,True,0.7909535452322738,0.19987775061124693,0.007946210268948655,0.0012224938875305623,Shoulder,Wednesday,October
2024-10-30 21:00:00,56,654,6,1,717,149,833,9,1,992,29.3,64,3,9.4,1709,False,21,205,1487,15,2,2024-10-30,False,False,True,0.8700994733762434,0.11995318899941486,0.008777062609713282,0.0011702750146284377,Shoulder,Wednesday,October
2024-10-30 22:00:00,167,682,7,2,858,209,459,13,4,685,29.0,67,3,9.8,1543,False,22,376,1141,20,6,2024-10-30,False,False,True,0.7394685677252106,0.2436811406351264,0.012961762799740765,0.0038885288399222295,Shoulder,Wednesday,October
2024-10-30 23:00:00,158,708,6,2,874,213,654,10,3,880,28.5,68,2,9.3,1754,False,23,371,1362,16,5,2024-10-30,False,False,True,0.7765108323831242,0.21151653363740022,0.009122006841505131,0.0028506271379703536,Shoulder,Wednesday,October
2024-10-31 00:00:00,162,728,3,1,894,162,545,12,2,721,28.2,68,3,8.2,1615,False,0,324,1273,15,3,2024-10-31,True,True,True,0.788235294117647,0.20061919504643963,0.009287925696594427,0.0018575851393188853,Off-Peak,Thursday,October
2024-10-31 01:00:00,138,488,5,2,633,169,484,11,4,668,27.7,72,3,8.7,1301,False,1,307,972,16,6,2024-10-31,True,True,False,0.7471176018447349,0.23597232897770945,0.012298232129131437,0.004611837048424289,Off-Peak,Thursday,October
2024-10-31 02:00:00,135,719,5,0,859,153,359,11,4,527,27.7,75,3,9.2,1386,False,2,288,1078,16,4,2024-10-31,True,True,True,0.7777777777777778,0.2077922077922078,0.011544011544011544,0.002886002886002886,Off-Peak,Thursday,October
2024-10-31 03:00:00,161,615,6,4,786,188,406,6,1,601,27.8,77,3,9.9,1387,False,3,349,1021,12,5,2024-10-31,True,True,True,0.7361211247296323,0.2516222062004326,0.008651766402307137,0.003604902667627974,Off-Peak,Thursday,October
2024-10-31 04:00:00,160,619,5,0,784,206,601,9,1,817,27.5,82,3,13.3,1601,False,4,366,1220,14,1,2024-10-31,True,True,True,0.7620237351655216,0.22860712054965646,0.008744534665833853,0.0006246096189881324,Off-Peak,Thursday,October
2024-10-31 05:00:00,195,661,5,0,861,281,565,11,3,860,27.4,84,3,16.6,1721,False,5,476,1226,16,3,2024-10-31,True,True,True,0.7123765252760024,0.27658338175479374,0.009296920395119116,0.0017431725740848344,Shoulder,Thursday,October
2024-10-31 06:00:00,86,645,6,3,740,172,379,10,3,564,26.8,83,3,17.4,1304,False,6,258,1024,16,6,2024-10-31,True,True,False,0.7852760736196319,0.19785276073619631,0.012269938650306749,0.004601226993865031,Shoulder,Thursday,October
2024-10-31 07:00:00,117,630,5,1,753,237,619,6,3,865,25.9,85,3,16.0,1618,False,7,354,1249,11,4,2024-10-31,True,True,True,0.7719406674907293,0.21878862793572312,0.006798516687268232,0.002472187886279357,Peak,Thursday,October
2024-10-31 08:00:00,143,607,3,4,757,108,459,5,5,577,26.6,82,3,14.0,1334,False,8,251,1066,8,9,2024-10-31,True,True,False,0.7991004497751124,0.18815592203898052,0.005997001499250375,0.006746626686656672,Peak,Thursday,October
2024-10-31 09:00:00,186,475,5,1,667,107,435,9,2,553,27.7,77,3,11.9,1220,False,9,293,910,14,3,2024-10-31,True,True,False,0.7459016393442623,0.24016393442622952,0.011475409836065573,0.002459016393442623,Shoulder,Thursday,October
2024-10-31 10:00:00,226,734,6,2,968,174,644,8,3,829,29.7,67,3,13.6,1797,False,10,400,1378,14,5,2024-10-31,True,True,True,0.766833611574847,0.22259321090706732,0.0077907623817473565,0.0027824151363383415,Shoulder,Thursday,October
2024-10-31 11:00:00,141,409,4,1,555,244,534,9,3,790,31.3,59,3,13.8,1345,False,11,385,943,13,4,2024-10-31,True,True,False,0.7011152416356877,0.2862453531598513,0.009665427509293681,0.002973977695167286,Peak,Thursday,October
2024-10-31 12:00:00,152,651,5,1,809,220,501,11,2,734,32.4,55,3,13.0,1543,False,12,372,1152,16,3,2024-10-31,True,True,True,0.7465975372650681,0.24108878807517822,0.010369410239792612,0.0019442644199611147,Peak,Thursday,October
2024-10-31 13:00:00,166,1021,5,2,1194,254,439,9,1,703,33.1,54,3,14.1,1897,False,13,420,1460,14,3,2024-10-31,True,True,True,0.7696362677912494,0.22140221402214022,0.007380073800738007,0.0015814443858724301,Peak,Thursday,October
2024-10-31 14:00:00,105,711,3,1,820,213,563,11,2,789,30.8,68,55,16.3,1609,False,14,318,1274,14,3,2024-10-31,True,True,True,0.7917961466749533,0.19763828464885022,0.00870105655686762,0.0018645121193287756,Peak,Thursday,October
2024-10-31 15:00:00,181,661,3,1,846,175,483,10,4,672,31.8,64,3,12.6,1518,False,15,356,1144,13,5,2024-10-31,True,True,True,0.7536231884057971,0.23451910408432147,0.008563899868247694,0.0032938076416337285,Peak,Thursday,October
2024-10-31 16:00:00,147,607,2,2,758,197,554,9,2,762,30.5,69,51,12.7,1520,False,16,344,1161,11,4,2024-10-31,True,True,True,0.7638157894736842,0.22631578947368422,0.007236842105263158,0.002631578947368421,Peak,Thursday,October
2024-10-31 17:00:00,146,468,6,1,621,205,566,10,1,782,30.3,68,3,13.8,1403,False,17,351,1034,16,2,2024-10-31,True,True,True,0.736992159657876,0.25017818959372773,0.011404133998574484,0.0014255167498218105,Peak,Thursday,October
2024-10-31 18:00:00,180,474,2,0,656,230,416,7,4,657,29.9,70,3,12.1,1313,False,18,410,890,9,4,2024-10-31,True,True,False,0.6778370144706778,0.31226199543031224,0.006854531607006854,0.0030464584920030465,Peak,Thursday,October
2024-10-31 19:00:00,134,813,3,0,950,241,738,11,2,992,29.6,71,3,13.5,1942,False,19,375,1551,14,2,2024-10-31,True,True,True,0.7986611740473738,0.19309989701338826,0.007209062821833162,0.0010298661174047373,Peak,Thursday,October
2024-10-31 20:00:00,107,647,3,2,759,243,446,11,3,703,28.8,73,3,8.9,1462,False,20,350,1093,14,5,2024-10-31,True,True,True,0.7476060191518468,0.2393980848153215,0.009575923392612859,0.003419972640218878,Shoulder,Thursday,October
2024-10-31 21:00:00,107,629,5,3,744,197,405,12,4,618,29.2,65,3,9.4,1362,False,21,304,1034,17,7,2024-10-31,True,True,False,0.7591776798825257,0.22320117474302498,0.012481644640234948,0.005139500734214391,Shoulder,Thursday,October
2024-10-31 22:00:00,124,556,4,2,686,192,559,10,1,762,28.8,66,3,10.8,1448,False,22,316,1115,14,3,2024-10-31,True,True,True,0.7700276243093923,0.21823204419889503,0.009668508287292817,0.0020718232044198894,Shoulder,Thursday,October
2024-10-31 23:00:00,202,780,3,1,986,248,481,8,3,740,28.3,70,3,9.6,1726,False,23,450,1261,11,4,2024-10-31,True,True,True,0.7305909617612978,0.2607184241019699,0.006373117033603708,0.002317497103128621,Shoulder,Thursday,October
2024-11-01 00:00:00,60,228,10,0,298,78,101,4,0,183,28.3,72,3,9.8,481,False,0,138,329,14,0,2024-11-01,False,True,False,0.683991683991684,0.2869022869022869,0.029106029106029108,0.0,Off-Peak,Friday,November
2024-11-01 01:00:00,67,192,10,0,269,60,91,6,0,157,28.0,75,3,9.3,426,False,1,127,283,16,0,2024-11-01,False,True,False,0.6643192488262911,0.2981220657276995,0.03755868544600939,0.0,Off-Peak,Friday,November
2024-11-01 02:00:00,60,147,10,1,218,45,83,6,0,134,27.8,78,3,8.6,352,False,2,105,230,16,1,2024-11-01,False,True,False,0.6534090909090909,0.29829545454545453,0.045454545454545456,0.002840909090909091,Off-Peak,Friday,November
2024-11-01 03:00:00,53,183,11,1,248,36,50,4,0,90,27.5,79,3,9.6,338,False,3,89,233,15,1,2024-11-01,False,True,False,0.6893491124260355,0.26331360946745563,0.04437869822485207,0.0029585798816568047,Off-Peak,Friday,November
2024-11-01 04:00:00,34,115,11,2,162,48,30,7,0,85,27.2,80,3,14.1,247,False,4,82,145,18,2,2024-11-01,False,True,False,0.5870445344129555,0.3319838056680162,0.0728744939271255,0.008097165991902834,Off-Peak,Friday,November
2024-11-01 05:00:00,36,355,11,1,403,57,56,5,1,119,26.7,84,3,13.9,522,False,5,93,411,16,2,2024-11-01,False,True,False,0.7873563218390804,0.1781609195402299,0.03065134099616858,0.0038314176245210726,Shoulder,Friday,November
2024-11-01 06:00:00,94,459,9,1,563,103,214,6,2,325,26.4,86,3,15.2,888,False,6,197,673,15,3,2024-11-01,False,True,False,0.7578828828828829,0.22184684684684686,0.016891891891891893,0.0033783783783783786,Shoulder,Friday,November
2024-11-01 07:00:00,130,651,10,1,792,178,450,5,1,634,26.1,88,3,13.0,1426,False,7,308,1101,15,2,2024-11-01,False,True,True,0.7720897615708275,0.21598877980364656,0.010518934081346423,0.001402524544179523,Peak,Friday,November
2024-11-01 08:00:00,99,487,12,1,599,100,484,7,1,592,26.8,84,3,14.5,1191,False,8,199,971,19,2,2024-11-01,False,True,False,0.815281276238455,0.1670864819479429,0.01595298068849706,0.0016792611251049538,Peak,Friday,November
2024-11-01 09:00:00,91,587,10,1,689,120,402,8,1,531,26.9,81,3,13.9,1220,False,9,211,989,18,2,2024-11-01,False,True,False,0.8106557377049181,0.17295081967213113,0.014754098360655738,0.001639344262295082,Shoulder,Friday,November
2024-11-01 10:00:00,96,544,12,1,653,107,476,8,1,592,28.6,74,3,14.5,1245,False,10,203,1020,20,2,2024-11-01,False,True,False,0.8192771084337349,0.16305220883534136,0.01606425702811245,0.001606425702811245,Shoulder,Friday,November
2024-11-01 11:00:00,113,604,10,1,728,103,433,6,1,543,30.2,65,1,15.9,1271,False,11,216,1037,16,2,2024-11-01,False,True,False,0.8158929976396538,0.16994492525570418,0.012588512981904013,0.0015735641227380016,Peak,Friday,November
2024-11-01 12:00:00,149,605,9,1,764,139,480,7,1,627,31.5,58,3,15.3,1391,False,12,288,1085,16,2,2024-11-01,False,True,True,0.7800143781452192,0.2070452911574407,0.011502516175413372,0.0014378145219266715,Peak,Friday,November
2024-11-01 13:00:00,140,504,11,1,656,168,421,8,1,598,32.3,53,3,16.6,1254,False,13,308,925,19,2,2024-11-01,False,True,False,0.7376395534290271,0.24561403508771928,0.015151515151515152,0.001594896331738437,Peak,Friday,November
2024-11-01 14:00:00,90,576,13,1,680,123,467,9,1,600,31.8,56,3,16.5,1280,False,14,213,1043,22,2,2024-11-01,False,True,False,0.81484375,0.16640625,0.0171875,0.0015625,Peak,Friday,November
2024-11-01 15:00:00,93,590,13,1,697,116,0,7,1,124,31.3,59,51,16.8,821,False,15,209,590,20,2,2024-11-01,False,True,False,0.7186358099878197,0.2545676004872107,0.024360535931790498,0.00243605359317905,Peak,Friday,November
2024-11-01 16:00:00,95,589,13,1,698,120,442,7,1,570,31.0,63,51,16.5,1268,False,16,215,1031,20,2,2024-11-01,False,True,False,0.8130914826498423,0.1695583596214511,0.015772870662460567,0.0015772870662460567,Peak,Friday,November
2024-11-01 17:00:00,84,599,11,1,695,180,472,6,1,659,30.3,67,3,16.6,1354,False,17,264,1071,17,2,2024-11-01,False,True,False,0.7909896602658789,0.19497784342688332,0.012555391432791729,0.0014771048744460858,Peak,Friday,November
2024-11-01 18:00:00,94,566,13,1,674,170,451,11,1,633,29.6,71,3,18.5,1307,False,18,264,1017,24,2,2024-11-01,False,True,False,0.7781178270849273,0.2019892884468248,0.018362662586074982,0.001530221882172915,Peak,Friday,November
2024-11-01 19:00:00,100,595,13,1,709,159,425,10,1,595,28.8,76,3,17.0,1304,False,19,259,1020,23,2,2024-11-01,False,True,False,0.7822085889570553,0.19861963190184048,0.01763803680981595,0.0015337423312883436,Peak,Friday,November
2024-11-01 20:00:00,85,663,13,1,762,152,455,9,0,616,28.7,75,3,17.3,1378,False,20,237,1118,22,1,2024-11-01,False,True,True,0.8113207547169812,0.17198838896952104,0.015965166908563134,0.000725689404934688,Shoulder,Friday,November
2024-11-01 21:00:00,86,672,10,1,769,143,424,6,0,573,29.1,70,3,12.0,1342,False,21,229,1096,16,1,2024-11-01,False,True,False,0.8166915052160953,0.1706408345752608,0.011922503725782414,0.0007451564828614009,Shoulder,Friday,November
2024-11-01 22:00:00,100,558,10,1,669,130,335,5,0,470,28.6,72,3,12.3,1139,False,22,230,893,15,1,2024-11-01,False,True,False,0.7840210711150132,0.2019315188762072,0.013169446883230905,0.000877963125548727,Shoulder,Friday,November
2024-11-01 23:00:00,113,437,14,1,565,101,260,5,0,366,28.2,76,3,11.7,931,False,23,214,697,19,1,2024-11-01,False,True,False,0.748657357679914,0.22986036519871106,0.02040816326530612,0.0010741138560687433,Shoulder,Friday,November
2024-11-02 00:00:00,74,289,9,0,372,137,326,9,0,472,28.0,78,3,9.9,844,True,0,211,615,18,0,2024-11-02,False,False,False,0.7286729857819905,0.25,0.02132701421800948,0.0,Off-Peak,Saturday,November
2024-11-02 01:00:00,83,138,9,0,230,128,222,8,0,358,27.8,79,3,10.1,588,True,1,211,360,17,0,2024-11-02,False,False,False,0.6122448979591837,0.358843537414966,0.02891156462585034,0.0,Off-Peak,Saturday,November
2024-11-02 02:00:00,97,169,8,0,274,155,155,7,0,317,27.6,79,3,12.7,591,True,2,252,324,15,0,2024-11-02,False,False,False,0.5482233502538071,0.4263959390862944,0.025380710659898477,0.0,Off-Peak,Saturday,November
2024-11-02 03:00:00,88,199,6,0,293,132,150,8,0,290,27.5,78,3,13.2,583,True,3,220,349,14,0,2024-11-02,False,False,False,0.5986277873070326,0.37735849056603776,0.024013722126929673,0.0,Off-Peak,Saturday,November
2024-11-02 04:00:00,85,162,7,0,254,157,122,7,1,287,26.9,80,51,12.9,541,True,4,242,284,14,1,2024-11-02,False,False,False,0.5249537892791127,0.44731977818853974,0.025878003696857672,0.0018484288354898336,Off-Peak,Saturday,November
2024-11-02 05:00:00,73,122,12,0,207,149,376,7,1,533,26.6,82,3,14.3,740,True,5,222,498,19,1,2024-11-02,False,False,False,0.672972972972973,0.3,0.025675675675675677,0.0013513513513513514,Shoulder,Saturday,November
2024-11-02 06:00:00,78,455,12,2,547,118,319,7,1,445,25.6,88,53,14.9,992,True,6,196,774,19,3,2024-11-02,False,False,False,0.780241935483871,0.1975806451612903,0.019153225806451613,0.0030241935483870967,Shoulder,Saturday,November
2024-11-02 07:00:00,86,607,13,2,708,124,633,7,1,765,25.5,89,53,15.2,1473,True,7,210,1240,20,3,2024-11-02,False,False,True,0.8418194161575017,0.1425661914460285,0.013577732518669382,0.002036659877800407,Peak,Saturday,November
2024-11-02 08:00:00,90,537,15,2,644,123,636,8,1,768,26.3,86,3,11.0,1412,True,8,213,1173,23,3,2024-11-02,False,False,True,0.8307365439093485,0.1508498583569405,0.016288951841359773,0.002124645892351275,Peak,Saturday,November
2024-11-02 09:00:00,95,511,15,1,622,164,614,6,1,785,25.9,90,53,6.4,1407,True,9,259,1125,21,2,2024-11-02,False,False,True,0.7995735607675906,0.18407960199004975,0.014925373134328358,0.0014214641080312722,Shoulder,Saturday,November
2024-11-02 10:00:00,81,547,10,1,639,184,541,8,1,734,26.8,85,51,10.2,1373,True,10,265,1088,18,2,2024-11-02,False,False,False,0.7924253459577567,0.1930080116533139,0.013109978150036417,0.0014566642388929353,Shoulder,Saturday,November
2024-11-02 11:00:00,74,535,13,1,623,182,551,7,1,741,27.0,84,51,10.1,1364,True,11,256,1086,20,2,2024-11-02,False,False,False,0.7961876832844574,0.187683284457478,0.01466275659824047,0.001466275659824047,Peak,Saturday,November
2024-11-02 12:00:00,67,651,17,1,736,155,548,9,2,714,27.9,80,3,9.9,1450,True,12,222,1199,26,3,2024-11-02,False,False,True,0.8268965517241379,0.15310344827586206,0.01793103448275862,0.0020689655172413794,Peak,Saturday,November
2024-11-02 13:00:00,114,538,14,1,667,180,528,9,1,718,28.5,76,3,12.9,1385,True,13,294,1066,23,2,2024-11-02,False,False,True,0.7696750902527075,0.21227436823104692,0.01660649819494585,0.001444043321299639,Peak,Saturday,November
2024-11-02 14:00:00,86,517,10,1,614,119,412,7,1,539,29.4,66,3,12.5,1153,True,14,205,929,17,2,2024-11-02,False,False,False,0.805724197745013,0.17779705117085862,0.014744145706851692,0.0017346053772766695,Peak,Saturday,November
2024-11-02 15:00:00,114,518,11,1,644,151,421,8,1,581,30.4,62,3,11.7,1225,True,15,265,939,19,2,2024-11-02,False,False,False,0.7665306122448979,0.2163265306122449,0.015510204081632653,0.0016326530612244899,Peak,Saturday,November
2024-11-02 16:00:00,71,556,10,1,638,193,531,9,1,734,29.8,66,3,12.9,1372,True,16,264,1087,19,2,2024-11-02,False,False,False,0.7922740524781341,0.1924198250728863,0.013848396501457727,0.0014577259475218659,Peak,Saturday,November
2024-11-02 17:00:00,89,597,10,1,697,174,533,11,1,719,29.1,71,3,13.7,1416,True,17,263,1130,21,2,2024-11-02,False,False,True,0.7980225988700564,0.18573446327683615,0.014830508474576272,0.0014124293785310734,Peak,Saturday,November
2024-11-02 18:00:00,80,541,12,1,634,181,378,9,1,569,28.6,74,3,16.0,1203,True,18,261,919,21,2,2024-11-02,False,False,False,0.7639235245220283,0.2169576059850374,0.017456359102244388,0.0016625103906899418,Peak,Saturday,November
2024-11-02 19:00:00,85,538,11,1,635,154,536,7,1,698,28.1,76,3,12.6,1333,True,19,239,1074,18,2,2024-11-02,False,False,False,0.805701425356339,0.17929482370592648,0.01350337584396099,0.0015003750937734434,Peak,Saturday,November
2024-11-02 20:00:00,105,665,12,2,784,140,520,7,1,668,28.0,78,3,13.3,1452,True,20,245,1185,19,3,2024-11-02,False,False,True,0.8161157024793388,0.16873278236914602,0.013085399449035813,0.002066115702479339,Shoulder,Saturday,November
2024-11-02 21:00:00,121,504,15,2,642,103,428,7,1,539,27.9,74,3,11.5,1181,True,21,224,932,22,3,2024-11-02,False,False,False,0.7891617273497037,0.1896697713801863,0.018628281117696866,0.002540220152413209,Shoulder,Saturday,November
2024-11-02 22:00:00,69,436,11,2,518,172,543,11,1,727,27.5,75,3,11.8,1245,True,22,241,979,22,3,2024-11-02,False,False,False,0.7863453815261044,0.19357429718875502,0.017670682730923693,0.0024096385542168677,Shoulder,Saturday,November
2024-11-02 23:00:00,78,420,13,0,511,141,593,8,1,743,27.1,77,3,10.0,1254,True,23,219,1013,21,1,2024-11-02,False,False,False,0.8078149920255183,0.17464114832535885,0.01674641148325359,0.0007974481658692185,Shoulder,Saturday,November
2024-11-03 00:00:00,74,389,9,0,472,182,320,9,0,511,26.7,79,3,8.9,983,True,0,256,709,18,0,2024-11-03,False,False,False,0.7212614445574771,0.26042726347914547,0.018311291963377416,0.0,Off-Peak,Sunday,November
2024-11-03 01:00:00,83,238,9,0,330,207,269,7,0,483,26.5,81,3,6.0,813,True,1,290,507,16,0,2024-11-03,False,False,False,0.6236162361623616,0.35670356703567035,0.01968019680196802,0.0,Off-Peak,Sunday,November
2024-11-03 02:00:00,97,169,8,0,274,198,172,3,0,373,26.4,83,3,7.2,647,True,2,295,341,11,0,2024-11-03,False,False,False,0.527047913446677,0.4559505409582689,0.017001545595054096,0.0,Off-Peak,Sunday,November
2024-11-03 03:00:00,88,199,6,0,293,189,182,5,0,376,26.3,83,3,7.3,669,True,3,277,381,11,0,2024-11-03,False,False,False,0.5695067264573991,0.414050822122571,0.016442451420029897,0.0,Off-Peak,Sunday,November
2024-11-03 04:00:00,85,162,7,0,254,151,181,3,1,336,26.1,84,3,8.7,590,True,4,236,343,10,1,2024-11-03,False,False,False,0.5813559322033899,0.4,0.01694915254237288,0.001694915254237288,Off-Peak,Sunday,November
2024-11-03 05:00:00,73,222,12,1,308,221,314,4,1,540,26.0,84,3,8.5,848,True,5,294,536,16,2,2024-11-03,False,False,False,0.6320754716981132,0.3466981132075472,0.018867924528301886,0.0023584905660377358,Shoulder,Sunday,November
2024-11-03 06:00:00,78,455,12,2,547,204,621,5,1,831,25.7,85,3,8.8,1378,True,6,282,1076,17,3,2024-11-03,False,False,True,0.7808417997097242,0.204644412191582,0.012336719883889695,0.0021770682148040637,Shoulder,Sunday,November
2024-11-03 07:00:00,86,607,13,2,708,158,617,7,2,784,25.7,85,3,9.7,1492,True,7,244,1224,20,4,2024-11-03,False,False,True,0.8203753351206434,0.16353887399463807,0.013404825737265416,0.002680965147453083,Peak,Sunday,November
2024-11-03 08:00:00,90,637,15,2,744,171,655,8,1,835,27.0,81,3,9.4,1579,True,8,261,1292,23,3,2024-11-03,False,False,True,0.818239392020266,0.16529449018366055,0.014566181127295756,0.0018999366687777073,Peak,Sunday,November
2024-11-03 09:00:00,95,461,15,1,572,183,632,6,1,822,28.8,69,3,9.0,1394,True,9,278,1093,21,2,2024-11-03,False,False,True,0.7840746054519369,0.1994261119081779,0.015064562410329985,0.0014347202295552368,Shoulder,Sunday,November
2024-11-03 10:00:00,81,477,17,2,577,179,698,8,1,886,29.8,64,3,10.7,1463,True,10,260,1175,25,3,2024-11-03,False,False,True,0.8031442241968558,0.17771701982228297,0.017088174982911826,0.002050580997949419,Shoulder,Sunday,November
2024-11-03 11:00:00,74,635,13,1,723,165,646,7,1,819,31.2,57,3,11.7,1542,True,11,239,1281,20,2,2024-11-03,False,False,True,0.830739299610895,0.1549935149156939,0.01297016861219196,0.0012970168612191958,Peak,Sunday,November
2024-11-03 12:00:00,67,551,17,1,636,150,685,9,2,846,32.4,52,3,13.5,1482,True,12,217,1236,26,3,2024-11-03,False,False,True,0.8340080971659919,0.14642375168690958,0.017543859649122806,0.0020242914979757085,Peak,Sunday,November
2024-11-03 13:00:00,114,538,14,1,667,234,545,9,1,789,32.7,53,51,14.2,1456,True,13,348,1083,23,2,2024-11-03,False,False,True,0.7438186813186813,0.23901098901098902,0.015796703296703296,0.0013736263736263737,Peak,Sunday,November
2024-11-03 14:00:00,86,517,18,2,623,196,610,7,1,814,32.7,55,3,15.1,1437,True,14,282,1127,25,3,2024-11-03,False,False,True,0.7842727905358385,0.19624217118997914,0.017397355601948505,0.0020876826722338203,Peak,Sunday,November
2024-11-03 15:00:00,114,418,11,1,544,223,545,8,1,777,31.0,67,51,15.0,1321,True,15,337,963,19,2,2024-11-03,False,False,False,0.728993186979561,0.25510976532929597,0.014383043149129448,0.001514004542013626,Peak,Sunday,November
2024-11-03 16:00:00,71,556,15,2,644,205,591,9,1,806,30.5,66,3,15.9,1450,True,16,276,1147,24,3,2024-11-03,False,False,True,0.7910344827586206,0.19034482758620688,0.016551724137931035,0.0020689655172413794,Peak,Sunday,November
2024-11-03 17:00:00,89,597,14,1,701,167,572,11,2,752,29.6,72,51,12.3,1453,True,17,256,1169,25,3,2024-11-03,False,False,True,0.8045423262216105,0.17618719889883,0.017205781142463867,0.0020646937370956643,Peak,Sunday,November
2024-11-03 18:00:00,83,580,12,1,676,169,587,9,1,766,29.0,75,3,10.8,1442,True,18,252,1167,21,2,2024-11-03,False,False,True,0.8092926490984743,0.17475728155339806,0.014563106796116505,0.0013869625520110957,Peak,Sunday,November
2024-11-03 19:00:00,85,538,11,1,635,193,627,7,1,828,28.0,78,3,6.5,1463,True,19,278,1165,18,2,2024-11-03,False,False,True,0.7963089542036911,0.1900205058099795,0.012303485987696514,0.001367053998632946,Peak,Sunday,November
2024-11-03 20:00:00,105,465,12,2,584,219,592,7,1,819,27.6,81,3,4.8,1403,True,20,324,1057,19,3,2024-11-03,False,False,True,0.7533856022808268,0.23093371347113328,0.0135424091233072,0.0021382751247327157,Shoulder,Sunday,November
2024-11-03 21:00:00,121,504,15,2,642,162,495,7,1,665,27.6,79,3,6.1,1307,True,21,283,999,22,3,2024-11-03,False,False,False,0.764345830145371,0.21652639632746748,0.016832440703902066,0.0022953328232593728,Shoulder,Sunday,November
2024-11-03 22:00:00,169,536,11,2,718,181,527,11,1,720,27.4,78,3,5.0,1438,True,22,350,1063,22,3,2024-11-03,False,False,True,0.739221140472879,0.24339360222531292,0.015299026425591099,0.002086230876216968,Shoulder,Sunday,November
2024-11-03 23:00:00,78,420,13,0,511,149,432,8,1,590,27.0,80,3,5.6,1101,True,23,227,852,21,1,2024-11-03,False,False,False,0.773841961852861,0.2061762034514078,0.01907356948228883,0.0009082652134423251,Shoulder,Sunday,November
2024-11-04 00:00:00,73,234,9,0,316,84,204,3,0,291,26.5,85,3,6.1,607,False,0,157,438,12,0,2024-11-04,False,False,False,0.7215815485996705,0.2586490939044481,0.019769357495881382,0.0,Off-Peak,Monday,November
2024-11-04 01:00:00,66,179,9,0,254,110,112,4,0,226,25.9,88,2,6.9,480,False,1,176,291,13,0,2024-11-04,False,False,False,0.60625,0.36666666666666664,0.027083333333333334,0.0,Off-Peak,Monday,November
2024-11-04 02:00:00,66,185,8,0,259,100,202,5,0,307,25.7,87,3,5.4,566,False,2,166,387,13,0,2024-11-04,False,False,False,0.6837455830388692,0.29328621908127206,0.022968197879858657,0.0,Off-Peak,Monday,November
2024-11-04 03:00:00,92,127,6,0,225,77,167,4,0,248,25.6,87,3,7.1,473,False,3,169,294,10,0,2024-11-04,False,False,False,0.6215644820295984,0.3572938689217759,0.021141649048625793,0.0,Off-Peak,Monday,November
2024-11-04 04:00:00,69,191,7,0,267,95,173,8,0,276,25.1,88,3,8.6,543,False,4,164,364,15,0,2024-11-04,False,False,False,0.6703499079189686,0.3020257826887661,0.027624309392265192,0.0,Off-Peak,Monday,November
2024-11-04 05:00:00,72,229,12,1,314,89,210,4,0,303,24.6,91,3,4.8,617,False,5,161,439,16,1,2024-11-04,False,False,False,0.7115072933549432,0.26094003241491087,0.02593192868719611,0.0016207455429497568,Shoulder,Monday,November
2024-11-04 06:00:00,74,431,12,2,519,105,324,5,0,434,24.7,89,3,5.3,953,False,6,179,755,17,2,2024-11-04,False,False,False,0.7922350472193075,0.18782791185729275,0.017838405036726127,0.002098635886673662,Shoulder,Monday,November
2024-11-04 07:00:00,68,658,13,2,741,78,525,4,0,607,24.5,93,61,6.0,1348,False,7,146,1183,17,2,2024-11-04,False,False,False,0.8775964391691394,0.1083086053412463,0.012611275964391691,0.001483679525222552,Peak,Monday,November
2024-11-04 08:00:00,65,507,12,2,586,87,217,4,0,308,24.4,94,53,7.1,894,False,8,152,724,16,2,2024-11-04,False,False,False,0.8098434004474273,0.17002237136465326,0.017897091722595078,0.0022371364653243847,Peak,Monday,November
2024-11-04 09:00:00,55,467,11,1,534,97,208,5,1,311,25.3,90,55,2.1,845,False,9,152,675,16,2,2024-11-04,False,False,False,0.7988165680473372,0.17988165680473372,0.01893491124260355,0.002366863905325444,Shoulder,Monday,November
2024-11-04 10:00:00,63,420,12,2,497,63,235,5,1,304,26.1,88,55,4.4,801,False,10,126,655,17,3,2024-11-04,False,False,False,0.8177278401997503,0.15730337078651685,0.02122347066167291,0.003745318352059925,Shoulder,Monday,November
2024-11-04 11:00:00,90,478,13,1,582,103,326,5,1,435,26.6,85,53,5.4,1017,False,11,193,804,18,2,2024-11-04,False,False,False,0.7905604719764012,0.18977384464110128,0.017699115044247787,0.0019665683382497543,Peak,Monday,November
2024-11-04 12:00:00,90,437,11,1,539,96,303,4,1,404,27.2,82,51,3.5,943,False,12,186,740,15,2,2024-11-04,False,False,False,0.7847295864262991,0.19724284199363734,0.015906680805938492,0.0021208907741251328,Peak,Monday,November
2024-11-04 13:00:00,61,446,8,1,516,60,240,5,1,306,28.5,76,51,4.3,822,False,13,121,686,13,2,2024-11-04,False,False,False,0.8345498783454988,0.14720194647201945,0.015815085158150853,0.0024330900243309003,Peak,Monday,November
2024-11-04 14:00:00,78,434,9,1,522,100,203,5,1,309,29.3,70,3,6.7,831,False,14,178,637,14,2,2024-11-04,False,False,False,0.766546329723225,0.21419975932611313,0.01684717208182912,0.0024067388688327317,Peak,Monday,November
2024-11-04 15:00:00,90,335,11,1,437,68,323,5,1,397,30.0,66,3,8.5,834,False,15,158,658,16,2,2024-11-04,False,False,False,0.7889688249400479,0.18944844124700239,0.019184652278177457,0.002398081534772182,Peak,Monday,November
2024-11-04 16:00:00,61,413,14,2,490,70,310,6,1,387,29.8,66,3,9.5,877,False,16,131,723,20,3,2024-11-04,False,False,False,0.8244013683010262,0.14937286202964653,0.02280501710376283,0.0034207525655644243,Peak,Monday,November
2024-11-04 17:00:00,94,553,13,1,661,90,269,6,1,366,28.9,69,3,10.2,1027,False,17,184,822,19,2,2024-11-04,False,False,False,0.8003894839337877,0.17916260954235638,0.018500486854917234,0.0019474196689386564,Peak,Monday,November
2024-11-04 18:00:00,90,383,12,2,487,84,200,6,1,291,28.1,72,3,8.0,778,False,18,174,583,18,3,2024-11-04,False,False,False,0.7493573264781491,0.2236503856041131,0.02313624678663239,0.0038560411311053984,Peak,Monday,November
2024-11-04 19:00:00,67,477,11,1,556,104,208,6,1,319,27.2,76,3,7.4,875,False,19,171,685,17,2,2024-11-04,False,False,False,0.7828571428571428,0.19542857142857142,0.019428571428571427,0.002285714285714286,Peak,Monday,November
2024-11-04 20:00:00,85,487,12,2,586,68,298,7,1,374,26.8,80,3,8.8,960,False,20,153,785,19,3,2024-11-04,False,False,False,0.8177083333333334,0.159375,0.019791666666666666,0.003125,Shoulder,Monday,November
2024-11-04 21:00:00,56,473,8,2,539,83,310,6,1,400,26.8,88,3,3.6,939,False,21,139,783,14,3,2024-11-04,False,False,False,0.8338658146964856,0.14802981895633652,0.014909478168264111,0.003194888178913738,Shoulder,Monday,November
2024-11-04 22:00:00,72,430,11,2,515,106,300,5,1,412,26.5,86,3,2.7,927,False,22,178,730,16,3,2024-11-04,False,False,False,0.7874865156418555,0.19201725997842503,0.017259978425026967,0.003236245954692557,Shoulder,Monday,November
2024-11-04 23:00:00,85,349,13,0,447,63,289,5,0,357,26.3,86,3,3.4,804,False,23,148,638,18,0,2024-11-04,False,False,False,0.7935323383084577,0.18407960199004975,0.022388059701492536,0.0,Shoulder,Monday,November
2024-11-05 00:00:00,73,134,9,0,216,84,304,3,0,391,25.9,87,3,2.9,607,False,0,157,438,12,0,2024-11-05,False,False,False,0.7215815485996705,0.2586490939044481,0.019769357495881382,0.0,Off-Peak,Tuesday,November
2024-11-05 01:00:00,66,179,9,0,254,110,212,4,0,326,25.6,88,3,4.7,580,False,1,176,391,13,0,2024-11-05,False,False,False,0.6741379310344827,0.30344827586206896,0.022413793103448276,0.0,Off-Peak,Tuesday,November
2024-11-05 02:00:00,36,185,8,0,229,100,202,5,0,307,25.3,90,3,4.9,536,False,2,136,387,13,0,2024-11-05,False,False,False,0.7220149253731343,0.2537313432835821,0.024253731343283583,0.0,Off-Peak,Tuesday,November
2024-11-05 03:00:00,50,187,6,0,243,77,167,4,0,248,25.2,91,3,3.2,491,False,3,127,354,10,0,2024-11-05,False,False,False,0.7209775967413442,0.25865580448065173,0.020366598778004074,0.0,Off-Peak,Tuesday,November
2024-11-05 04:00:00,29,191,7,0,227,95,273,8,0,376,25.1,91,3,5.3,603,False,4,124,464,15,0,2024-11-05,False,False,False,0.7694859038142621,0.20563847429519072,0.024875621890547265,0.0,Off-Peak,Tuesday,November
2024-11-05 05:00:00,22,329,9,1,361,89,210,4,0,303,24.9,92,3,3.1,664,False,5,111,539,13,1,2024-11-05,False,False,False,0.8117469879518072,0.16716867469879518,0.01957831325301205,0.0015060240963855422,Shoulder,Tuesday,November
2024-11-05 06:00:00,44,331,8,1,384,105,324,5,0,434,24.6,94,3,8.9,818,False,6,149,655,13,1,2024-11-05,False,False,False,0.8007334963325183,0.1821515892420538,0.01589242053789731,0.0012224938875305623,Shoulder,Tuesday,November
2024-11-05 07:00:00,68,558,6,1,633,178,225,6,0,409,24.9,92,3,7.6,1042,False,7,246,783,12,1,2024-11-05,False,False,False,0.7514395393474088,0.236084452975048,0.011516314779270634,0.0009596928982725527,Peak,Tuesday,November
2024-11-05 08:00:00,65,407,7,1,480,87,217,7,0,311,26.1,86,1,5.0,791,False,8,152,624,14,1,2024-11-05,False,False,False,0.7888748419721872,0.19216182048040456,0.017699115044247787,0.0012642225031605564,Peak,Tuesday,November
2024-11-05 09:00:00,55,467,8,1,531,97,238,5,1,341,28.1,78,1,7.3,872,False,9,152,705,13,2,2024-11-05,False,False,False,0.8084862385321101,0.1743119266055046,0.014908256880733946,0.0022935779816513763,Shoulder,Tuesday,November
2024-11-05 10:00:00,63,420,5,1,489,93,235,6,1,335,28.8,75,51,7.3,824,False,10,156,655,11,2,2024-11-05,False,False,False,0.7949029126213593,0.18932038834951456,0.013349514563106795,0.0024271844660194173,Shoulder,Tuesday,November
2024-11-05 11:00:00,50,448,5,1,504,103,326,5,1,435,29.8,69,3,7.9,939,False,11,153,774,10,2,2024-11-05,False,False,False,0.8242811501597445,0.16293929712460065,0.010649627263045794,0.002129925452609159,Peak,Tuesday,November
2024-11-05 12:00:00,53,437,7,1,498,96,303,4,1,404,29.9,69,3,9.3,902,False,12,149,740,11,2,2024-11-05,False,False,False,0.8203991130820399,0.16518847006651885,0.012195121951219513,0.0022172949002217295,Peak,Tuesday,November
2024-11-05 13:00:00,61,346,8,1,416,60,243,7,1,311,30.5,67,3,9.8,727,False,13,121,589,15,2,2024-11-05,False,False,False,0.8101788170563962,0.16643741403026135,0.02063273727647868,0.002751031636863824,Peak,Tuesday,November
2024-11-05 14:00:00,78,434,9,1,522,100,203,5,1,309,30.5,67,3,11.6,831,False,14,178,637,14,2,2024-11-05,False,False,False,0.766546329723225,0.21419975932611313,0.01684717208182912,0.0024067388688327317,Peak,Tuesday,November
2024-11-05 15:00:00,70,340,7,1,418,68,323,5,1,397,29.9,68,3,11.6,815,False,15,138,663,12,2,2024-11-05,False,False,False,0.8134969325153374,0.16932515337423312,0.014723926380368098,0.00245398773006135,Peak,Tuesday,November
2024-11-05 16:00:00,67,413,6,1,487,77,310,6,1,394,30.4,66,2,9.9,881,False,16,144,723,12,2,2024-11-05,False,False,False,0.8206583427922814,0.16345062429057888,0.01362088535754824,0.0022701475595913734,Peak,Tuesday,November
2024-11-05 17:00:00,64,553,5,1,623,130,269,7,1,407,29.5,71,51,9.0,1030,False,17,194,822,12,2,2024-11-05,False,False,False,0.7980582524271844,0.1883495145631068,0.011650485436893204,0.001941747572815534,Peak,Tuesday,November
2024-11-05 18:00:00,90,383,12,1,486,84,239,6,1,330,28.8,71,3,9.0,816,False,18,174,622,18,2,2024-11-05,False,False,False,0.7622549019607843,0.21323529411764705,0.022058823529411766,0.0024509803921568627,Peak,Tuesday,November
2024-11-05 19:00:00,67,277,11,1,356,104,208,6,1,319,28.0,73,3,7.4,675,False,19,171,485,17,2,2024-11-05,False,False,False,0.7185185185185186,0.25333333333333335,0.025185185185185185,0.002962962962962963,Peak,Tuesday,November
2024-11-05 20:00:00,85,387,12,1,485,68,298,7,1,374,27.7,77,3,5.6,859,False,20,153,685,19,2,2024-11-05,False,False,False,0.7974388824214202,0.1781140861466822,0.02211874272409779,0.002328288707799767,Shoulder,Tuesday,November
2024-11-05 21:00:00,56,473,8,1,538,83,310,6,1,400,27.8,74,3,6.3,938,False,21,139,783,14,2,2024-11-05,False,False,False,0.8347547974413646,0.14818763326226012,0.014925373134328358,0.0021321961620469083,Shoulder,Tuesday,November
2024-11-05 22:00:00,72,430,11,1,514,106,300,5,0,411,27.3,77,2,5.1,925,False,22,178,730,16,1,2024-11-05,False,False,False,0.7891891891891892,0.19243243243243244,0.017297297297297298,0.001081081081081081,Shoulder,Tuesday,November
2024-11-05 23:00:00,85,349,13,0,447,63,289,5,0,357,26.6,80,3,3.6,804,False,23,148,638,18,0,2024-11-05,False,False,False,0.7935323383084577,0.18407960199004975,0.022388059701492536,0.0,Shoulder,Tuesday,November
2024-11-06 00:00:00,34,234,2,0,270,84,204,3,0,291,26.3,78,3,4.6,561,False,0,118,438,5,0,2024-11-06,False,False,False,0.7807486631016043,0.2103386809269162,0.008912655971479501,0.0,Off-Peak,Wednesday,November
2024-11-06 01:00:00,43,179,2,0,224,110,212,2,0,324,25.8,76,3,6.9,548,False,1,153,391,4,0,2024-11-06,False,False,False,0.7135036496350365,0.2791970802919708,0.0072992700729927005,0.0,Off-Peak,Wednesday,November
2024-11-06 02:00:00,48,185,1,0,234,100,202,1,0,303,25.4,79,3,10.2,537,False,2,148,387,2,0,2024-11-06,False,False,False,0.7206703910614525,0.2756052141527002,0.0037243947858473,0.0,Off-Peak,Wednesday,November
2024-11-06 03:00:00,36,187,1,0,224,77,167,2,0,246,24.7,86,51,5.8,470,False,3,113,354,3,0,2024-11-06,False,False,False,0.7531914893617021,0.2404255319148936,0.006382978723404255,0.0,Off-Peak,Wednesday,November
2024-11-06 04:00:00,33,191,2,0,226,95,173,1,0,269,24.5,92,51,1.0,495,False,4,128,364,3,0,2024-11-06,False,False,False,0.7353535353535353,0.2585858585858586,0.006060606060606061,0.0,Off-Peak,Wednesday,November
2024-11-06 05:00:00,58,129,3,1,191,89,210,0,0,299,24.4,93,3,5.8,490,False,5,147,339,3,1,2024-11-06,False,False,False,0.6918367346938775,0.3,0.006122448979591836,0.0020408163265306124,Shoulder,Wednesday,November
2024-11-06 06:00:00,46,231,5,1,283,105,224,5,0,334,24.0,96,3,5.5,617,False,6,151,455,10,1,2024-11-06,False,False,False,0.7374392220421394,0.24473257698541329,0.01620745542949757,0.0016207455429497568,Shoulder,Wednesday,November
2024-11-06 07:00:00,35,558,6,1,600,142,525,6,0,673,23.9,96,3,4.5,1273,False,7,177,1083,12,1,2024-11-06,False,False,False,0.8507462686567164,0.13904163393558522,0.009426551453260016,0.0007855459544383347,Peak,Wednesday,November
2024-11-06 08:00:00,51,407,7,1,466,87,217,7,0,311,24.7,92,3,4.5,777,False,8,138,624,14,1,2024-11-06,False,False,False,0.803088803088803,0.1776061776061776,0.018018018018018018,0.001287001287001287,Peak,Wednesday,November
2024-11-06 09:00:00,40,463,5,2,510,97,238,5,1,341,25.4,88,63,6.9,851,False,9,137,701,10,3,2024-11-06,False,False,False,0.8237367802585194,0.1609870740305523,0.011750881316098707,0.0035252643948296123,Shoulder,Wednesday,November
2024-11-06 10:00:00,48,420,5,1,474,93,235,6,0,334,25.6,87,61,4.2,808,False,10,141,655,11,1,2024-11-06,False,False,False,0.8106435643564357,0.1745049504950495,0.013613861386138614,0.0012376237623762376,Shoulder,Wednesday,November
2024-11-06 11:00:00,36,448,5,1,490,103,326,5,1,435,27.3,82,51,4.1,925,False,11,139,774,10,2,2024-11-06,False,False,False,0.8367567567567568,0.15027027027027026,0.010810810810810811,0.002162162162162162,Peak,Wednesday,November
2024-11-06 12:00:00,42,437,7,1,487,96,303,4,1,404,28.8,77,51,3.3,891,False,12,138,740,11,2,2024-11-06,False,False,False,0.8305274971941639,0.15488215488215487,0.012345679012345678,0.002244668911335578,Peak,Wednesday,November
2024-11-06 13:00:00,44,346,4,1,395,60,243,7,1,311,29.9,72,51,7.6,706,False,13,104,589,11,2,2024-11-06,False,False,False,0.8342776203966006,0.14730878186968838,0.015580736543909348,0.0028328611898017,Peak,Wednesday,November
2024-11-06 14:00:00,56,434,4,2,496,100,203,5,1,309,30.2,70,3,10.7,805,False,14,156,637,9,3,2024-11-06,False,False,False,0.7913043478260869,0.1937888198757764,0.011180124223602485,0.0037267080745341614,Peak,Wednesday,November
2024-11-06 15:00:00,51,340,7,1,399,68,323,5,1,397,29.6,72,3,11.2,796,False,15,119,663,12,2,2024-11-06,False,False,False,0.8329145728643216,0.14949748743718594,0.01507537688442211,0.002512562814070352,Peak,Wednesday,November
2024-11-06 16:00:00,52,413,6,1,472,77,318,6,1,402,29.4,73,3,8.1,874,False,16,129,731,12,2,2024-11-06,False,False,False,0.8363844393592678,0.14759725400457666,0.013729977116704805,0.002288329519450801,Peak,Wednesday,November
2024-11-06 17:00:00,49,453,5,2,509,80,269,5,1,355,29.1,73,3,9.0,864,False,17,129,722,10,3,2024-11-06,False,False,False,0.8356481481481481,0.14930555555555555,0.011574074074074073,0.003472222222222222,Peak,Wednesday,November
2024-11-06 18:00:00,45,383,7,1,436,84,239,6,1,330,28.6,75,3,7.8,766,False,18,129,622,13,2,2024-11-06,False,False,False,0.8120104438642297,0.16840731070496084,0.016971279373368148,0.0026109660574412533,Peak,Wednesday,November
2024-11-06 19:00:00,42,277,6,1,326,94,248,6,1,349,27.6,87,51,3.5,675,False,19,136,525,12,2,2024-11-06,False,False,False,0.7777777777777778,0.20148148148148148,0.017777777777777778,0.002962962962962963,Peak,Wednesday,November
2024-11-06 20:00:00,39,387,11,2,439,68,298,7,1,374,27.1,84,3,3.8,813,False,20,107,685,18,3,2024-11-06,False,False,False,0.8425584255842559,0.13161131611316113,0.02214022140221402,0.0036900369003690036,Shoulder,Wednesday,November
2024-11-06 21:00:00,39,473,8,1,521,83,310,6,1,400,27.2,83,3,2.8,921,False,21,122,783,14,2,2024-11-06,False,False,False,0.8501628664495114,0.13246471226927253,0.01520086862106406,0.002171552660152009,Shoulder,Wednesday,November
2024-11-06 22:00:00,48,430,11,1,490,67,300,5,0,372,26.7,84,3,4.1,862,False,22,115,730,16,1,2024-11-06,False,False,False,0.8468677494199536,0.1334106728538283,0.018561484918793503,0.001160092807424594,Shoulder,Wednesday,November
2024-11-06 23:00:00,37,249,3,0,289,63,289,5,0,357,26.6,84,3,9.3,646,False,23,100,538,8,0,2024-11-06,False,False,False,0.8328173374613003,0.15479876160990713,0.01238390092879257,0.0,Shoulder,Wednesday,November
2024-11-07 00:00:00,73,334,9,0,416,84,204,3,0,291,26.1,86,3,8.9,707,False,0,157,538,12,0,2024-11-07,False,False,False,0.7609618104667609,0.22206506364922207,0.016973125884016973,0.0,Off-Peak,Thursday,November
2024-11-07 01:00:00,66,279,9,0,354,110,312,2,0,424,25.1,91,51,9.8,778,False,1,176,591,11,0,2024-11-07,False,False,False,0.7596401028277635,0.2262210796915167,0.014138817480719794,0.0,Off-Peak,Thursday,November
2024-11-07 02:00:00,36,155,8,0,199,100,202,1,0,303,24.9,91,51,8.3,502,False,2,136,357,9,0,2024-11-07,False,False,False,0.7111553784860558,0.27091633466135456,0.017928286852589643,0.0,Off-Peak,Thursday,November
2024-11-07 03:00:00,50,127,6,0,183,77,167,2,0,246,24.8,91,51,8.0,429,False,3,127,294,8,0,2024-11-07,False,False,False,0.6853146853146853,0.29603729603729606,0.018648018648018648,0.0,Off-Peak,Thursday,November
2024-11-07 04:00:00,29,191,7,0,227,95,273,1,0,369,24.2,94,51,8.6,596,False,4,124,464,8,0,2024-11-07,False,False,False,0.7785234899328859,0.2080536912751678,0.013422818791946308,0.0,Off-Peak,Thursday,November
2024-11-07 05:00:00,22,129,12,1,164,89,210,0,0,299,23.9,95,3,6.8,463,False,5,111,339,12,1,2024-11-07,False,False,False,0.7321814254859611,0.23974082073434125,0.02591792656587473,0.0021598272138228943,Shoulder,Thursday,November
2024-11-07 06:00:00,44,331,12,1,388,105,324,5,0,434,23.7,96,3,4.5,822,False,6,149,655,17,1,2024-11-07,False,False,False,0.7968369829683698,0.18126520681265207,0.02068126520681265,0.0012165450121654502,Shoulder,Thursday,November
2024-11-07 07:00:00,98,658,13,1,770,142,225,6,0,373,23.6,97,3,3.9,1143,False,7,240,883,19,1,2024-11-07,False,False,False,0.7725284339457568,0.2099737532808399,0.016622922134733157,0.0008748906386701663,Peak,Thursday,November
2024-11-07 08:00:00,65,507,12,1,585,87,217,7,0,311,24.7,92,3,3.5,896,False,8,152,724,19,1,2024-11-07,False,False,False,0.8080357142857143,0.16964285714285715,0.021205357142857144,0.0011160714285714285,Peak,Thursday,November
2024-11-07 09:00:00,52,467,11,2,532,97,238,5,1,341,26.7,82,51,10.3,873,False,9,149,705,16,3,2024-11-07,False,False,False,0.8075601374570447,0.1706758304696449,0.018327605956471937,0.003436426116838488,Shoulder,Thursday,November
2024-11-07 10:00:00,63,420,12,1,496,93,235,6,0,334,27.5,81,3,5.8,830,False,10,156,655,18,1,2024-11-07,False,False,False,0.7891566265060241,0.18795180722891566,0.021686746987951807,0.0012048192771084338,Shoulder,Thursday,November
2024-11-07 11:00:00,50,478,10,1,539,103,326,5,1,435,28.6,75,3,3.5,974,False,11,153,804,15,2,2024-11-07,False,False,False,0.8254620123203286,0.1570841889117043,0.015400410677618069,0.002053388090349076,Peak,Thursday,November
2024-11-07 12:00:00,53,337,11,1,402,96,303,6,1,406,29.4,73,51,7.2,808,False,12,149,640,17,2,2024-11-07,False,False,False,0.7920792079207921,0.1844059405940594,0.02103960396039604,0.0024752475247524753,Peak,Thursday,November
2024-11-07 13:00:00,61,446,8,1,516,60,243,7,1,311,30.0,70,51,9.4,827,False,13,121,689,15,2,2024-11-07,False,False,False,0.8331318016928658,0.14631197097944376,0.018137847642079808,0.0024183796856106408,Peak,Thursday,November
2024-11-07 14:00:00,78,434,9,2,523,100,203,5,1,309,29.2,74,3,12.3,832,False,14,178,637,14,3,2024-11-07,False,False,False,0.765625,0.21394230769230768,0.016826923076923076,0.003605769230769231,Peak,Thursday,November
2024-11-07 15:00:00,70,335,11,1,417,68,323,5,1,397,29.5,71,3,12.1,814,False,15,138,658,16,2,2024-11-07,False,False,False,0.8083538083538083,0.16953316953316952,0.019656019656019656,0.002457002457002457,Peak,Thursday,November
2024-11-07 16:00:00,97,413,11,1,522,77,318,6,1,402,29.4,73,3,9.6,924,False,16,174,731,17,2,2024-11-07,False,False,False,0.7911255411255411,0.18831168831168832,0.0183982683982684,0.0021645021645021645,Peak,Thursday,November
2024-11-07 17:00:00,94,623,12,1,730,80,269,5,1,355,28.8,73,3,6.0,1085,False,17,174,892,17,2,2024-11-07,False,False,False,0.8221198156682028,0.16036866359447005,0.01566820276497696,0.0018433179723502304,Peak,Thursday,November
2024-11-07 18:00:00,90,383,12,1,486,84,239,6,1,330,28.5,74,3,3.2,816,False,18,174,622,18,2,2024-11-07,False,False,False,0.7622549019607843,0.21323529411764705,0.022058823529411766,0.0024509803921568627,Peak,Thursday,November
2024-11-07 19:00:00,97,479,11,1,588,94,248,6,1,349,27.5,82,3,3.4,937,False,19,191,727,17,2,2024-11-07,False,False,False,0.775880469583778,0.20384204909284953,0.01814300960512273,0.0021344717182497333,Peak,Thursday,November
2024-11-07 20:00:00,85,487,12,2,586,68,298,7,1,374,26.9,88,3,4.5,960,False,20,153,785,19,3,2024-11-07,False,False,False,0.8177083333333334,0.159375,0.019791666666666666,0.003125,Shoulder,Thursday,November
2024-11-07 21:00:00,56,413,8,1,478,83,310,6,1,400,26.6,84,3,2.7,878,False,21,139,723,14,2,2024-11-07,False,False,False,0.8234624145785877,0.15831435079726652,0.015945330296127564,0.002277904328018223,Shoulder,Thursday,November
2024-11-07 22:00:00,72,430,11,1,514,66,300,5,0,371,26.5,86,3,4.5,885,False,22,138,730,16,1,2024-11-07,False,False,False,0.8248587570621468,0.15593220338983052,0.01807909604519774,0.0011299435028248588,Shoulder,Thursday,November
2024-11-07 23:00:00,85,349,10,0,444,63,195,5,0,263,26.1,89,3,3.9,707,False,23,148,544,15,0,2024-11-07,False,False,False,0.7694483734087695,0.20933521923620935,0.021216407355021217,0.0,Shoulder,Thursday,November
2024-11-08 00:00:00,73,234,9,0,316,84,204,3,0,291,26.0,91,51,6.5,607,False,0,157,438,12,0,2024-11-08,False,False,False,0.7215815485996705,0.2586490939044481,0.019769357495881382,0.0,Off-Peak,Friday,November
2024-11-08 01:00:00,66,279,9,0,354,110,212,2,0,324,25.8,93,51,7.2,678,False,1,176,491,11,0,2024-11-08,False,False,False,0.724188790560472,0.25958702064896755,0.016224188790560472,0.0,Off-Peak,Friday,November
2024-11-08 02:00:00,66,155,8,0,229,100,202,1,0,303,25.4,96,53,8.3,532,False,2,166,357,9,0,2024-11-08,False,False,False,0.6710526315789473,0.31203007518796994,0.016917293233082706,0.0,Off-Peak,Friday,November
2024-11-08 03:00:00,92,127,6,0,225,77,167,2,0,246,25.2,98,51,2.6,471,False,3,169,294,8,0,2024-11-08,False,False,False,0.6242038216560509,0.35881104033970274,0.016985138004246284,0.0,Off-Peak,Friday,November
2024-11-08 04:00:00,69,191,7,0,267,75,173,1,0,249,24.9,97,3,3.2,516,False,4,144,364,8,0,2024-11-08,False,False,False,0.7054263565891473,0.27906976744186046,0.015503875968992248,0.0,Off-Peak,Friday,November
2024-11-08 05:00:00,72,229,16,1,318,89,210,0,0,299,24.6,98,3,2.3,617,False,5,161,439,16,1,2024-11-08,False,False,False,0.7115072933549432,0.26094003241491087,0.02593192868719611,0.0016207455429497568,Shoulder,Friday,November
2024-11-08 06:00:00,74,331,15,1,421,105,324,5,0,434,24.5,98,3,2.2,855,False,6,179,655,20,1,2024-11-08,False,False,False,0.7660818713450293,0.20935672514619882,0.023391812865497075,0.0011695906432748538,Shoulder,Friday,November
2024-11-08 07:00:00,98,658,18,1,775,178,525,6,1,710,24.4,98,3,1.6,1485,False,7,276,1183,24,2,2024-11-08,False,False,True,0.7966329966329966,0.18585858585858586,0.01616161616161616,0.0013468013468013469,Peak,Friday,November
2024-11-08 08:00:00,85,507,19,1,612,187,317,7,1,512,25.3,93,51,5.8,1124,False,8,272,824,26,2,2024-11-08,False,False,False,0.7330960854092526,0.24199288256227758,0.023131672597864767,0.0017793594306049821,Peak,Friday,November
2024-11-08 09:00:00,55,567,18,2,642,97,238,5,1,341,26.0,86,3,5.7,983,False,9,152,805,23,3,2024-11-08,False,False,False,0.8189216683621566,0.15462868769074262,0.023397761953204477,0.003051881993896236,Shoulder,Friday,November
2024-11-08 10:00:00,63,420,12,2,497,93,235,6,0,334,27.7,78,3,6.5,831,False,10,156,655,18,2,2024-11-08,False,False,False,0.7882069795427196,0.18772563176895307,0.021660649819494584,0.0024067388688327317,Shoulder,Friday,November
2024-11-08 11:00:00,90,478,17,2,587,103,326,5,1,435,28.7,72,3,10.1,1022,False,11,193,804,22,3,2024-11-08,False,False,False,0.786692759295499,0.1888454011741683,0.021526418786692758,0.0029354207436399216,Peak,Friday,November
2024-11-08 12:00:00,90,437,18,2,547,96,303,6,2,407,29.1,70,3,11.9,954,False,12,186,740,24,4,2024-11-08,False,False,False,0.7756813417190775,0.1949685534591195,0.025157232704402517,0.0041928721174004195,Peak,Friday,November
2024-11-08 13:00:00,61,446,14,1,522,60,343,7,1,411,29.6,69,3,10.7,933,False,13,121,789,21,2,2024-11-08,False,False,False,0.8456591639871383,0.12968917470525188,0.022508038585209004,0.0021436227224008574,Peak,Friday,November
2024-11-08 14:00:00,78,434,16,2,530,100,208,5,1,314,29.8,67,3,11.8,844,False,14,178,642,21,3,2024-11-08,False,False,False,0.7606635071090048,0.2109004739336493,0.024881516587677725,0.0035545023696682463,Peak,Friday,November
2024-11-08 15:00:00,90,435,18,2,545,68,323,5,1,397,29.8,66,3,12.0,942,False,15,158,758,23,3,2024-11-08,False,False,False,0.8046709129511678,0.16772823779193205,0.024416135881104035,0.0031847133757961785,Peak,Friday,November
2024-11-08 16:00:00,91,413,19,3,526,77,318,6,1,402,29.4,68,3,10.6,928,False,16,168,731,25,4,2024-11-08,False,False,False,0.7877155172413793,0.1810344827586207,0.02693965517241379,0.004310344827586207,Peak,Friday,November
2024-11-08 17:00:00,94,623,12,2,731,130,369,5,1,505,28.9,70,3,11.6,1236,False,17,224,992,17,3,2024-11-08,False,False,False,0.8025889967637541,0.18122977346278318,0.013754045307443365,0.0024271844660194173,Peak,Friday,November
2024-11-08 18:00:00,90,472,12,2,576,84,339,6,2,431,28.0,75,3,8.4,1007,False,18,174,811,18,4,2024-11-08,False,False,False,0.8053624627606752,0.1727904667328699,0.01787487586891758,0.003972194637537239,Peak,Friday,November
2024-11-08 19:00:00,97,570,17,2,686,104,348,6,1,459,27.3,81,3,6.5,1145,False,19,201,918,23,3,2024-11-08,False,False,False,0.8017467248908297,0.17554585152838428,0.020087336244541485,0.0026200873362445414,Peak,Friday,November
2024-11-08 20:00:00,85,587,12,2,686,68,298,8,1,375,27.3,82,3,8.8,1061,False,20,153,885,20,3,2024-11-08,False,False,False,0.8341187558906692,0.14420358152686144,0.01885014137606032,0.002827521206409048,Shoulder,Friday,November
2024-11-08 21:00:00,56,513,15,1,585,83,310,6,1,400,27.5,78,3,7.5,985,False,21,139,823,21,2,2024-11-08,False,False,False,0.8355329949238579,0.14111675126903553,0.02131979695431472,0.0020304568527918783,Shoulder,Friday,November
2024-11-08 22:00:00,72,530,13,1,616,106,300,5,1,412,26.9,81,1,5.3,1028,False,22,178,830,18,2,2024-11-08,False,False,False,0.8073929961089494,0.17315175097276264,0.017509727626459144,0.0019455252918287938,Shoulder,Friday,November
2024-11-08 23:00:00,85,349,10,0,444,63,295,5,0,363,26.2,84,2,5.7,807,False,23,148,644,15,0,2024-11-08,False,False,False,0.7980173482032218,0.18339529120198264,0.01858736059479554,0.0,Shoulder,Friday,November
2024-11-09 00:00:00,73,234,9,0,316,84,101,3,0,188,25.7,86,2,6.6,504,True,0,157,335,12,0,2024-11-09,False,False,False,0.6646825396825397,0.3115079365079365,0.023809523809523808,0.0,Off-Peak,Saturday,November
2024-11-09 01:00:00,66,179,9,0,254,110,91,2,0,203,25.5,86,3,7.5,457,True,1,176,270,11,0,2024-11-09,False,False,False,0.5908096280087527,0.3851203501094092,0.024070021881838075,0.0,Off-Peak,Saturday,November
2024-11-09 02:00:00,66,155,8,0,229,100,83,1,0,184,25.4,86,3,8.4,413,True,2,166,238,9,0,2024-11-09,False,False,False,0.576271186440678,0.4019370460048426,0.021791767554479417,0.0,Off-Peak,Saturday,November
2024-11-09 03:00:00,92,127,6,0,225,77,50,2,0,129,25.0,88,3,5.1,354,True,3,169,177,8,0,2024-11-09,False,False,False,0.5,0.4774011299435028,0.022598870056497175,0.0,Off-Peak,Saturday,November
2024-11-09 04:00:00,69,191,7,0,267,75,30,1,0,106,24.3,92,3,5.4,373,True,4,144,221,8,0,2024-11-09,False,False,False,0.5924932975871313,0.38605898123324395,0.021447721179624665,0.0,Off-Peak,Saturday,November
2024-11-09 05:00:00,72,129,9,1,211,89,56,0,0,145,24.1,92,3,4.5,356,True,5,161,185,9,1,2024-11-09,False,False,False,0.5196629213483146,0.45224719101123595,0.025280898876404494,0.0028089887640449437,Shoulder,Saturday,November
2024-11-09 06:00:00,64,431,13,1,509,105,214,5,0,324,24.2,91,3,6.6,833,True,6,169,645,18,1,2024-11-09,False,False,False,0.7743097238895558,0.2028811524609844,0.021608643457382955,0.0012004801920768306,Shoulder,Saturday,November
2024-11-09 07:00:00,98,658,13,1,770,178,450,6,1,635,24.0,94,3,7.9,1405,True,7,276,1108,19,2,2024-11-09,False,False,True,0.7886120996441282,0.19644128113879003,0.013523131672597865,0.0014234875444839859,Peak,Saturday,November
2024-11-09 08:00:00,89,507,14,1,611,187,484,7,1,679,25.1,91,51,2.9,1290,True,8,276,991,21,2,2024-11-09,False,False,False,0.7682170542635659,0.21395348837209302,0.01627906976744186,0.0015503875968992248,Peak,Saturday,November
2024-11-09 09:00:00,95,467,12,2,576,97,402,5,1,505,26.9,83,3,5.5,1081,True,9,192,869,17,3,2024-11-09,False,False,False,0.8038852913968547,0.17761332099907493,0.01572617946345976,0.0027752081406105457,Shoulder,Saturday,November
2024-11-09 10:00:00,83,520,12,2,617,93,476,6,0,575,28.6,74,3,3.2,1192,True,10,176,996,18,2,2024-11-09,False,False,False,0.8355704697986577,0.1476510067114094,0.015100671140939598,0.0016778523489932886,Shoulder,Saturday,November
2024-11-09 11:00:00,90,578,17,1,686,103,433,5,1,542,29.7,70,51,3.1,1228,True,11,193,1011,22,2,2024-11-09,False,False,False,0.8232899022801303,0.15716612377850162,0.017915309446254073,0.0016286644951140066,Peak,Saturday,November
2024-11-09 12:00:00,90,437,15,2,544,96,480,6,2,584,30.7,67,3,4.2,1128,True,12,186,917,21,4,2024-11-09,False,False,False,0.8129432624113475,0.16489361702127658,0.018617021276595744,0.0035460992907801418,Peak,Saturday,November
2024-11-09 13:00:00,91,536,14,1,642,60,421,4,1,486,30.8,67,51,10.8,1128,True,13,151,957,18,2,2024-11-09,False,False,False,0.848404255319149,0.13386524822695037,0.015957446808510637,0.0017730496453900709,Peak,Saturday,November
2024-11-09 14:00:00,78,434,16,2,530,100,467,5,1,573,28.9,78,63,9.9,1103,True,14,178,901,21,3,2024-11-09,False,False,False,0.8168631006346329,0.1613780598368087,0.019038984587488667,0.0027198549410698096,Peak,Saturday,November
2024-11-09 15:00:00,90,435,11,2,538,68,0,5,1,74,29.5,73,51,11.5,612,True,15,158,435,16,3,2024-11-09,False,False,False,0.7107843137254902,0.2581699346405229,0.026143790849673203,0.004901960784313725,Peak,Saturday,November
2024-11-09 16:00:00,91,513,14,1,619,77,442,6,1,526,28.9,78,53,12.7,1145,True,16,168,955,20,2,2024-11-09,False,False,False,0.834061135371179,0.1467248908296943,0.017467248908296942,0.0017467248908296944,Peak,Saturday,November
2024-11-09 17:00:00,97,503,12,2,614,130,472,5,1,608,28.8,76,3,13.2,1222,True,17,227,975,17,3,2024-11-09,False,False,False,0.7978723404255319,0.18576104746317512,0.013911620294599018,0.0024549918166939444,Peak,Saturday,November
2024-11-09 18:00:00,90,562,12,2,666,184,451,6,1,642,28.1,77,53,11.1,1308,True,18,274,1013,18,3,2024-11-09,False,False,False,0.7744648318042814,0.20948012232415902,0.013761467889908258,0.0022935779816513763,Peak,Saturday,November
2024-11-09 19:00:00,97,474,17,2,590,104,425,6,1,536,26.8,84,3,12.8,1126,True,19,201,899,23,3,2024-11-09,False,False,False,0.7984014209591475,0.17850799289520428,0.020426287744227355,0.0026642984014209592,Peak,Saturday,November
2024-11-09 20:00:00,85,487,12,2,586,138,455,5,1,599,26.3,87,3,8.1,1185,True,20,223,942,17,3,2024-11-09,False,False,False,0.7949367088607595,0.1881856540084388,0.014345991561181435,0.002531645569620253,Shoulder,Saturday,November
2024-11-09 21:00:00,56,513,15,1,585,156,424,6,1,587,26.8,83,3,6.5,1172,True,21,212,937,21,2,2024-11-09,False,False,False,0.7994880546075085,0.18088737201365188,0.017918088737201365,0.0017064846416382253,Shoulder,Saturday,November
2024-11-09 22:00:00,72,530,13,1,616,106,335,5,1,447,26.5,85,3,4.3,1063,True,22,178,865,18,2,2024-11-09,False,False,False,0.8137347130761995,0.16745061147695203,0.016933207902163686,0.0018814675446848542,Shoulder,Saturday,November
2024-11-09 23:00:00,85,349,10,0,444,73,271,4,0,348,26.1,87,3,3.9,792,True,23,158,620,14,0,2024-11-09,False,False,False,0.7828282828282829,0.1994949494949495,0.017676767676767676,0.0,Shoulder,Saturday,November
2024-11-10 00:00:00,73,334,9,0,416,84,101,3,0,188,25.8,91,3,4.2,604,True,0,157,435,12,0,2024-11-10,False,False,False,0.7201986754966887,0.2599337748344371,0.019867549668874173,0.0,Off-Peak,Sunday,November
2024-11-10 01:00:00,66,179,9,0,254,110,91,2,0,203,25.8,90,3,5.6,457,True,1,176,270,11,0,2024-11-10,False,False,False,0.5908096280087527,0.3851203501094092,0.024070021881838075,0.0,Off-Peak,Sunday,November
2024-11-10 02:00:00,66,155,8,0,229,100,83,4,0,187,25.7,91,51,7.4,416,True,2,166,238,12,0,2024-11-10,False,False,False,0.5721153846153846,0.39903846153846156,0.028846153846153848,0.0,Off-Peak,Sunday,November
2024-11-10 03:00:00,58,127,6,0,191,77,50,2,0,129,25.2,93,51,12.7,320,True,3,135,177,8,0,2024-11-10,False,False,False,0.553125,0.421875,0.025,0.0,Off-Peak,Sunday,November
2024-11-10 04:00:00,59,191,7,0,257,75,30,3,0,108,25.3,91,3,12.6,365,True,4,134,221,10,0,2024-11-10,False,False,False,0.6054794520547945,0.36712328767123287,0.0273972602739726,0.0,Off-Peak,Sunday,November
2024-11-10 05:00:00,53,129,9,1,192,89,56,2,0,147,24.8,92,53,10.8,339,True,5,142,185,11,1,2024-11-10,False,False,False,0.5457227138643068,0.41887905604719766,0.032448377581120944,0.0029498525073746312,Shoulder,Sunday,November
2024-11-10 06:00:00,64,331,13,1,409,105,214,8,0,327,24.9,93,51,7.8,736,True,6,169,545,21,1,2024-11-10,False,False,False,0.7404891304347826,0.2296195652173913,0.028532608695652172,0.001358695652173913,Shoulder,Sunday,November
2024-11-10 07:00:00,98,718,13,1,830,178,491,6,1,676,25.0,93,3,10.7,1506,True,7,276,1209,19,2,2024-11-10,False,False,True,0.8027888446215139,0.18326693227091634,0.012616201859229747,0.0013280212483399733,Peak,Sunday,November
2024-11-10 08:00:00,89,612,14,1,716,187,484,7,1,679,25.8,89,3,8.7,1395,True,8,276,1096,21,2,2024-11-10,False,False,True,0.785663082437276,0.1978494623655914,0.015053763440860216,0.0014336917562724014,Peak,Sunday,November
2024-11-10 09:00:00,95,567,12,2,676,97,402,9,1,509,26.8,85,3,12.8,1185,True,9,192,969,21,3,2024-11-10,False,False,False,0.8177215189873418,0.1620253164556962,0.017721518987341773,0.002531645569620253,Shoulder,Sunday,November
2024-11-10 10:00:00,83,420,12,2,517,93,476,6,0,575,27.5,81,3,15.1,1092,True,10,176,896,18,2,2024-11-10,False,False,False,0.8205128205128205,0.16117216117216118,0.016483516483516484,0.0018315018315018315,Shoulder,Sunday,November
2024-11-10 11:00:00,90,478,13,2,583,103,433,9,1,546,28.6,75,51,14.2,1129,True,11,193,911,22,3,2024-11-10,False,False,False,0.8069087688219664,0.17094774136403898,0.01948627103631532,0.002657218777679362,Peak,Sunday,November
2024-11-10 12:00:00,90,437,13,2,542,96,480,6,2,584,29.7,70,3,15.3,1126,True,12,186,917,19,4,2024-11-10,False,False,False,0.8143872113676732,0.16518650088809947,0.016873889875666074,0.003552397868561279,Peak,Sunday,November
2024-11-10 13:00:00,91,436,14,1,542,90,421,8,1,520,30.8,65,3,14.2,1062,True,13,181,857,22,2,2024-11-10,False,False,False,0.8069679849340866,0.1704331450094162,0.02071563088512241,0.0018832391713747645,Peak,Sunday,November
2024-11-10 14:00:00,78,434,12,1,525,100,467,6,1,574,30.8,63,3,15.1,1099,True,14,178,901,18,2,2024-11-10,False,False,False,0.8198362147406734,0.16196542311191992,0.01637852593266606,0.0018198362147406734,Peak,Sunday,November
2024-11-10 15:00:00,91,435,11,1,538,98,0,8,1,107,30.1,68,3,17.0,645,True,15,189,435,19,2,2024-11-10,False,False,False,0.6744186046511628,0.2930232558139535,0.02945736434108527,0.0031007751937984496,Peak,Sunday,November
2024-11-10 16:00:00,90,413,14,1,518,79,442,6,2,529,29.8,69,51,16.7,1047,True,16,169,855,20,3,2024-11-10,False,False,False,0.8166189111747851,0.16141356255969436,0.019102196752626553,0.0028653295128939827,Peak,Sunday,November
2024-11-10 17:00:00,97,703,12,2,814,130,572,5,1,708,28.9,75,51,14.3,1522,True,17,227,1275,17,3,2024-11-10,False,False,True,0.8377135348226018,0.14914586070959265,0.011169513797634692,0.0019710906701708277,Peak,Sunday,November
2024-11-10 18:00:00,90,762,12,1,865,184,451,6,1,642,28.5,75,3,13.7,1507,True,18,274,1213,18,2,2024-11-10,False,False,True,0.8049104180491041,0.18181818181818182,0.011944260119442602,0.0013271400132714001,Peak,Sunday,November
2024-11-10 19:00:00,97,674,17,1,789,104,425,9,1,539,27.0,80,3,13.8,1328,True,19,201,1099,26,2,2024-11-10,False,False,False,0.8275602409638554,0.15135542168674698,0.01957831325301205,0.0015060240963855422,Peak,Sunday,November
2024-11-10 20:00:00,85,687,12,2,786,138,455,5,1,599,25.8,84,51,8.3,1385,True,20,223,1142,17,3,2024-11-10,False,False,True,0.8245487364620938,0.16101083032490976,0.01227436823104693,0.0021660649819494585,Shoulder,Sunday,November
2024-11-10 21:00:00,56,513,15,1,585,156,424,9,1,590,27.1,83,51,7.8,1175,True,21,212,937,24,2,2024-11-10,False,False,False,0.7974468085106383,0.1804255319148936,0.020425531914893616,0.001702127659574468,Shoulder,Sunday,November
2024-11-10 22:00:00,72,530,13,1,616,106,335,5,1,447,26.2,90,53,11.2,1063,True,22,178,865,18,2,2024-11-10,False,False,False,0.8137347130761995,0.16745061147695203,0.016933207902163686,0.0018814675446848542,Shoulder,Sunday,November
2024-11-10 23:00:00,85,349,10,0,444,73,271,7,0,351,25.7,95,55,11.7,795,True,23,158,620,17,0,2024-11-10,False,False,False,0.779874213836478,0.19874213836477989,0.021383647798742137,0.0,Shoulder,Sunday,November
2024-11-11 00:00:00,73,334,9,0,416,73,204,3,0,280,25.4,95,51,11.6,696,False,0,146,538,12,0,2024-11-11,False,False,False,0.7729885057471264,0.20977011494252873,0.017241379310344827,0.0,Off-Peak,Monday,November
2024-11-11 01:00:00,66,279,9,0,354,66,112,2,0,180,25.2,95,3,12.4,534,False,1,132,391,11,0,2024-11-11,False,False,False,0.7322097378277154,0.24719101123595505,0.020599250936329586,0.0,Off-Peak,Monday,November
2024-11-11 02:00:00,36,125,8,0,169,66,201,1,0,268,24.7,95,3,9.7,437,False,2,102,326,9,0,2024-11-11,False,False,False,0.7459954233409611,0.2334096109839817,0.020594965675057208,0.0,Off-Peak,Monday,November
2024-11-11 03:00:00,50,127,6,0,183,52,167,2,0,221,24.5,95,3,9.7,404,False,3,102,294,8,0,2024-11-11,False,False,False,0.7277227722772277,0.2524752475247525,0.019801980198019802,0.0,Off-Peak,Monday,November
2024-11-11 04:00:00,29,151,7,0,187,62,173,1,0,236,24.3,96,3,7.1,423,False,4,91,324,8,0,2024-11-11,False,False,False,0.7659574468085106,0.21513002364066194,0.018912529550827423,0.0,Off-Peak,Monday,November
2024-11-11 05:00:00,22,229,12,1,264,72,183,0,0,255,24.2,96,3,5.7,519,False,5,94,412,12,1,2024-11-11,False,False,False,0.7938342967244701,0.1811175337186898,0.023121387283236993,0.0019267822736030828,Shoulder,Monday,November
2024-11-11 06:00:00,74,431,12,1,518,64,205,5,0,274,24.0,97,3,4.2,792,False,6,138,636,17,1,2024-11-11,False,False,False,0.803030303030303,0.17424242424242425,0.021464646464646464,0.0012626262626262627,Shoulder,Monday,November
2024-11-11 07:00:00,93,659,13,1,766,98,324,6,0,428,23.7,98,3,4.1,1194,False,7,191,983,19,1,2024-11-11,False,False,False,0.8232830820770519,0.15996649916247907,0.015912897822445562,0.0008375209380234506,Peak,Monday,November
2024-11-11 08:00:00,75,407,12,1,495,89,230,5,0,324,24.9,96,2,8.1,819,False,8,164,637,17,1,2024-11-11,False,False,False,0.7777777777777778,0.20024420024420025,0.020757020757020756,0.001221001221001221,Peak,Monday,November
2024-11-11 09:00:00,52,467,11,0,530,95,228,5,1,329,27.3,84,3,6.3,859,False,9,147,695,16,1,2024-11-11,False,False,False,0.8090803259604191,0.17112922002328287,0.018626309662398137,0.0011641443538998836,Shoulder,Monday,November
2024-11-11 10:00:00,63,420,11,1,495,83,235,6,1,325,28.4,78,51,4.8,820,False,10,146,655,17,2,2024-11-11,False,False,False,0.7987804878048781,0.17804878048780487,0.020731707317073172,0.0024390243902439024,Shoulder,Monday,November
2024-11-11 11:00:00,50,478,10,1,539,90,321,5,1,417,29.3,75,51,4.7,956,False,11,140,799,15,2,2024-11-11,False,False,False,0.8357740585774058,0.14644351464435146,0.015690376569037656,0.0020920502092050207,Peak,Monday,November
2024-11-11 12:00:00,53,537,11,1,602,90,303,6,1,400,30.0,73,51,6.3,1002,False,12,143,840,17,2,2024-11-11,False,False,False,0.8383233532934131,0.14271457085828343,0.016966067864271458,0.001996007984031936,Peak,Monday,November
2024-11-11 13:00:00,61,346,8,1,416,91,240,4,1,336,30.1,72,53,8.3,752,False,13,152,586,12,2,2024-11-11,False,False,False,0.7792553191489362,0.20212765957446807,0.015957446808510637,0.0026595744680851063,Peak,Monday,November
2024-11-11 14:00:00,78,434,9,2,523,78,201,5,1,285,30.4,71,51,8.9,808,False,14,156,635,14,3,2024-11-11,False,False,False,0.7858910891089109,0.19306930693069307,0.017326732673267328,0.0037128712871287127,Peak,Monday,November
2024-11-11 15:00:00,70,335,11,1,417,90,323,5,1,419,29.9,71,51,7.0,836,False,15,160,658,16,2,2024-11-11,False,False,False,0.7870813397129187,0.19138755980861244,0.019138755980861243,0.0023923444976076554,Peak,Monday,November
2024-11-11 16:00:00,97,413,11,2,523,91,310,6,1,408,29.3,74,3,7.0,931,False,16,188,723,17,3,2024-11-11,False,False,False,0.7765843179377014,0.20193340494092374,0.018259935553168637,0.00322234156820623,Peak,Monday,November
2024-11-11 17:00:00,94,623,12,1,730,97,269,5,1,372,28.2,78,63,4.4,1102,False,17,191,892,17,2,2024-11-11,False,False,False,0.809437386569873,0.1733212341197822,0.015426497277676952,0.0018148820326678765,Peak,Monday,November
2024-11-11 18:00:00,90,383,12,2,487,90,200,6,1,297,27.5,81,51,2.8,784,False,18,180,583,18,3,2024-11-11,False,False,False,0.7436224489795918,0.22959183673469388,0.02295918367346939,0.003826530612244898,Peak,Monday,November
2024-11-11 19:00:00,97,379,11,1,488,97,208,5,1,311,26.2,92,51,1.7,799,False,19,194,587,16,2,2024-11-11,False,False,False,0.7346683354192741,0.2428035043804756,0.02002503128911139,0.0025031289111389237,Peak,Monday,November
2024-11-11 20:00:00,85,387,12,2,486,85,298,5,1,389,26.0,92,51,1.9,875,False,20,170,685,17,3,2024-11-11,False,False,False,0.7828571428571428,0.19428571428571428,0.019428571428571427,0.0034285714285714284,Shoulder,Monday,November
2024-11-11 21:00:00,56,413,8,1,478,56,310,6,1,373,26.1,90,3,10.1,851,False,21,112,723,14,2,2024-11-11,False,False,False,0.8495887191539365,0.13160987074030553,0.01645123384253819,0.0023501762632197414,Shoulder,Monday,November
2024-11-11 22:00:00,72,430,11,1,514,72,300,5,0,377,25.4,90,3,10.4,891,False,22,144,730,16,1,2024-11-11,False,False,False,0.819304152637486,0.16161616161616163,0.017957351290684626,0.001122334455667789,Shoulder,Monday,November
2024-11-11 23:00:00,85,349,10,0,444,85,289,4,0,378,25.0,90,3,11.3,822,False,23,170,638,14,0,2024-11-11,False,False,False,0.7761557177615572,0.20681265206812652,0.0170316301703163,0.0,Shoulder,Monday,November
2024-11-12 00:00:00,60,234,9,0,303,73,204,3,0,280,24.7,91,3,9.0,583,False,0,133,438,12,0,2024-11-12,False,False,False,0.7512864493996569,0.2281303602058319,0.02058319039451115,0.0,Off-Peak,Tuesday,November
2024-11-12 01:00:00,52,179,9,0,240,66,112,2,0,180,24.5,92,3,8.1,420,False,1,118,291,11,0,2024-11-12,False,False,False,0.6928571428571428,0.28095238095238095,0.02619047619047619,0.0,Off-Peak,Tuesday,November
2024-11-12 02:00:00,45,125,8,0,178,66,202,1,0,269,24.1,95,53,7.6,447,False,2,111,327,9,0,2024-11-12,False,False,False,0.7315436241610739,0.2483221476510067,0.020134228187919462,0.0,Off-Peak,Tuesday,November
2024-11-12 03:00:00,56,127,6,0,189,52,167,2,0,221,24.0,96,3,5.9,410,False,3,108,294,8,0,2024-11-12,False,False,False,0.7170731707317073,0.2634146341463415,0.01951219512195122,0.0,Off-Peak,Tuesday,November
2024-11-12 04:00:00,51,151,7,0,209,62,173,1,0,236,23.1,98,63,5.6,445,False,4,113,324,8,0,2024-11-12,False,False,False,0.7280898876404495,0.2539325842696629,0.017977528089887642,0.0,Off-Peak,Tuesday,November
2024-11-12 05:00:00,53,229,7,1,290,72,183,0,0,255,23.1,97,63,7.7,545,False,5,125,412,7,1,2024-11-12,False,False,False,0.7559633027522936,0.22935779816513763,0.012844036697247707,0.001834862385321101,Shoulder,Tuesday,November
2024-11-12 06:00:00,58,532,8,1,599,64,205,5,0,274,23.2,95,51,2.7,873,False,6,122,737,13,1,2024-11-12,False,False,False,0.8442153493699885,0.13974799541809851,0.014891179839633447,0.001145475372279496,Shoulder,Tuesday,November
2024-11-12 07:00:00,50,659,9,1,719,98,424,6,0,528,23.0,96,3,1.6,1247,False,7,148,1083,15,1,2024-11-12,False,False,False,0.8684843624699278,0.11868484362469928,0.012028869286287089,0.0008019246190858059,Peak,Tuesday,November
2024-11-12 08:00:00,46,507,7,2,562,89,290,5,0,384,24.1,93,3,4.8,946,False,8,135,797,12,2,2024-11-12,False,False,False,0.8424947145877378,0.1427061310782241,0.012684989429175475,0.0021141649048625794,Peak,Tuesday,November
2024-11-12 09:00:00,49,567,8,2,626,95,228,5,1,329,26.6,89,3,6.2,955,False,9,144,795,13,3,2024-11-12,False,False,False,0.8324607329842932,0.15078534031413612,0.013612565445026177,0.0031413612565445027,Shoulder,Tuesday,November
2024-11-12 10:00:00,71,520,11,1,603,83,235,6,1,325,27.9,81,51,10.9,928,False,10,154,755,17,2,2024-11-12,False,False,False,0.8135775862068966,0.16594827586206898,0.018318965517241378,0.0021551724137931034,Shoulder,Tuesday,November
2024-11-12 11:00:00,58,578,10,2,648,90,321,5,1,417,28.6,76,51,8.0,1065,False,11,148,899,15,3,2024-11-12,False,False,False,0.844131455399061,0.13896713615023473,0.014084507042253521,0.0028169014084507044,Peak,Tuesday,November
2024-11-12 12:00:00,66,437,11,2,516,90,303,6,1,400,29.3,75,51,9.2,916,False,12,156,740,17,3,2024-11-12,False,False,False,0.8078602620087336,0.1703056768558952,0.018558951965065504,0.0032751091703056767,Peak,Tuesday,November
2024-11-12 13:00:00,63,346,8,1,418,91,240,4,1,336,29.9,74,51,8.2,754,False,13,154,586,12,2,2024-11-12,False,False,False,0.7771883289124668,0.20424403183023873,0.015915119363395226,0.002652519893899204,Peak,Tuesday,November
2024-11-12 14:00:00,57,434,9,2,502,98,201,5,1,305,30.1,71,51,11.3,807,False,14,155,635,14,3,2024-11-12,False,False,False,0.7868649318463445,0.19206939281288724,0.01734820322180917,0.0037174721189591076,Peak,Tuesday,November
2024-11-12 15:00:00,62,335,11,1,409,90,323,7,1,421,30.0,70,51,9.9,830,False,15,152,658,18,2,2024-11-12,False,False,False,0.7927710843373494,0.18313253012048192,0.021686746987951807,0.0024096385542168677,Peak,Tuesday,November
2024-11-12 16:00:00,51,413,11,1,476,91,310,6,2,409,29.4,73,3,10.9,885,False,16,142,723,17,3,2024-11-12,False,False,False,0.8169491525423729,0.16045197740112993,0.0192090395480226,0.003389830508474576,Peak,Tuesday,November
2024-11-12 17:00:00,43,663,12,2,720,97,269,5,1,372,29.0,75,3,8.4,1092,False,17,140,932,17,3,2024-11-12,False,False,False,0.8534798534798534,0.1282051282051282,0.015567765567765568,0.0027472527472527475,Peak,Tuesday,November
2024-11-12 18:00:00,56,393,12,1,462,90,200,6,1,297,28.6,77,3,7.9,759,False,18,146,593,18,2,2024-11-12,False,False,False,0.7812911725955204,0.19235836627140976,0.023715415019762844,0.002635046113306983,Peak,Tuesday,November
2024-11-12 19:00:00,66,388,11,1,466,97,208,5,1,311,27.3,86,3,2.9,777,False,19,163,596,16,2,2024-11-12,False,False,False,0.767052767052767,0.2097812097812098,0.02059202059202059,0.002574002574002574,Peak,Tuesday,November
2024-11-12 20:00:00,48,387,9,2,446,85,298,6,1,390,27.0,86,3,4.3,836,False,20,133,685,15,3,2024-11-12,False,False,False,0.819377990430622,0.1590909090909091,0.017942583732057416,0.0035885167464114833,Shoulder,Tuesday,November
2024-11-12 21:00:00,52,413,8,1,474,93,310,6,1,410,28.0,83,3,5.3,884,False,21,145,723,14,2,2024-11-12,False,False,False,0.8178733031674208,0.16402714932126697,0.01583710407239819,0.0022624434389140274,Shoulder,Tuesday,November
2024-11-12 22:00:00,48,430,6,2,486,70,300,5,0,375,27.4,88,3,2.4,861,False,22,118,730,11,2,2024-11-12,False,False,False,0.8478513356562137,0.13704994192799072,0.012775842044134728,0.0023228803716608595,Shoulder,Tuesday,November
2024-11-12 23:00:00,68,349,7,0,424,85,289,4,0,378,26.5,90,51,7.7,802,False,23,153,638,11,0,2024-11-12,False,False,False,0.7955112219451371,0.19077306733167082,0.01371571072319202,0.0,Shoulder,Tuesday,November
2024-11-13 00:00:00,60,334,2,0,396,84,204,3,0,291,25.7,94,3,7.6,687,False,0,144,538,5,0,2024-11-13,False,False,False,0.7831149927219796,0.2096069868995633,0.00727802037845706,0.0,Off-Peak,Wednesday,November
2024-11-13 01:00:00,52,179,2,0,233,83,112,2,0,197,25.2,95,3,8.7,430,False,1,135,291,4,0,2024-11-13,False,False,False,0.6767441860465117,0.313953488372093,0.009302325581395349,0.0,Off-Peak,Wednesday,November
2024-11-13 02:00:00,45,185,1,0,231,70,102,1,0,173,24.6,95,3,9.2,404,False,2,115,287,2,0,2024-11-13,False,False,False,0.7103960396039604,0.28465346534653463,0.0049504950495049506,0.0,Off-Peak,Wednesday,November
2024-11-13 03:00:00,46,187,1,0,234,77,167,2,0,246,24.4,94,3,9.3,480,False,3,123,354,3,0,2024-11-13,False,False,False,0.7375,0.25625,0.00625,0.0,Off-Peak,Wednesday,November
2024-11-13 04:00:00,52,191,2,0,245,95,173,1,0,269,24.1,94,3,9.6,514,False,4,147,364,3,0,2024-11-13,False,False,False,0.708171206225681,0.28599221789883267,0.005836575875486381,0.0,Off-Peak,Wednesday,November
2024-11-13 05:00:00,53,329,3,1,386,89,110,0,0,199,24.0,95,3,9.8,585,False,5,142,439,3,1,2024-11-13,False,False,False,0.7504273504273504,0.24273504273504273,0.005128205128205128,0.0017094017094017094,Shoulder,Wednesday,November
2024-11-13 06:00:00,58,431,5,1,495,105,324,5,0,434,23.8,96,3,7.4,929,False,6,163,755,10,1,2024-11-13,False,False,False,0.8127018299246501,0.17545748116254037,0.010764262648008612,0.001076426264800861,Shoulder,Wednesday,November
2024-11-13 07:00:00,50,358,6,1,415,142,625,6,0,773,23.9,96,3,4.2,1188,False,7,192,983,12,1,2024-11-13,False,False,False,0.8274410774410774,0.16161616161616163,0.010101010101010102,0.0008417508417508417,Peak,Wednesday,November
2024-11-13 08:00:00,46,407,7,1,461,87,217,7,0,311,24.6,95,51,2.4,772,False,8,133,624,14,1,2024-11-13,False,False,False,0.8082901554404145,0.172279792746114,0.018134715025906734,0.0012953367875647669,Peak,Wednesday,November
2024-11-13 09:00:00,49,467,5,1,522,97,238,5,1,341,26.7,85,2,7.8,863,False,9,146,705,10,2,2024-11-13,False,False,False,0.816917728852839,0.16917728852838934,0.011587485515643106,0.002317497103128621,Shoulder,Wednesday,November
2024-11-13 10:00:00,71,420,7,1,499,93,235,6,1,335,27.8,82,51,11.0,834,False,10,164,655,13,2,2024-11-13,False,False,False,0.7853717026378897,0.19664268585131894,0.015587529976019185,0.002398081534772182,Shoulder,Wednesday,November
2024-11-13 11:00:00,58,448,5,1,512,103,326,5,1,435,27.1,84,63,3.2,947,False,11,161,774,10,2,2024-11-13,False,False,False,0.8173178458289335,0.1700105596620908,0.010559662090813094,0.0021119324181626186,Peak,Wednesday,November
2024-11-13 12:00:00,66,437,7,1,511,96,303,6,1,406,28.9,79,3,3.1,917,False,12,162,740,13,2,2024-11-13,False,False,False,0.806979280261723,0.1766630316248637,0.014176663031624863,0.0021810250817884407,Peak,Wednesday,November
2024-11-13 13:00:00,63,346,4,1,414,88,243,7,1,339,29.6,77,51,3.8,753,False,13,151,589,11,2,2024-11-13,False,False,False,0.7822045152722443,0.20053120849933598,0.014608233731739707,0.0026560424966799467,Peak,Wednesday,November
2024-11-13 14:00:00,57,434,4,1,496,93,203,5,1,302,29.8,78,51,7.1,798,False,14,150,637,9,2,2024-11-13,False,False,False,0.7982456140350878,0.18796992481203006,0.011278195488721804,0.002506265664160401,Peak,Wednesday,November
2024-11-13 15:00:00,62,602,9,1,674,68,323,5,1,397,29.5,78,63,9.3,1071,False,15,130,925,14,2,2024-11-13,False,False,False,0.8636788048552755,0.12138188608776844,0.013071895424836602,0.0018674136321195146,Peak,Wednesday,November
2024-11-13 16:00:00,51,413,6,1,471,77,310,6,1,394,26.2,85,63,2.3,865,False,16,128,723,12,2,2024-11-13,False,False,False,0.8358381502890173,0.14797687861271677,0.013872832369942197,0.0023121387283236996,Peak,Wednesday,November
2024-11-13 17:00:00,43,453,9,1,506,92,369,5,1,467,26.6,81,51,5.1,973,False,17,135,822,14,2,2024-11-13,False,False,False,0.8448098663926003,0.13874614594039056,0.014388489208633094,0.0020554984583761563,Peak,Wednesday,November
2024-11-13 18:00:00,56,383,7,1,447,84,239,6,1,330,26.9,86,3,7.0,777,False,18,140,622,13,2,2024-11-13,False,False,False,0.8005148005148005,0.18018018018018017,0.01673101673101673,0.002574002574002574,Peak,Wednesday,November
2024-11-13 19:00:00,60,277,6,1,344,94,208,6,1,309,26.4,90,51,4.6,653,False,19,154,485,12,2,2024-11-13,False,False,False,0.7427258805513017,0.23583460949464014,0.018376722817764167,0.0030627871362940277,Peak,Wednesday,November
2024-11-13 20:00:00,48,387,11,1,447,68,298,8,1,375,26.2,92,3,3.6,822,False,20,116,685,19,2,2024-11-13,False,False,False,0.8333333333333334,0.1411192214111922,0.023114355231143552,0.0024330900243309003,Shoulder,Wednesday,November
2024-11-13 21:00:00,52,473,8,1,534,83,300,6,0,389,26.5,94,3,3.9,923,False,21,135,773,14,1,2024-11-13,False,False,False,0.8374864572047671,0.14626218851570963,0.015167930660888408,0.0010834236186348862,Shoulder,Wednesday,November
2024-11-13 22:00:00,48,430,11,0,489,66,300,5,0,371,26.2,96,51,5.2,860,False,22,114,730,16,0,2024-11-13,False,False,False,0.8488372093023255,0.1325581395348837,0.018604651162790697,0.0,Shoulder,Wednesday,November
2024-11-13 23:00:00,68,349,6,0,423,63,286,5,0,354,25.9,96,51,5.9,777,False,23,131,635,11,0,2024-11-13,False,False,False,0.8172458172458172,0.16859716859716858,0.014157014157014158,0.0,Shoulder,Wednesday,November
2024-11-14 00:00:00,73,234,9,0,316,73,204,3,0,280,25.5,97,3,7.1,596,False,0,146,438,12,0,2024-11-14,False,False,False,0.7348993288590604,0.24496644295302014,0.020134228187919462,0.0,Off-Peak,Thursday,November
2024-11-14 01:00:00,66,179,8,0,253,66,112,2,0,180,25.2,98,3,8.5,433,False,1,132,291,10,0,2024-11-14,False,False,False,0.6720554272517321,0.30484988452655887,0.023094688221709007,0.0,Off-Peak,Thursday,November
2024-11-14 02:00:00,36,125,7,0,168,66,102,1,0,169,25.0,97,3,5.5,337,False,2,102,227,8,0,2024-11-14,False,False,False,0.6735905044510386,0.3026706231454006,0.02373887240356083,0.0,Off-Peak,Thursday,November
2024-11-14 03:00:00,50,127,8,0,185,52,67,2,0,121,24.6,98,3,3.1,306,False,3,102,194,10,0,2024-11-14,False,False,False,0.6339869281045751,0.3333333333333333,0.032679738562091505,0.0,Off-Peak,Thursday,November
2024-11-14 04:00:00,29,151,7,0,187,62,95,1,0,158,24.5,98,3,3.1,345,False,4,91,246,8,0,2024-11-14,False,False,False,0.7130434782608696,0.263768115942029,0.02318840579710145,0.0,Off-Peak,Thursday,November
2024-11-14 05:00:00,22,121,7,1,151,72,151,0,0,223,24.3,98,3,0.6,374,False,5,94,272,7,1,2024-11-14,False,False,False,0.7272727272727273,0.25133689839572193,0.01871657754010695,0.00267379679144385,Shoulder,Thursday,November
2024-11-14 06:00:00,74,531,7,1,613,64,205,5,0,274,24.4,98,3,0.6,887,False,6,138,736,12,1,2024-11-14,False,False,False,0.8297632468996617,0.1555806087936866,0.013528748590755355,0.0011273957158962795,Shoulder,Thursday,November
2024-11-14 07:00:00,93,659,7,1,760,98,424,6,0,528,24.3,98,3,2.7,1288,False,7,191,1083,13,1,2024-11-14,False,False,False,0.8408385093167702,0.1482919254658385,0.010093167701863354,0.0007763975155279503,Peak,Thursday,November
2024-11-14 08:00:00,75,407,8,1,491,89,230,5,0,324,25.3,96,2,3.6,815,False,8,164,637,13,1,2024-11-14,False,False,False,0.7815950920245399,0.20122699386503068,0.015950920245398775,0.001226993865030675,Peak,Thursday,November
2024-11-14 09:00:00,52,467,6,0,525,95,228,5,1,329,27.3,85,2,6.1,854,False,9,147,695,11,1,2024-11-14,False,False,False,0.8138173302107728,0.1721311475409836,0.01288056206088993,0.00117096018735363,Shoulder,Thursday,November
2024-11-14 10:00:00,63,420,8,1,492,83,235,6,1,325,29.0,79,2,8.3,817,False,10,146,655,14,2,2024-11-14,False,False,False,0.8017135862913096,0.17870257037943696,0.017135862913096694,0.0024479804161566705,Shoulder,Thursday,November
2024-11-14 11:00:00,60,478,7,1,546,90,321,5,1,417,29.8,75,2,4.9,963,False,11,150,799,12,2,2024-11-14,False,False,False,0.829698857736241,0.1557632398753894,0.012461059190031152,0.0020768431983385254,Peak,Thursday,November
2024-11-14 12:00:00,53,337,9,1,400,90,303,6,1,400,30.5,73,3,4.0,800,False,12,143,640,15,2,2024-11-14,False,False,False,0.8,0.17875,0.01875,0.0025,Peak,Thursday,November
2024-11-14 13:00:00,71,346,9,1,427,91,240,4,1,336,28.8,79,63,11.6,763,False,13,162,586,13,2,2024-11-14,False,False,False,0.7680209698558322,0.21231979030144169,0.01703800786369594,0.002621231979030144,Peak,Thursday,November
2024-11-14 14:00:00,78,434,7,2,521,78,201,5,1,285,27.3,85,63,10.7,806,False,14,156,635,12,3,2024-11-14,False,False,False,0.7878411910669976,0.1935483870967742,0.01488833746898263,0.0037220843672456576,Peak,Thursday,November
2024-11-14 15:00:00,80,335,8,1,424,90,323,5,1,419,29.0,78,51,2.9,843,False,15,170,658,13,2,2024-11-14,False,False,False,0.7805456702253856,0.20166073546856464,0.01542111506524318,0.002372479240806643,Peak,Thursday,November
2024-11-14 16:00:00,97,413,9,1,520,91,310,6,2,409,29.3,77,51,3.1,929,False,16,188,723,15,3,2024-11-14,False,False,False,0.7782561894510226,0.2023681377825619,0.016146393972012917,0.0032292787944025836,Peak,Thursday,November
2024-11-14 17:00:00,94,623,10,1,728,97,269,5,1,372,28.3,79,61,8.2,1100,False,17,191,892,15,2,2024-11-14,False,False,False,0.8109090909090909,0.17363636363636364,0.013636363636363636,0.0018181818181818182,Peak,Thursday,November
2024-11-14 18:00:00,90,483,9,1,583,90,200,6,1,297,26.6,88,61,5.5,880,False,18,180,683,15,2,2024-11-14,False,False,False,0.7761363636363636,0.20454545454545456,0.017045454545454544,0.0022727272727272726,Peak,Thursday,November
2024-11-14 19:00:00,97,279,7,1,384,97,208,5,1,311,26.1,91,3,3.4,695,False,19,194,487,12,2,2024-11-14,False,False,False,0.7007194244604317,0.27913669064748203,0.017266187050359712,0.0028776978417266188,Peak,Thursday,November
2024-11-14 20:00:00,85,387,8,2,482,85,298,5,1,389,25.8,95,3,1.4,871,False,20,170,685,13,3,2024-11-14,False,False,False,0.7864523536165328,0.19517795637198623,0.014925373134328358,0.003444316877152698,Shoulder,Thursday,November
2024-11-14 21:00:00,56,413,7,1,477,86,310,6,1,403,25.2,95,65,8.3,880,False,21,142,723,13,2,2024-11-14,False,False,False,0.821590909090909,0.16136363636363638,0.014772727272727272,0.0022727272727272726,Shoulder,Thursday,November
2024-11-14 22:00:00,72,430,11,1,514,79,300,5,0,384,25.0,95,55,6.9,898,False,22,151,730,16,1,2024-11-14,False,False,False,0.8129175946547884,0.16815144766146994,0.017817371937639197,0.0011135857461024498,Shoulder,Thursday,November
2024-11-14 23:00:00,85,349,8,0,442,85,289,4,0,378,24.7,96,51,6.1,820,False,23,170,638,12,0,2024-11-14,False,False,False,0.7780487804878049,0.2073170731707317,0.014634146341463415,0.0,Shoulder,Thursday,November
2024-11-15 00:00:00,73,334,9,0,416,84,101,3,0,188,24.7,96,51,5.8,604,False,0,157,435,12,0,2024-11-15,False,False,False,0.7201986754966887,0.2599337748344371,0.019867549668874173,0.0,Off-Peak,Friday,November
2024-11-15 01:00:00,66,179,9,0,254,110,91,2,0,203,24.9,96,3,5.7,457,False,1,176,270,11,0,2024-11-15,False,False,False,0.5908096280087527,0.3851203501094092,0.024070021881838075,0.0,Off-Peak,Friday,November
2024-11-15 02:00:00,66,155,8,0,229,76,83,4,0,163,24.6,98,3,5.4,392,False,2,142,238,12,0,2024-11-15,False,False,False,0.6071428571428571,0.3622448979591837,0.030612244897959183,0.0,Off-Peak,Friday,November
2024-11-15 03:00:00,52,127,6,0,185,77,50,2,0,129,24.7,97,3,8.0,314,False,3,129,177,8,0,2024-11-15,False,False,False,0.5636942675159236,0.410828025477707,0.025477707006369428,0.0,Off-Peak,Friday,November
2024-11-15 04:00:00,62,91,7,0,160,75,30,2,0,107,24.7,97,3,7.7,267,False,4,137,121,9,0,2024-11-15,False,False,False,0.45318352059925093,0.5131086142322098,0.033707865168539325,0.0,Off-Peak,Friday,November
2024-11-15 05:00:00,72,129,9,1,211,89,56,3,0,148,24.7,97,3,8.0,359,False,5,161,185,12,1,2024-11-15,False,False,False,0.5153203342618384,0.44846796657381616,0.033426183844011144,0.002785515320334262,Shoulder,Friday,November
2024-11-15 06:00:00,64,331,13,1,409,105,214,5,0,324,24.6,97,3,4.9,733,False,6,169,545,18,1,2024-11-15,False,False,False,0.7435197817189632,0.2305593451568895,0.02455661664392906,0.001364256480218281,Shoulder,Friday,November
2024-11-15 07:00:00,98,718,13,1,830,178,450,6,1,635,24.4,98,3,4.5,1465,False,7,276,1168,19,2,2024-11-15,False,False,True,0.7972696245733788,0.18839590443686008,0.012969283276450512,0.0013651877133105802,Peak,Friday,November
2024-11-15 08:00:00,89,612,14,1,716,187,484,7,1,679,25.1,95,3,6.0,1395,False,8,276,1096,21,2,2024-11-15,False,False,True,0.785663082437276,0.1978494623655914,0.015053763440860216,0.0014336917562724014,Peak,Friday,November
2024-11-15 09:00:00,95,567,12,1,675,97,402,5,1,505,26.9,91,51,8.0,1180,False,9,192,969,17,2,2024-11-15,False,False,False,0.8211864406779661,0.16271186440677965,0.01440677966101695,0.001694915254237288,Shoulder,Friday,November
2024-11-15 10:00:00,83,420,12,1,516,93,326,6,0,425,28.1,84,51,4.8,941,False,10,176,746,18,1,2024-11-15,False,False,False,0.7927736450584485,0.18703506907545164,0.019128586609989374,0.0010626992561105207,Shoulder,Friday,November
2024-11-15 11:00:00,90,478,17,1,586,103,333,5,1,442,29.3,77,51,4.6,1028,False,11,193,811,22,2,2024-11-15,False,False,False,0.7889105058365758,0.1877431906614786,0.021400778210116732,0.0019455252918287938,Peak,Friday,November
2024-11-15 12:00:00,90,437,15,2,544,96,380,6,2,484,29.9,74,51,5.8,1028,False,12,186,817,21,4,2024-11-15,False,False,False,0.7947470817120622,0.18093385214007782,0.020428015564202335,0.0038910505836575876,Peak,Friday,November
2024-11-15 13:00:00,91,436,14,1,542,60,421,4,1,486,30.3,72,51,7.6,1028,False,13,151,857,18,2,2024-11-15,False,False,False,0.8336575875486382,0.14688715953307394,0.017509727626459144,0.0019455252918287938,Peak,Friday,November
2024-11-15 14:00:00,98,434,16,2,550,100,467,5,1,573,28.8,80,63,8.2,1123,False,14,198,901,21,3,2024-11-15,False,False,False,0.8023152270703473,0.176313446126447,0.018699910952804988,0.0026714158504007124,Peak,Friday,November
2024-11-15 15:00:00,90,435,11,2,538,68,0,5,1,74,29.5,77,51,3.8,612,False,15,158,435,16,3,2024-11-15,False,False,False,0.7107843137254902,0.2581699346405229,0.026143790849673203,0.004901960784313725,Peak,Friday,November
2024-11-15 16:00:00,91,413,14,1,519,77,342,6,1,426,28.8,80,51,2.1,945,False,16,168,755,20,2,2024-11-15,False,False,False,0.798941798941799,0.17777777777777778,0.021164021164021163,0.0021164021164021165,Peak,Friday,November
2024-11-15 17:00:00,97,603,12,2,714,130,458,5,1,594,27.9,84,51,3.6,1308,False,17,227,1061,17,3,2024-11-15,False,False,False,0.8111620795107034,0.1735474006116208,0.012996941896024464,0.0022935779816513763,Peak,Friday,November
2024-11-15 18:00:00,90,662,12,2,766,184,451,6,1,642,27.6,82,55,4.3,1408,False,18,274,1113,18,3,2024-11-15,False,False,True,0.7904829545454546,0.19460227272727273,0.01278409090909091,0.002130681818181818,Peak,Friday,November
2024-11-15 19:00:00,97,674,17,2,790,104,425,6,1,536,26.8,89,3,3.2,1326,False,19,201,1099,23,3,2024-11-15,False,False,False,0.8288084464555053,0.1515837104072398,0.017345399698340876,0.0022624434389140274,Peak,Friday,November
2024-11-15 20:00:00,85,687,12,2,786,138,455,5,1,599,26.2,95,3,5.0,1385,False,20,223,1142,17,3,2024-11-15,False,False,True,0.8245487364620938,0.16101083032490976,0.01227436823104693,0.0021660649819494585,Shoulder,Friday,November
2024-11-15 21:00:00,93,513,15,1,622,156,424,6,1,587,24.8,94,51,10.4,1209,False,21,249,937,21,2,2024-11-15,False,False,False,0.7750206782464847,0.20595533498759305,0.017369727047146403,0.0016542597187758478,Shoulder,Friday,November
2024-11-15 22:00:00,82,530,13,1,626,106,335,7,1,449,24.3,96,61,10.1,1075,False,22,188,865,20,2,2024-11-15,False,False,False,0.8046511627906977,0.17488372093023255,0.018604651162790697,0.0018604651162790699,Shoulder,Friday,November
2024-11-15 23:00:00,85,349,10,0,444,73,271,4,0,348,24.5,96,51,6.7,792,False,23,158,620,14,0,2024-11-15,False,False,False,0.7828282828282829,0.1994949494949495,0.017676767676767676,0.0,Shoulder,Friday,November
2024-11-16 00:00:00,53,334,9,0,396,84,101,3,0,188,24.7,96,3,5.7,584,True,0,137,435,12,0,2024-11-16,False,False,False,0.7448630136986302,0.2345890410958904,0.02054794520547945,0.0,Off-Peak,Saturday,November
2024-11-16 01:00:00,56,245,9,0,310,110,91,2,0,203,24.4,98,3,5.8,513,True,1,166,336,11,0,2024-11-16,False,False,False,0.6549707602339181,0.3235867446393762,0.021442495126705652,0.0,Off-Peak,Saturday,November
2024-11-16 02:00:00,56,155,8,0,219,76,83,4,0,163,24.2,98,3,4.3,382,True,2,132,238,12,0,2024-11-16,False,False,False,0.6230366492146597,0.34554973821989526,0.031413612565445025,0.0,Off-Peak,Saturday,November
2024-11-16 03:00:00,52,127,6,0,185,77,50,2,0,129,23.8,98,51,3.5,314,True,3,129,177,8,0,2024-11-16,False,False,False,0.5636942675159236,0.410828025477707,0.025477707006369428,0.0,Off-Peak,Saturday,November
2024-11-16 04:00:00,52,191,7,0,250,75,30,2,0,107,23.6,99,53,3.1,357,True,4,127,221,9,0,2024-11-16,False,False,False,0.6190476190476191,0.3557422969187675,0.025210084033613446,0.0,Off-Peak,Saturday,November
2024-11-16 05:00:00,52,229,9,1,291,89,56,3,0,148,23.6,99,61,2.2,439,True,5,141,285,12,1,2024-11-16,False,False,False,0.6492027334851936,0.3211845102505695,0.02733485193621868,0.002277904328018223,Shoulder,Saturday,November
2024-11-16 06:00:00,54,431,13,1,499,105,114,5,0,224,23.2,98,53,3.7,723,True,6,159,545,18,1,2024-11-16,False,False,False,0.7538035961272476,0.21991701244813278,0.024896265560165973,0.0013831258644536654,Shoulder,Saturday,November
2024-11-16 07:00:00,78,458,13,1,550,128,450,9,1,588,23.3,98,51,1.4,1138,True,7,206,908,22,2,2024-11-16,False,False,False,0.7978910369068541,0.18101933216168717,0.019332161687170474,0.0017574692442882249,Peak,Saturday,November
2024-11-16 08:00:00,79,407,14,1,501,137,484,7,1,629,24.1,94,51,5.8,1130,True,8,216,891,21,2,2024-11-16,False,False,False,0.7884955752212389,0.1911504424778761,0.018584070796460177,0.0017699115044247787,Peak,Saturday,November
2024-11-16 09:00:00,75,467,12,1,555,97,402,5,1,505,27.2,86,3,4.1,1060,True,9,172,869,17,2,2024-11-16,False,False,False,0.819811320754717,0.16226415094339622,0.016037735849056604,0.0018867924528301887,Shoulder,Saturday,November
2024-11-16 10:00:00,83,520,12,1,616,93,326,7,0,426,28.6,79,3,7.6,1042,True,10,176,846,19,1,2024-11-16,False,False,False,0.8119001919385797,0.1689059500959693,0.018234165067178502,0.0009596928982725527,Shoulder,Saturday,November
2024-11-16 11:00:00,90,578,17,1,686,103,333,5,1,442,29.6,77,51,8.0,1128,True,11,193,911,22,2,2024-11-16,False,False,False,0.8076241134751773,0.17109929078014185,0.01950354609929078,0.0017730496453900709,Peak,Saturday,November
2024-11-16 12:00:00,90,537,15,2,644,96,390,6,2,494,30.0,74,51,3.4,1138,True,12,186,927,21,4,2024-11-16,False,False,False,0.8145869947275922,0.1634446397188049,0.01845342706502636,0.0035149384885764497,Peak,Saturday,November
2024-11-16 13:00:00,91,536,14,1,642,60,421,4,1,486,30.0,77,51,5.1,1128,True,13,151,957,18,2,2024-11-16,False,False,False,0.848404255319149,0.13386524822695037,0.015957446808510637,0.0017730496453900709,Peak,Saturday,November
2024-11-16 14:00:00,98,434,16,1,549,78,467,7,1,553,27.6,85,65,11.6,1102,True,14,176,901,23,2,2024-11-16,False,False,False,0.8176043557168784,0.15970961887477314,0.020871143375680582,0.0018148820326678765,Peak,Saturday,November
2024-11-16 15:00:00,90,535,17,1,643,68,0,5,1,74,27.4,84,63,9.0,717,True,15,158,535,22,2,2024-11-16,False,False,False,0.7461645746164575,0.2203626220362622,0.030683403068340307,0.002789400278940028,Peak,Saturday,November
2024-11-16 16:00:00,91,513,14,1,619,77,342,6,1,426,25.5,92,65,8.7,1045,True,16,168,855,20,2,2024-11-16,False,False,False,0.8181818181818182,0.16076555023923444,0.019138755980861243,0.0019138755980861245,Peak,Saturday,November
2024-11-16 17:00:00,87,503,14,1,605,130,458,5,1,594,24.9,93,51,7.5,1199,True,17,217,961,19,2,2024-11-16,False,False,False,0.8015012510425354,0.18098415346121768,0.0158465387823186,0.0016680567139282735,Peak,Saturday,November
2024-11-16 18:00:00,90,462,16,1,569,184,451,9,1,645,25.3,90,51,4.5,1214,True,18,274,913,25,2,2024-11-16,False,False,False,0.7520593080724877,0.2257001647446458,0.02059308072487644,0.0016474464579901153,Peak,Saturday,November
2024-11-16 19:00:00,81,574,17,1,673,104,425,8,1,538,24.4,96,65,4.0,1211,True,19,185,999,25,2,2024-11-16,False,False,False,0.8249380677126342,0.152766308835673,0.02064409578860446,0.0016515276630883566,Peak,Saturday,November
2024-11-16 20:00:00,85,487,12,2,586,138,454,5,1,598,24.0,97,63,5.6,1184,True,20,223,941,17,3,2024-11-16,False,False,False,0.7947635135135135,0.1883445945945946,0.014358108108108109,0.002533783783783784,Shoulder,Saturday,November
2024-11-16 21:00:00,93,413,15,1,522,96,424,6,1,527,24.4,96,51,7.1,1049,True,21,189,837,21,2,2024-11-16,False,False,False,0.797902764537655,0.1801715919923737,0.02001906577693041,0.0019065776930409914,Shoulder,Saturday,November
2024-11-16 22:00:00,82,430,13,1,526,106,330,7,1,444,24.5,96,3,5.8,970,True,22,188,760,20,2,2024-11-16,False,False,False,0.7835051546391752,0.19381443298969073,0.020618556701030927,0.002061855670103093,Shoulder,Saturday,November
2024-11-16 23:00:00,85,349,10,0,444,73,291,7,0,371,24.3,97,53,5.6,815,True,23,158,640,17,0,2024-11-16,False,False,False,0.7852760736196319,0.19386503067484662,0.020858895705521473,0.0,Shoulder,Saturday,November
2024-11-17 00:00:00,53,389,9,0,451,78,101,4,0,183,24.5,98,51,5.2,634,True,0,131,490,13,0,2024-11-17,False,False,False,0.7728706624605678,0.20662460567823343,0.02050473186119874,0.0,Off-Peak,Sunday,November
2024-11-17 01:00:00,56,238,9,0,303,60,91,6,0,157,24.1,99,3,6.0,460,True,1,116,329,15,0,2024-11-17,False,False,False,0.7152173913043478,0.25217391304347825,0.03260869565217391,0.0,Off-Peak,Sunday,November
2024-11-17 02:00:00,56,169,8,0,233,45,83,6,0,134,24.1,98,3,5.4,367,True,2,101,252,14,0,2024-11-17,False,False,False,0.6866485013623979,0.27520435967302453,0.03814713896457766,0.0,Off-Peak,Sunday,November
2024-11-17 03:00:00,52,199,6,0,257,36,50,4,0,90,24.2,97,3,7.5,347,True,3,88,249,10,0,2024-11-17,False,False,False,0.7175792507204611,0.25360230547550433,0.02881844380403458,0.0,Off-Peak,Sunday,November
2024-11-17 04:00:00,52,162,7,0,221,48,30,7,0,85,24.2,97,3,8.4,306,True,4,100,192,14,0,2024-11-17,False,False,False,0.6274509803921569,0.32679738562091504,0.0457516339869281,0.0,Off-Peak,Sunday,November
2024-11-17 05:00:00,52,222,12,1,287,57,56,5,0,118,24.1,96,3,8.6,405,True,5,109,278,17,1,2024-11-17,False,False,False,0.6864197530864198,0.2691358024691358,0.04197530864197531,0.0024691358024691358,Shoulder,Sunday,November
2024-11-17 06:00:00,54,455,12,1,522,103,314,6,0,423,23.7,98,3,5.8,945,True,6,157,769,18,1,2024-11-17,False,False,False,0.8137566137566138,0.16613756613756614,0.01904761904761905,0.0010582010582010583,Shoulder,Sunday,November
2024-11-17 07:00:00,78,607,13,1,699,178,491,5,1,675,23.3,99,3,3.0,1374,True,7,256,1098,18,2,2024-11-17,False,False,True,0.7991266375545851,0.18631732168850074,0.013100436681222707,0.001455604075691412,Peak,Sunday,November
2024-11-17 08:00:00,79,637,12,1,729,100,484,6,1,591,24.6,96,3,6.0,1320,True,8,179,1121,18,2,2024-11-17,False,False,False,0.8492424242424242,0.13560606060606062,0.013636363636363636,0.0015151515151515152,Peak,Sunday,November
2024-11-17 09:00:00,75,461,11,2,549,120,402,8,1,531,26.0,90,51,9.7,1080,True,9,195,863,19,3,2024-11-17,False,False,False,0.799074074074074,0.18055555555555555,0.017592592592592594,0.002777777777777778,Shoulder,Sunday,November
2024-11-17 10:00:00,83,577,11,2,673,107,476,8,0,591,27.3,85,3,9.8,1264,True,10,190,1053,19,2,2024-11-17,False,False,False,0.8330696202531646,0.15031645569620253,0.015031645569620253,0.0015822784810126582,Shoulder,Sunday,November
2024-11-17 11:00:00,74,535,10,2,621,103,433,6,1,543,28.4,82,51,8.8,1164,True,11,177,968,16,3,2024-11-17,False,False,False,0.8316151202749141,0.15206185567010308,0.013745704467353952,0.002577319587628866,Peak,Sunday,November
2024-11-17 12:00:00,80,551,11,2,644,139,480,7,2,628,29.0,79,51,6.6,1272,True,12,219,1031,18,4,2024-11-17,False,False,False,0.8105345911949685,0.1721698113207547,0.014150943396226415,0.0031446540880503146,Peak,Sunday,November
2024-11-17 13:00:00,91,538,11,1,641,168,421,8,1,598,29.7,75,51,5.3,1239,True,13,259,959,19,2,2024-11-17,False,False,False,0.7740112994350282,0.20903954802259886,0.01533494753833737,0.0016142050040355124,Peak,Sunday,November
2024-11-17 14:00:00,97,517,10,2,626,123,467,9,1,600,30.0,73,51,5.6,1226,True,14,220,984,19,3,2024-11-17,False,False,False,0.802610114192496,0.17944535073409462,0.015497553017944535,0.0024469820554649264,Peak,Sunday,November
2024-11-17 15:00:00,90,518,11,1,620,116,0,7,1,124,29.2,75,63,11.6,744,True,15,206,518,18,2,2024-11-17,False,False,False,0.696236559139785,0.2768817204301075,0.024193548387096774,0.002688172043010753,Peak,Sunday,November
2024-11-17 16:00:00,91,556,11,1,659,120,442,7,1,570,26.4,86,65,6.3,1229,True,16,211,998,18,2,2024-11-17,False,False,False,0.8120423108218063,0.17168429617575265,0.014646053702196907,0.0016273393002441008,Peak,Sunday,November
2024-11-17 17:00:00,87,665,12,2,766,180,572,6,1,759,26.5,88,51,6.8,1525,True,17,267,1237,18,3,2024-11-17,False,False,True,0.8111475409836065,0.17508196721311475,0.01180327868852459,0.0019672131147540984,Peak,Sunday,November
2024-11-17 18:00:00,90,580,12,1,683,170,451,8,1,630,26.8,90,3,5.9,1313,True,18,260,1031,20,2,2024-11-17,False,False,False,0.7852246763137852,0.19801980198019803,0.015232292460015232,0.0015232292460015233,Peak,Sunday,November
2024-11-17 19:00:00,81,538,11,1,631,159,425,8,1,593,26.3,93,3,4.4,1224,True,19,240,963,19,2,2024-11-17,False,False,False,0.7867647058823529,0.19607843137254902,0.015522875816993464,0.0016339869281045752,Peak,Sunday,November
2024-11-17 20:00:00,85,565,12,2,664,152,456,9,1,618,25.8,96,3,6.4,1282,True,20,237,1021,21,3,2024-11-17,False,False,False,0.7964118564742589,0.18486739469578783,0.01638065522620905,0.00234009360374415,Shoulder,Sunday,November
2024-11-17 21:00:00,93,504,13,1,611,143,429,6,1,579,25.5,91,3,6.8,1190,True,21,236,933,19,2,2024-11-17,False,False,False,0.7840336134453781,0.19831932773109243,0.015966386554621848,0.0016806722689075631,Shoulder,Sunday,November
2024-11-17 22:00:00,82,436,11,1,530,130,435,5,1,571,25.4,91,3,5.7,1101,True,22,212,871,16,2,2024-11-17,False,False,False,0.7910990009082652,0.19255222524977295,0.014532243415077202,0.0018165304268846503,Shoulder,Sunday,November
2024-11-17 23:00:00,85,420,10,0,515,101,298,5,0,404,25.1,93,3,6.4,919,True,23,186,718,15,0,2024-11-17,False,False,False,0.7812840043525572,0.20239390642002175,0.01632208922742111,0.0,Shoulder,Sunday,November
2024-11-18 00:00:00,73,389,9,0,471,73,204,3,0,280,24.9,94,3,4.8,751,False,0,146,593,12,0,2024-11-18,False,False,False,0.7896138482023968,0.19440745672436752,0.015978695073235686,0.0,Off-Peak,Monday,November
2024-11-18 01:00:00,66,138,9,0,213,66,112,2,0,180,24.7,96,3,8.0,393,False,1,132,250,11,0,2024-11-18,False,False,False,0.6361323155216285,0.33587786259541985,0.027989821882951654,0.0,Off-Peak,Monday,November
2024-11-18 02:00:00,66,169,8,0,243,66,102,1,0,169,24.4,97,3,6.5,412,False,2,132,271,9,0,2024-11-18,False,False,False,0.6577669902912622,0.32038834951456313,0.021844660194174758,0.0,Off-Peak,Monday,November
2024-11-18 03:00:00,67,199,6,0,272,52,157,2,0,211,24.3,97,3,2.8,483,False,3,119,356,8,0,2024-11-18,False,False,False,0.7370600414078675,0.2463768115942029,0.016563146997929608,0.0,Off-Peak,Monday,November
2024-11-18 04:00:00,69,162,7,0,238,62,162,1,0,225,24.2,97,3,7.0,463,False,4,131,324,8,0,2024-11-18,False,False,False,0.6997840172786177,0.28293736501079914,0.017278617710583154,0.0,Off-Peak,Monday,November
2024-11-18 05:00:00,72,322,9,1,404,72,183,1,0,256,24.1,97,3,6.3,660,False,5,144,505,10,1,2024-11-18,False,False,False,0.7651515151515151,0.21818181818181817,0.015151515151515152,0.0015151515151515152,Shoulder,Monday,November
2024-11-18 06:00:00,74,455,8,1,538,64,205,5,0,274,24.1,97,3,11.1,812,False,6,138,660,13,1,2024-11-18,False,False,False,0.812807881773399,0.16995073891625614,0.01600985221674877,0.0012315270935960591,Shoulder,Monday,November
2024-11-18 07:00:00,68,607,6,1,682,98,424,3,0,525,24.0,97,3,9.7,1207,False,7,166,1031,9,1,2024-11-18,False,False,False,0.8541839270919636,0.1375310687655344,0.007456503728251864,0.0008285004142502071,Peak,Monday,November
2024-11-18 08:00:00,65,627,7,1,700,89,290,5,0,384,24.9,94,3,12.7,1084,False,8,154,917,12,1,2024-11-18,False,False,False,0.8459409594095941,0.14206642066420663,0.01107011070110701,0.0009225092250922509,Peak,Monday,November
2024-11-18 09:00:00,55,661,8,1,725,95,228,5,1,329,26.5,89,3,11.0,1054,False,9,150,889,13,2,2024-11-18,False,False,False,0.8434535104364327,0.14231499051233396,0.012333965844402278,0.0018975332068311196,Shoulder,Monday,November
2024-11-18 10:00:00,63,577,5,1,646,83,235,4,1,323,27.7,81,3,14.7,969,False,10,146,812,9,2,2024-11-18,False,False,False,0.8379772961816305,0.15067079463364294,0.009287925696594427,0.0020639834881320948,Shoulder,Monday,November
2024-11-18 11:00:00,90,535,5,1,631,90,321,5,2,418,28.9,77,51,12.6,1049,False,11,180,856,10,3,2024-11-18,False,False,False,0.8160152526215443,0.17159199237368922,0.009532888465204958,0.002859866539561487,Peak,Monday,November
2024-11-18 12:00:00,90,531,7,1,629,90,303,3,1,397,30.1,74,51,14.2,1026,False,12,180,834,10,2,2024-11-18,False,False,False,0.8128654970760234,0.17543859649122806,0.009746588693957114,0.001949317738791423,Peak,Monday,November
2024-11-18 13:00:00,61,538,8,1,608,91,240,4,1,336,30.1,71,51,18.6,944,False,13,152,778,12,2,2024-11-18,False,False,False,0.8241525423728814,0.16101694915254236,0.012711864406779662,0.00211864406779661,Peak,Monday,November
2024-11-18 14:00:00,78,515,9,1,603,98,201,5,1,305,26.7,86,63,14.9,908,False,14,176,716,14,2,2024-11-18,False,False,False,0.788546255506608,0.19383259911894274,0.015418502202643172,0.0022026431718061676,Peak,Monday,November
2024-11-18 15:00:00,90,518,7,1,616,90,323,7,1,421,28.1,79,51,16.3,1037,False,15,180,841,14,2,2024-11-18,False,False,False,0.81099324975892,0.17357762777242045,0.013500482160077145,0.0019286403085824494,Peak,Monday,November
2024-11-18 16:00:00,61,556,6,1,624,91,310,6,2,409,28.5,79,3,15.3,1033,False,16,152,866,12,3,2024-11-18,False,False,False,0.8383349467570184,0.14714424007744434,0.011616650532429816,0.002904162633107454,Peak,Monday,November
2024-11-18 17:00:00,94,697,5,1,797,97,269,5,1,372,28.5,76,51,17.2,1169,False,17,191,966,10,2,2024-11-18,False,False,False,0.8263473053892215,0.16338751069289992,0.00855431993156544,0.001710863986313088,Peak,Monday,November
2024-11-18 18:00:00,90,580,11,1,682,90,200,6,1,297,26.9,85,53,14.3,979,False,18,180,780,17,2,2024-11-18,False,False,False,0.7967313585291114,0.18386108273748722,0.017364657814096015,0.0020429009193054137,Peak,Monday,November
2024-11-18 19:00:00,67,538,11,1,617,97,208,5,1,311,26.0,90,3,12.1,928,False,19,164,746,16,2,2024-11-18,False,False,False,0.8038793103448276,0.17672413793103448,0.017241379310344827,0.0021551724137931034,Peak,Monday,November
2024-11-18 20:00:00,85,465,12,1,563,82,298,6,1,387,25.4,91,51,13.9,950,False,20,167,763,18,2,2024-11-18,False,False,False,0.8031578947368421,0.17578947368421052,0.018947368421052633,0.002105263157894737,Shoulder,Monday,November
2024-11-18 21:00:00,56,404,8,0,468,93,310,6,1,410,25.3,94,51,15.8,878,False,21,149,714,14,1,2024-11-18,False,False,False,0.8132118451025057,0.16970387243735763,0.015945330296127564,0.0011389521640091116,Shoulder,Monday,November
2024-11-18 22:00:00,72,336,11,0,419,80,300,5,0,385,24.9,94,51,15.0,804,False,22,152,636,16,0,2024-11-18,False,False,False,0.7910447761194029,0.1890547263681592,0.01990049751243781,0.0,Shoulder,Monday,November
2024-11-18 23:00:00,85,420,13,0,518,85,289,4,0,378,24.8,95,51,13.8,896,False,23,170,709,17,0,2024-11-18,False,False,False,0.7912946428571429,0.18973214285714285,0.018973214285714284,0.0,Shoulder,Monday,November
2024-11-19 00:00:00,73,334,2,0,409,73,204,3,0,280,24.6,96,51,12.7,689,False,0,146,538,5,0,2024-11-19,False,False,False,0.7808417997097242,0.21190130624092887,0.00725689404934688,0.0,Off-Peak,Tuesday,November
2024-11-19 01:00:00,66,179,2,0,247,66,112,2,0,180,23.6,97,55,13.9,427,False,1,132,291,4,0,2024-11-19,False,False,False,0.6814988290398126,0.3091334894613583,0.00936768149882904,0.0,Off-Peak,Tuesday,November
2024-11-19 02:00:00,36,155,1,0,192,44,91,1,0,136,23.5,97,61,12.4,328,False,2,80,246,2,0,2024-11-19,False,False,False,0.75,0.24390243902439024,0.006097560975609756,0.0,Off-Peak,Tuesday,November
2024-11-19 03:00:00,50,127,1,0,178,52,97,2,0,151,23.4,97,61,11.0,329,False,3,102,224,3,0,2024-11-19,False,False,False,0.6808510638297872,0.3100303951367781,0.00911854103343465,0.0,Off-Peak,Tuesday,November
2024-11-19 04:00:00,29,91,2,0,122,62,62,1,0,125,23.3,97,63,10.1,247,False,4,91,153,3,0,2024-11-19,False,False,False,0.6194331983805668,0.3684210526315789,0.012145748987854251,0.0,Off-Peak,Tuesday,November
2024-11-19 05:00:00,22,129,3,1,155,42,183,1,0,226,23.3,98,63,8.3,381,False,5,64,312,4,1,2024-11-19,False,False,False,0.8188976377952756,0.1679790026246719,0.010498687664041995,0.0026246719160104987,Shoulder,Tuesday,November
2024-11-19 06:00:00,44,331,5,1,381,64,205,2,0,271,23.3,98,61,9.2,652,False,6,108,536,7,1,2024-11-19,False,False,False,0.8220858895705522,0.1656441717791411,0.010736196319018405,0.0015337423312883436,Shoulder,Tuesday,November
2024-11-19 07:00:00,68,718,6,1,793,98,424,3,0,525,23.2,98,53,10.3,1318,False,7,166,1142,9,1,2024-11-19,False,False,False,0.866464339908953,0.125948406676783,0.006828528072837633,0.0007587253414264037,Peak,Tuesday,November
2024-11-19 08:00:00,65,612,7,1,685,89,290,5,0,384,23.4,99,61,8.8,1069,False,8,154,902,12,1,2024-11-19,False,False,False,0.8437792329279701,0.14405986903648269,0.011225444340505144,0.0009354536950420954,Peak,Tuesday,November
2024-11-19 09:00:00,55,567,5,1,628,95,228,5,1,329,25.1,93,51,10.1,957,False,9,150,795,10,2,2024-11-19,False,False,False,0.8307210031347962,0.15673981191222572,0.01044932079414838,0.0020898641588296763,Shoulder,Tuesday,November
2024-11-19 10:00:00,63,420,5,1,489,83,235,4,1,323,26.4,89,51,10.6,812,False,10,146,655,9,2,2024-11-19,False,False,False,0.8066502463054187,0.17980295566502463,0.011083743842364532,0.0024630541871921183,Shoulder,Tuesday,November
2024-11-19 11:00:00,50,478,5,1,534,90,321,5,1,417,26.9,85,51,10.1,951,False,11,140,799,10,2,2024-11-19,False,False,False,0.8401682439537329,0.14721345951629863,0.010515247108307046,0.002103049421661409,Peak,Tuesday,November
2024-11-19 12:00:00,53,437,7,2,499,90,303,3,1,397,26.8,85,61,7.8,896,False,12,143,740,10,3,2024-11-19,False,False,False,0.8258928571428571,0.15959821428571427,0.011160714285714286,0.0033482142857142855,Peak,Tuesday,November
2024-11-19 13:00:00,61,436,5,1,503,91,240,4,1,336,27.1,86,53,5.8,839,False,13,152,676,9,2,2024-11-19,False,False,False,0.8057210965435042,0.18116805721096543,0.010727056019070322,0.0023837902264600714,Peak,Tuesday,November
2024-11-19 14:00:00,78,434,7,1,520,98,201,5,1,305,27.7,86,51,5.8,825,False,14,176,635,12,2,2024-11-19,False,False,False,0.7696969696969697,0.21333333333333335,0.014545454545454545,0.0024242424242424242,Peak,Tuesday,November
2024-11-19 15:00:00,70,435,7,2,514,90,323,5,1,419,26.2,86,63,14.3,933,False,15,160,758,12,3,2024-11-19,False,False,False,0.812433011789925,0.1714898177920686,0.012861736334405145,0.003215434083601286,Peak,Tuesday,November
2024-11-19 16:00:00,67,413,6,1,487,91,310,6,1,408,25.2,95,61,7.7,895,False,16,158,723,12,2,2024-11-19,False,False,False,0.8078212290502793,0.17653631284916202,0.013407821229050279,0.0022346368715083797,Peak,Tuesday,November
2024-11-19 17:00:00,64,623,5,1,693,97,269,5,1,372,25.8,93,53,8.1,1065,False,17,161,892,10,2,2024-11-19,False,False,False,0.8375586854460094,0.1511737089201878,0.009389671361502348,0.0018779342723004694,Peak,Tuesday,November
2024-11-19 18:00:00,80,662,7,1,750,90,200,6,1,297,25.7,92,51,10.7,1047,False,18,170,862,13,2,2024-11-19,False,False,False,0.8233046800382043,0.1623686723973257,0.012416427889207259,0.0019102196752626551,Peak,Tuesday,November
2024-11-19 19:00:00,67,670,6,1,744,97,208,5,1,311,24.9,94,51,11.1,1055,False,19,164,878,11,2,2024-11-19,False,False,False,0.8322274881516588,0.15545023696682464,0.01042654028436019,0.0018957345971563982,Peak,Tuesday,November
2024-11-19 20:00:00,84,687,11,1,783,82,298,6,1,387,24.5,95,51,10.1,1170,False,20,166,985,17,2,2024-11-19,False,False,False,0.8418803418803419,0.14188034188034188,0.01452991452991453,0.0017094017094017094,Shoulder,Tuesday,November
2024-11-19 21:00:00,53,513,8,0,574,93,310,6,1,410,24.8,94,51,13.0,984,False,21,146,823,14,1,2024-11-19,False,False,False,0.8363821138211383,0.1483739837398374,0.014227642276422764,0.0010162601626016261,Shoulder,Tuesday,November
2024-11-19 22:00:00,72,530,11,0,613,80,300,5,0,385,24.5,95,51,14.2,998,False,22,152,830,16,0,2024-11-19,False,False,False,0.8316633266533067,0.1523046092184369,0.01603206412825651,0.0,Shoulder,Tuesday,November
2024-11-19 23:00:00,75,349,3,0,427,85,289,4,0,378,24.3,96,3,12.3,805,False,23,160,638,7,0,2024-11-19,False,False,False,0.7925465838509317,0.19875776397515527,0.008695652173913044,0.0,Shoulder,Tuesday,November
2024-11-20 00:00:00,50,334,2,0,386,73,96,3,0,172,24.1,96,3,10.1,558,False,0,123,430,5,0,2024-11-20,False,False,False,0.7706093189964157,0.22043010752688172,0.008960573476702509,0.0,Off-Peak,Wednesday,November
2024-11-20 01:00:00,42,179,2,0,223,56,94,2,0,152,24.1,96,51,10.8,375,False,1,98,273,4,0,2024-11-20,False,False,False,0.728,0.2613333333333333,0.010666666666666666,0.0,Off-Peak,Wednesday,November
2024-11-20 02:00:00,30,185,1,0,216,44,91,1,0,136,24.0,97,51,11.0,352,False,2,74,276,2,0,2024-11-20,False,False,False,0.7840909090909091,0.21022727272727273,0.005681818181818182,0.0,Off-Peak,Wednesday,November
2024-11-20 03:00:00,30,127,1,0,158,52,97,2,0,151,23.7,97,51,11.9,309,False,3,82,224,3,0,2024-11-20,False,False,False,0.7249190938511327,0.26537216828478966,0.009708737864077669,0.0,Off-Peak,Wednesday,November
2024-11-20 04:00:00,32,191,2,0,225,52,69,1,0,122,23.8,97,3,11.9,347,False,4,84,260,3,0,2024-11-20,False,False,False,0.7492795389048992,0.2420749279538905,0.008645533141210375,0.0,Off-Peak,Wednesday,November
2024-11-20 05:00:00,30,329,3,1,363,42,183,1,0,226,23.7,97,3,11.4,589,False,5,72,512,4,1,2024-11-20,False,False,False,0.8692699490662139,0.12224108658743633,0.006791171477079796,0.001697792869269949,Shoulder,Wednesday,November
2024-11-20 06:00:00,58,431,5,1,495,64,205,5,0,274,23.5,97,3,10.1,769,False,6,122,636,10,1,2024-11-20,False,False,False,0.8270481144343304,0.15864759427828348,0.013003901170351105,0.0013003901170351106,Shoulder,Wednesday,November
2024-11-20 07:00:00,85,658,6,1,750,98,424,6,0,528,23.3,97,3,11.0,1278,False,7,183,1082,12,1,2024-11-20,False,False,False,0.8466353677621283,0.1431924882629108,0.009389671361502348,0.000782472613458529,Peak,Wednesday,November
2024-11-20 08:00:00,46,507,7,1,561,89,290,5,0,384,24.1,95,3,11.1,945,False,8,135,797,12,1,2024-11-20,False,False,False,0.8433862433862434,0.14285714285714285,0.012698412698412698,0.0010582010582010583,Peak,Wednesday,November
2024-11-20 09:00:00,47,467,5,1,520,95,228,5,1,329,26.2,89,3,11.2,849,False,9,142,695,10,2,2024-11-20,False,False,False,0.8186101295641932,0.16725559481743227,0.011778563015312132,0.002355712603062426,Shoulder,Wednesday,November
2024-11-20 10:00:00,61,420,5,1,487,83,235,5,1,324,27.6,84,3,12.6,811,False,10,144,655,10,2,2024-11-20,False,False,False,0.8076448828606658,0.17755856966707767,0.012330456226880395,0.002466091245376079,Shoulder,Wednesday,November
2024-11-20 11:00:00,58,478,5,1,542,90,321,5,1,417,29.2,75,3,14.4,959,False,11,148,799,10,2,2024-11-20,False,False,False,0.8331595411887383,0.1543274244004171,0.010427528675703858,0.0020855057351407717,Peak,Wednesday,November
2024-11-20 12:00:00,66,437,7,1,511,90,305,7,1,403,30.3,71,51,14.4,914,False,12,156,742,14,2,2024-11-20,False,False,False,0.811816192560175,0.17067833698030635,0.015317286652078774,0.002188183807439825,Peak,Wednesday,November
2024-11-20 13:00:00,63,426,5,1,495,91,240,4,1,336,30.1,73,51,14.3,831,False,13,154,666,9,2,2024-11-20,False,False,False,0.8014440433212996,0.18531889290012032,0.010830324909747292,0.0024067388688327317,Peak,Wednesday,November
2024-11-20 14:00:00,57,434,7,1,499,98,201,5,1,305,30.7,70,51,12.2,804,False,14,155,635,12,2,2024-11-20,False,False,False,0.7898009950248757,0.1927860696517413,0.014925373134328358,0.0024875621890547263,Peak,Wednesday,November
2024-11-20 15:00:00,62,435,7,1,505,90,323,5,1,419,26.8,86,63,16.0,924,False,15,152,758,12,2,2024-11-20,False,False,False,0.8203463203463204,0.1645021645021645,0.012987012987012988,0.0021645021645021645,Peak,Wednesday,November
2024-11-20 16:00:00,51,413,6,1,471,91,310,7,1,409,26.9,89,53,10.4,880,False,16,142,723,13,2,2024-11-20,False,False,False,0.821590909090909,0.16136363636363638,0.014772727272727272,0.0022727272727272726,Peak,Wednesday,November
2024-11-20 17:00:00,43,453,5,1,502,97,269,5,1,372,28.2,78,51,18.7,874,False,17,140,722,10,2,2024-11-20,False,False,False,0.8260869565217391,0.16018306636155608,0.011441647597254004,0.002288329519450801,Peak,Wednesday,November
2024-11-20 18:00:00,56,380,7,1,444,91,200,6,1,298,26.7,86,3,16.1,742,False,18,147,580,13,2,2024-11-20,False,False,False,0.7816711590296496,0.19811320754716982,0.01752021563342318,0.0026954177897574125,Peak,Wednesday,November
2024-11-20 19:00:00,50,377,6,1,434,97,208,5,1,311,26.1,89,3,16.8,745,False,19,147,585,11,2,2024-11-20,False,False,False,0.785234899328859,0.19731543624161074,0.01476510067114094,0.0026845637583892616,Peak,Wednesday,November
2024-11-20 20:00:00,48,387,7,1,443,82,298,6,0,386,25.6,90,3,14.5,829,False,20,130,685,13,1,2024-11-20,False,False,False,0.8262967430639324,0.15681544028950542,0.015681544028950542,0.0012062726176115801,Shoulder,Wednesday,November
2024-11-20 21:00:00,52,473,5,0,530,93,310,6,0,409,25.3,93,3,15.1,939,False,21,145,783,11,0,2024-11-20,False,False,False,0.8338658146964856,0.154419595314164,0.011714589989350373,0.0,Shoulder,Wednesday,November
2024-11-20 22:00:00,48,430,6,0,484,80,300,5,0,385,25.2,94,3,13.1,869,False,22,128,730,11,0,2024-11-20,False,False,False,0.8400460299194477,0.1472957422324511,0.012658227848101266,0.0,Shoulder,Wednesday,November
2024-11-20 23:00:00,58,349,3,0,410,85,289,4,0,378,25.0,96,51,11.9,788,False,23,143,638,7,0,2024-11-20,False,False,False,0.8096446700507615,0.1814720812182741,0.008883248730964468,0.0,Shoulder,Wednesday,November
2024-11-21 00:00:00,31,334,2,0,367,73,258,2,0,333,24.8,97,53,11.5,700,False,0,104,592,4,0,2024-11-21,False,False,False,0.8457142857142858,0.14857142857142858,0.005714285714285714,0.0,Off-Peak,Thursday,November
2024-11-21 01:00:00,36,179,2,0,217,66,205,3,0,274,24.6,97,51,11.1,491,False,1,102,384,5,0,2024-11-21,False,False,False,0.7820773930753564,0.20773930753564154,0.010183299389002037,0.0,Off-Peak,Thursday,November
2024-11-21 02:00:00,32,125,1,0,158,66,145,2,0,213,24.5,98,53,10.8,371,False,2,98,270,3,0,2024-11-21,False,False,False,0.7277628032345014,0.2641509433962264,0.008086253369272238,0.0,Off-Peak,Thursday,November
2024-11-21 03:00:00,35,127,1,0,163,79,236,3,0,318,24.4,98,53,10.5,481,False,3,114,363,4,0,2024-11-21,False,False,False,0.7546777546777547,0.23700623700623702,0.008316008316008316,0.0,Off-Peak,Thursday,November
2024-11-21 04:00:00,49,151,2,0,202,69,169,2,0,240,24.3,98,53,9.3,442,False,4,118,320,4,0,2024-11-21,False,False,False,0.7239819004524887,0.2669683257918552,0.00904977375565611,0.0,Off-Peak,Thursday,November
2024-11-21 05:00:00,40,121,3,0,164,72,161,2,0,235,24.1,98,53,8.7,399,False,5,112,282,5,0,2024-11-21,False,False,False,0.706766917293233,0.2807017543859649,0.012531328320802004,0.0,Shoulder,Thursday,November
2024-11-21 06:00:00,43,431,5,0,479,74,158,2,0,234,24.1,98,51,9.1,713,False,6,117,589,7,0,2024-11-21,False,False,False,0.8260869565217391,0.1640953716690042,0.009817671809256662,0.0,Shoulder,Thursday,November
2024-11-21 07:00:00,35,659,6,0,700,68,169,2,0,239,24.0,98,3,9.7,939,False,7,103,828,8,0,2024-11-21,False,False,False,0.8817891373801917,0.10969116080937168,0.008519701810436636,0.0,Peak,Thursday,November
2024-11-21 08:00:00,43,407,7,0,457,65,225,3,1,294,24.4,96,3,11.6,751,False,8,108,632,10,1,2024-11-21,False,False,False,0.8415446071904128,0.14380825565912117,0.013315579227696404,0.0013315579227696406,Peak,Thursday,November
2024-11-21 09:00:00,43,467,7,1,518,55,190,3,1,249,26.2,92,51,9.9,767,False,9,98,657,10,2,2024-11-21,False,False,False,0.8565840938722294,0.12777053455019557,0.01303780964797914,0.002607561929595828,Shoulder,Thursday,November
2024-11-21 10:00:00,37,420,5,1,463,63,224,3,1,291,26.7,90,51,10.0,754,False,10,100,644,8,2,2024-11-21,False,False,False,0.8541114058355438,0.13262599469496023,0.010610079575596816,0.002652519893899204,Shoulder,Thursday,November
2024-11-21 11:00:00,35,478,5,1,519,90,209,3,1,303,27.9,83,3,10.7,822,False,11,125,687,8,2,2024-11-21,False,False,False,0.8357664233576643,0.15206812652068127,0.009732360097323601,0.0024330900243309003,Peak,Thursday,November
2024-11-21 12:00:00,33,437,7,1,478,90,168,3,1,262,29.1,79,51,9.6,740,False,12,123,605,10,2,2024-11-21,False,False,False,0.8175675675675675,0.1662162162162162,0.013513513513513514,0.002702702702702703,Peak,Thursday,November
2024-11-21 13:00:00,34,446,5,1,486,61,254,3,1,319,30.0,75,51,7.9,805,False,13,95,700,8,2,2024-11-21,False,False,False,0.8695652173913043,0.11801242236024845,0.009937888198757764,0.002484472049689441,Peak,Thursday,November
2024-11-21 14:00:00,42,434,7,1,484,78,160,4,1,243,29.3,75,51,11.1,727,False,14,120,594,11,2,2024-11-21,False,False,False,0.8170563961485557,0.16506189821182943,0.015130674002751032,0.002751031636863824,Peak,Thursday,November
2024-11-21 15:00:00,36,435,7,1,479,90,174,3,1,268,29.3,77,51,10.9,747,False,15,126,609,10,2,2024-11-21,False,False,False,0.8152610441767069,0.1686746987951807,0.013386880856760375,0.002677376171352075,Peak,Thursday,November
2024-11-21 16:00:00,48,413,6,1,468,61,213,3,0,277,27.2,82,61,13.7,745,False,16,109,626,9,1,2024-11-21,False,False,False,0.8402684563758389,0.14630872483221477,0.012080536912751677,0.0013422818791946308,Peak,Thursday,November
2024-11-21 17:00:00,53,423,5,1,482,94,220,3,0,317,25.3,92,61,8.8,799,False,17,147,643,8,1,2024-11-21,False,False,False,0.804755944931164,0.18397997496871088,0.010012515644555695,0.0012515644555694619,Peak,Thursday,November
2024-11-21 18:00:00,30,383,7,1,421,90,230,3,0,323,25.6,90,51,3.9,744,False,18,120,613,10,1,2024-11-21,False,False,False,0.8239247311827957,0.16129032258064516,0.013440860215053764,0.0013440860215053765,Peak,Thursday,November
2024-11-21 19:00:00,54,379,6,1,440,67,228,3,0,298,25.0,95,51,7.7,738,False,19,121,607,9,1,2024-11-21,False,False,False,0.8224932249322493,0.16395663956639567,0.012195121951219513,0.0013550135501355014,Peak,Thursday,November
2024-11-21 20:00:00,44,382,10,0,436,85,244,3,0,332,24.9,97,55,6.0,768,False,20,129,626,13,0,2024-11-21,False,False,False,0.8151041666666666,0.16796875,0.016927083333333332,0.0,Shoulder,Thursday,November
2024-11-21 21:00:00,50,413,8,0,471,56,170,3,0,229,24.8,97,65,9.4,700,False,21,106,583,11,0,2024-11-21,False,False,False,0.8328571428571429,0.15142857142857144,0.015714285714285715,0.0,Shoulder,Thursday,November
2024-11-21 22:00:00,37,430,11,0,478,72,176,3,0,251,24.7,97,65,11.3,729,False,22,109,606,14,0,2024-11-21,False,False,False,0.831275720164609,0.149519890260631,0.019204389574759947,0.0,Shoulder,Thursday,November
2024-11-21 23:00:00,49,349,3,0,401,85,237,3,0,325,24.6,98,63,6.4,726,False,23,134,586,6,0,2024-11-21,False,False,False,0.8071625344352618,0.18457300275482094,0.008264462809917356,0.0,Shoulder,Thursday,November
2024-11-22 00:00:00,60,347,9,0,416,78,101,9,0,188,24.5,98,63,4.2,604,False,0,138,448,18,0,2024-11-22,False,False,False,0.7417218543046358,0.22847682119205298,0.029801324503311258,0.0,Off-Peak,Friday,November
2024-11-22 01:00:00,67,273,9,0,349,60,91,5,0,156,24.4,99,63,4.6,505,False,1,127,364,14,0,2024-11-22,False,False,False,0.7207920792079208,0.2514851485148515,0.027722772277227723,0.0,Off-Peak,Friday,November
2024-11-22 02:00:00,60,256,8,0,324,45,83,3,0,131,24.4,99,63,4.3,455,False,2,105,339,11,0,2024-11-22,False,False,False,0.7450549450549451,0.23076923076923078,0.024175824175824177,0.0,Off-Peak,Friday,November
2024-11-22 03:00:00,53,203,6,0,262,36,50,5,0,91,24.3,98,63,7.6,353,False,3,89,253,11,0,2024-11-22,False,False,False,0.71671388101983,0.2521246458923513,0.031161473087818695,0.0,Off-Peak,Friday,November
2024-11-22 04:00:00,34,229,7,0,270,48,30,3,0,81,24.1,98,61,11.0,351,False,4,82,259,10,0,2024-11-22,False,False,False,0.7378917378917379,0.2336182336182336,0.02849002849002849,0.0,Off-Peak,Friday,November
2024-11-22 05:00:00,36,266,16,1,319,57,56,4,1,118,23.8,98,61,12.2,437,False,5,93,322,20,2,2024-11-22,False,False,False,0.7368421052631579,0.2128146453089245,0.04576659038901602,0.004576659038901602,Shoulder,Friday,November
2024-11-22 06:00:00,90,370,15,1,476,92,214,5,1,312,23.6,98,61,10.9,788,False,6,182,584,20,2,2024-11-22,False,False,False,0.7411167512690355,0.23096446700507614,0.025380710659898477,0.0025380710659898475,Shoulder,Friday,November
2024-11-22 07:00:00,130,719,15,1,865,178,491,7,1,677,23.6,98,55,9.9,1542,False,7,308,1210,22,2,2024-11-22,False,False,True,0.7846952010376135,0.19974059662775617,0.014267185473411154,0.0012970168612191958,Peak,Friday,November
2024-11-22 08:00:00,99,607,16,2,724,150,484,8,2,644,23.6,98,61,12.8,1368,False,8,249,1091,24,4,2024-11-22,False,False,False,0.797514619883041,0.18201754385964913,0.017543859649122806,0.0029239766081871343,Peak,Friday,November
2024-11-22 09:00:00,91,509,18,2,620,140,402,6,2,550,25.6,95,3,10.8,1170,False,9,231,911,24,4,2024-11-22,False,False,False,0.7786324786324786,0.19743589743589743,0.020512820512820513,0.003418803418803419,Shoulder,Friday,November
2024-11-22 10:00:00,96,549,12,1,658,127,474,8,1,610,26.3,91,3,9.6,1268,False,10,223,1023,20,2,2024-11-22,False,False,False,0.806782334384858,0.17586750788643532,0.015772870662460567,0.0015772870662460567,Shoulder,Friday,November
2024-11-22 11:00:00,113,688,17,2,820,123,451,7,2,583,27.3,90,51,6.7,1403,False,11,236,1139,24,4,2024-11-22,False,False,True,0.811831789023521,0.16821097647897362,0.017106200997861726,0.002851033499643621,Peak,Friday,November
2024-11-22 12:00:00,149,691,15,2,857,169,580,9,2,760,25.9,89,63,14.3,1617,False,12,318,1271,24,4,2024-11-22,False,False,True,0.7860235003092146,0.19666048237476808,0.014842300556586271,0.0024737167594310453,Peak,Friday,November
2024-11-22 13:00:00,140,632,15,1,788,168,421,9,1,599,26.2,91,51,10.8,1387,False,13,308,1053,24,2,2024-11-22,False,False,True,0.7591925018024513,0.2220620043258832,0.017303532804614274,0.0014419610670511895,Peak,Friday,November
2024-11-22 14:00:00,90,785,16,2,893,143,467,7,2,619,27.2,84,51,11.2,1512,False,14,233,1252,23,4,2024-11-22,False,False,True,0.828042328042328,0.1541005291005291,0.01521164021164021,0.0026455026455026454,Peak,Friday,November
2024-11-22 15:00:00,93,776,18,1,888,146,0,8,1,155,28.2,80,51,10.0,1043,False,15,239,776,26,2,2024-11-22,False,False,False,0.7440076701821668,0.22914669223394055,0.024928092042186004,0.0019175455417066154,Peak,Friday,November
2024-11-22 16:00:00,95,638,16,1,750,140,542,9,1,692,28.7,80,51,7.8,1442,False,16,235,1180,25,2,2024-11-22,False,False,True,0.8183079056865464,0.16296809986130376,0.017337031900138695,0.0013869625520110957,Peak,Friday,November
2024-11-22 17:00:00,84,788,12,2,886,180,572,11,2,765,27.2,86,63,11.5,1651,False,17,264,1360,23,4,2024-11-22,False,False,True,0.8237431859479104,0.1599030890369473,0.013930950938824955,0.0024227740763173833,Peak,Friday,November
2024-11-22 18:00:00,94,742,12,1,849,170,451,9,1,631,25.5,92,61,11.1,1480,False,18,264,1193,21,2,2024-11-22,False,False,True,0.8060810810810811,0.1783783783783784,0.01418918918918919,0.0013513513513513514,Peak,Friday,November
2024-11-22 19:00:00,100,566,17,1,684,159,425,7,1,592,24.9,94,51,9.6,1276,False,19,259,991,24,2,2024-11-22,False,False,False,0.7766457680250783,0.2029780564263323,0.018808777429467086,0.001567398119122257,Peak,Friday,November
2024-11-22 20:00:00,85,436,12,2,535,152,456,7,2,617,24.7,94,51,11.5,1152,False,20,237,892,19,4,2024-11-22,False,False,False,0.7743055555555556,0.20572916666666666,0.016493055555555556,0.003472222222222222,Shoulder,Friday,November
2024-11-22 21:00:00,86,696,15,1,798,143,429,8,1,581,24.8,94,3,12.0,1379,False,21,229,1125,23,2,2024-11-22,False,False,True,0.8158085569253082,0.1660623640319072,0.016678752719361856,0.0014503263234227702,Shoulder,Friday,November
2024-11-22 22:00:00,100,690,13,2,805,130,435,11,2,578,24.7,95,3,13.5,1383,False,22,230,1125,24,4,2024-11-22,False,False,True,0.8134490238611713,0.16630513376717282,0.01735357917570499,0.0028922631959508315,Shoulder,Friday,November
2024-11-22 23:00:00,113,487,10,0,610,101,298,8,0,407,24.6,95,3,13.4,1017,False,23,214,785,18,0,2024-11-22,False,False,False,0.7718780727630286,0.21042281219272368,0.017699115044247787,0.0,Shoulder,Friday,November
2024-11-23 00:00:00,84,347,9,0,440,137,226,9,0,372,24.5,96,3,13.5,812,True,0,221,573,18,0,2024-11-23,False,False,False,0.7056650246305419,0.27216748768472904,0.022167487684729065,0.0,Off-Peak,Saturday,November
2024-11-23 01:00:00,90,273,9,0,372,128,222,8,0,358,24.5,96,3,14.0,730,True,1,218,495,17,0,2024-11-23,False,False,False,0.678082191780822,0.29863013698630136,0.023287671232876714,0.0,Off-Peak,Saturday,November
2024-11-23 02:00:00,80,256,8,0,344,155,255,7,0,417,24.3,96,3,16.6,761,True,2,235,511,15,0,2024-11-23,False,False,False,0.671484888304862,0.3088042049934297,0.01971090670170828,0.0,Off-Peak,Saturday,November
2024-11-23 03:00:00,77,203,6,0,286,132,150,8,0,290,24.0,96,3,17.3,576,True,3,209,353,14,0,2024-11-23,False,False,False,0.6128472222222222,0.3628472222222222,0.024305555555555556,0.0,Off-Peak,Saturday,November
2024-11-23 04:00:00,75,229,7,0,311,157,122,7,0,286,23.8,95,51,18.2,597,True,4,232,351,14,0,2024-11-23,False,False,False,0.5879396984924623,0.38860971524288107,0.023450586264656615,0.0,Off-Peak,Saturday,November
2024-11-23 05:00:00,89,266,9,1,365,149,276,7,1,433,23.5,96,3,15.6,798,True,5,238,542,16,2,2024-11-23,False,False,False,0.6791979949874687,0.2982456140350877,0.020050125313283207,0.002506265664160401,Shoulder,Saturday,November
2024-11-23 06:00:00,105,370,13,1,489,118,319,7,1,445,23.4,96,3,14.9,934,True,6,223,689,20,2,2024-11-23,False,False,False,0.7376873661670236,0.23875802997858672,0.021413276231263382,0.0021413276231263384,Shoulder,Saturday,November
2024-11-23 07:00:00,168,419,13,1,601,124,433,7,1,565,23.3,96,3,13.9,1166,True,7,292,852,20,2,2024-11-23,False,False,False,0.7307032590051458,0.2504288164665523,0.017152658662092625,0.0017152658662092624,Peak,Saturday,November
2024-11-23 08:00:00,169,607,14,2,792,123,436,8,1,568,23.9,94,3,13.0,1360,True,8,292,1043,22,3,2024-11-23,False,False,False,0.7669117647058824,0.21470588235294116,0.016176470588235296,0.0022058823529411764,Peak,Saturday,November
2024-11-23 09:00:00,97,609,12,2,720,164,414,6,2,586,25.3,96,51,8.5,1306,True,9,261,1023,18,4,2024-11-23,False,False,False,0.7833078101071975,0.1998468606431853,0.013782542113323124,0.0030627871362940277,Shoulder,Saturday,November
2024-11-23 10:00:00,93,549,12,1,655,184,441,8,2,635,26.9,91,3,8.3,1290,True,10,277,990,20,3,2024-11-23,False,False,False,0.7674418604651163,0.21472868217054264,0.015503875968992248,0.002325581395348837,Shoulder,Saturday,November
2024-11-23 11:00:00,103,688,17,2,810,182,651,7,2,842,29.0,80,51,9.9,1652,True,11,285,1339,24,4,2024-11-23,False,False,True,0.8105326876513317,0.1725181598062954,0.014527845036319613,0.002421307506053269,Peak,Saturday,November
2024-11-23 12:00:00,96,691,15,2,804,155,548,9,2,714,29.9,77,51,8.4,1518,True,12,251,1239,24,4,2024-11-23,False,False,True,0.8162055335968379,0.16534914361001318,0.015810276679841896,0.002635046113306983,Peak,Saturday,November
2024-11-23 13:00:00,60,632,14,1,707,180,528,9,1,718,29.6,76,51,3.5,1425,True,13,240,1160,23,2,2024-11-23,False,False,True,0.8140350877192982,0.16842105263157894,0.016140350877192983,0.0014035087719298245,Peak,Saturday,November
2024-11-23 14:00:00,100,785,16,2,903,169,612,7,1,789,26.8,87,65,8.3,1692,True,14,269,1397,23,3,2024-11-23,False,False,True,0.8256501182033097,0.15898345153664303,0.013593380614657211,0.0017730496453900709,Peak,Saturday,November
2024-11-23 15:00:00,68,776,11,1,856,151,621,8,1,781,27.0,89,63,6.5,1637,True,15,219,1397,19,2,2024-11-23,False,False,True,0.853390348197923,0.13378130726939524,0.011606597434331093,0.0012217470983506415,Peak,Saturday,November
2024-11-23 16:00:00,77,738,14,1,830,193,631,9,1,834,26.7,87,51,6.7,1664,True,16,270,1369,23,2,2024-11-23,False,False,True,0.8227163461538461,0.1622596153846154,0.013822115384615384,0.001201923076923077,Peak,Saturday,November
2024-11-23 17:00:00,130,788,12,2,932,174,533,10,2,719,26.7,87,51,6.4,1651,True,17,304,1321,22,4,2024-11-23,False,False,True,0.8001211387038158,0.18413082980012113,0.013325257419745608,0.0024227740763173833,Peak,Saturday,November
2024-11-23 18:00:00,84,742,12,1,839,181,678,9,1,869,26.6,89,51,5.4,1708,True,18,265,1420,21,2,2024-11-23,False,False,True,0.8313817330210773,0.15515222482435598,0.012295081967213115,0.00117096018735363,Peak,Saturday,November
2024-11-23 19:00:00,104,636,14,1,755,154,526,7,1,688,26.1,93,3,4.5,1443,True,19,258,1162,21,2,2024-11-23,False,False,True,0.8052668052668053,0.1787941787941788,0.014553014553014554,0.001386001386001386,Peak,Saturday,November
2024-11-23 20:00:00,68,633,12,2,715,180,550,7,2,739,25.8,95,3,6.8,1454,True,20,248,1183,19,4,2024-11-23,False,False,True,0.813617606602476,0.17056396148555708,0.013067400275103164,0.002751031636863824,Shoulder,Saturday,November
2024-11-23 21:00:00,83,696,15,1,795,155,428,7,1,591,25.3,94,51,9.8,1386,True,21,238,1124,22,2,2024-11-23,False,False,True,0.810966810966811,0.1717171717171717,0.015873015873015872,0.001443001443001443,Shoulder,Saturday,November
2024-11-23 22:00:00,106,690,13,2,811,172,543,7,1,723,25.1,94,3,10.9,1534,True,22,278,1233,20,3,2024-11-23,False,False,True,0.8037809647979139,0.18122555410691005,0.01303780964797914,0.001955671447196871,Shoulder,Saturday,November
2024-11-23 23:00:00,63,587,10,0,660,141,493,8,0,642,24.9,95,3,8.4,1302,True,23,204,1080,18,0,2024-11-23,False,False,False,0.8294930875576036,0.15668202764976957,0.013824884792626729,0.0,Shoulder,Saturday,November
2024-11-24 00:00:00,74,289,9,0,372,137,334,9,0,480,24.7,96,3,5.6,852,True,0,211,623,18,0,2024-11-24,False,False,False,0.7312206572769953,0.2476525821596244,0.02112676056338028,0.0,Off-Peak,Sunday,November
2024-11-24 01:00:00,56,238,9,0,303,128,179,9,0,316,24.6,98,3,7.3,619,True,1,184,417,18,0,2024-11-24,False,False,False,0.6736672051696284,0.2972536348949919,0.029079159935379646,0.0,Off-Peak,Sunday,November
2024-11-24 02:00:00,56,169,8,0,233,155,155,8,0,318,24.4,98,3,7.0,551,True,2,211,324,16,0,2024-11-24,False,False,False,0.588021778584392,0.38294010889292196,0.029038112522686024,0.0,Off-Peak,Sunday,November
2024-11-24 03:00:00,57,199,6,0,262,132,127,6,0,265,24.3,98,3,8.1,527,True,3,189,326,12,0,2024-11-24,False,False,False,0.618595825426945,0.3586337760910816,0.022770398481973434,0.0,Off-Peak,Sunday,November
2024-11-24 04:00:00,59,162,7,0,228,157,91,7,0,255,24.2,98,3,8.3,483,True,4,216,253,14,0,2024-11-24,False,False,False,0.5238095238095238,0.4472049689440994,0.028985507246376812,0.0,Off-Peak,Sunday,November
2024-11-24 05:00:00,72,322,14,1,409,149,129,9,1,288,24.1,98,3,9.8,697,True,5,221,451,23,2,2024-11-24,False,False,False,0.6470588235294118,0.3170731707317073,0.03299856527977044,0.0028694404591104736,Shoulder,Sunday,November
2024-11-24 06:00:00,74,455,15,1,545,118,331,8,1,458,24.0,99,3,9.2,1003,True,6,192,786,23,2,2024-11-24,False,False,False,0.7836490528414756,0.1914257228315055,0.022931206380857428,0.0019940179461615153,Shoulder,Sunday,November
2024-11-24 07:00:00,68,607,15,1,691,124,718,6,1,849,23.9,99,3,9.2,1540,True,7,192,1325,21,2,2024-11-24,False,False,True,0.8603896103896104,0.12467532467532468,0.013636363636363636,0.0012987012987012987,Peak,Sunday,November
2024-11-24 08:00:00,65,537,16,1,619,123,612,7,1,743,24.5,97,3,13.3,1362,True,8,188,1149,23,2,2024-11-24,False,False,False,0.8436123348017621,0.13803230543318648,0.016886930983847283,0.0014684287812041115,Peak,Sunday,November
2024-11-24 09:00:00,55,511,17,2,585,164,567,8,2,741,26.2,91,3,12.5,1326,True,9,219,1078,25,4,2024-11-24,False,False,False,0.8129713423831071,0.16515837104072398,0.01885369532428356,0.0030165912518853697,Shoulder,Sunday,November
2024-11-24 10:00:00,63,547,12,1,623,184,420,5,1,610,27.5,83,3,16.9,1233,True,10,247,967,17,2,2024-11-24,False,False,False,0.7842660178426601,0.2003244120032441,0.013787510137875101,0.0016220600162206002,Shoulder,Sunday,November
2024-11-24 11:00:00,90,536,17,1,644,182,478,5,1,666,28.7,76,3,18.0,1310,True,11,272,1014,22,2,2024-11-24,False,False,False,0.7740458015267175,0.20763358778625954,0.016793893129770993,0.0015267175572519084,Peak,Sunday,November
2024-11-24 12:00:00,90,528,15,1,634,155,437,7,1,600,29.9,70,3,15.4,1234,True,12,245,965,22,2,2024-11-24,False,False,False,0.7820097244732577,0.19854132901134522,0.017828200972447326,0.0016207455429497568,Peak,Sunday,November
2024-11-24 13:00:00,61,538,15,1,615,180,436,8,1,625,30.3,69,3,13.5,1240,True,13,241,974,23,2,2024-11-24,False,False,False,0.785483870967742,0.19435483870967743,0.018548387096774192,0.0016129032258064516,Peak,Sunday,November
2024-11-24 14:00:00,78,617,16,1,712,119,434,9,2,564,30.0,69,51,13.5,1276,True,14,197,1051,25,3,2024-11-24,False,False,False,0.8236677115987461,0.15438871473354232,0.019592476489028215,0.0023510971786833857,Peak,Sunday,November
2024-11-24 15:00:00,90,518,18,1,627,151,445,7,1,604,30.5,71,51,7.6,1231,True,15,241,963,25,2,2024-11-24,False,False,False,0.7822908204711616,0.1957757920389927,0.020308692120227456,0.0016246953696181965,Peak,Sunday,November
2024-11-24 16:00:00,61,556,16,1,634,183,532,6,1,722,29.1,77,61,10.8,1356,True,16,244,1088,22,2,2024-11-24,False,False,False,0.8023598820058997,0.17994100294985252,0.016224188790560472,0.0014749262536873156,Peak,Sunday,November
2024-11-24 17:00:00,84,597,12,1,694,174,625,5,1,805,27.1,85,63,11.1,1499,True,17,258,1222,17,2,2024-11-24,False,False,True,0.8152101400933957,0.17211474316210806,0.01134089392928619,0.00133422281521014,Peak,Sunday,November
2024-11-24 18:00:00,90,541,12,1,644,181,662,12,1,856,26.4,88,51,7.7,1500,True,18,271,1203,24,2,2024-11-24,False,False,True,0.802,0.18066666666666667,0.016,0.0013333333333333333,Peak,Sunday,November
2024-11-24 19:00:00,67,538,17,1,623,154,674,11,1,840,26.0,92,51,7.8,1463,True,19,221,1212,28,2,2024-11-24,False,False,True,0.8284347231715653,0.15105946684894053,0.019138755980861243,0.001367053998632946,Peak,Sunday,November
2024-11-24 20:00:00,85,565,12,2,664,140,687,11,2,840,25.9,93,3,6.6,1504,True,20,225,1252,23,4,2024-11-24,False,False,True,0.8324468085106383,0.14960106382978725,0.015292553191489361,0.0026595744680851063,Shoulder,Sunday,November
2024-11-24 21:00:00,56,404,15,1,476,103,513,8,1,625,25.2,99,61,5.5,1101,True,21,159,917,23,2,2024-11-24,False,False,False,0.8328792007266121,0.1444141689373297,0.02089009990917348,0.0018165304268846503,Shoulder,Sunday,November
2024-11-24 22:00:00,72,436,13,1,522,172,530,11,1,714,25.1,97,61,5.9,1236,True,22,244,966,24,2,2024-11-24,False,False,False,0.7815533980582524,0.19741100323624594,0.019417475728155338,0.0016181229773462784,Shoulder,Sunday,November
2024-11-24 23:00:00,85,420,10,0,515,141,349,13,0,503,24.8,98,51,6.5,1018,True,23,226,769,23,0,2024-11-24,False,False,False,0.7554027504911591,0.2220039292730845,0.022593320235756387,0.0,Shoulder,Sunday,November
2024-11-25 00:00:00,63,234,9,0,306,73,204,3,0,280,24.7,98,51,5.3,586,False,0,136,438,12,0,2024-11-25,False,False,False,0.7474402730375427,0.23208191126279865,0.020477815699658702,0.0,Off-Peak,Monday,November
2024-11-25 01:00:00,66,179,9,0,254,66,112,2,0,180,24.6,98,51,8.1,434,False,1,132,291,11,0,2024-11-25,False,False,False,0.6705069124423964,0.30414746543778803,0.02534562211981567,0.0,Off-Peak,Monday,November
2024-11-25 02:00:00,36,125,8,0,169,66,202,1,0,269,24.2,98,3,8.9,438,False,2,102,327,9,0,2024-11-25,False,False,False,0.7465753424657534,0.2328767123287671,0.02054794520547945,0.0,Off-Peak,Monday,November
2024-11-25 03:00:00,53,127,6,0,186,52,167,2,0,221,24.0,98,51,11.8,407,False,3,105,294,8,0,2024-11-25,False,False,False,0.7223587223587223,0.257985257985258,0.019656019656019656,0.0,Off-Peak,Monday,November
2024-11-25 04:00:00,29,151,7,0,187,62,173,1,0,236,23.8,97,61,10.7,423,False,4,91,324,8,0,2024-11-25,False,False,False,0.7659574468085106,0.21513002364066194,0.018912529550827423,0.0,Off-Peak,Monday,November
2024-11-25 05:00:00,22,229,12,1,264,72,183,1,1,257,23.7,97,61,10.7,521,False,5,94,412,13,2,2024-11-25,False,False,False,0.7907869481765835,0.18042226487523993,0.02495201535508637,0.003838771593090211,Shoulder,Monday,November
2024-11-25 06:00:00,44,431,12,1,488,64,205,5,2,276,23.7,97,51,9.2,764,False,6,108,636,17,3,2024-11-25,False,False,False,0.8324607329842932,0.14136125654450263,0.02225130890052356,0.003926701570680628,Shoulder,Monday,November
2024-11-25 07:00:00,98,659,9,1,767,98,424,6,1,529,23.8,96,3,11.6,1296,False,7,196,1083,15,2,2024-11-25,False,False,False,0.8356481481481481,0.15123456790123457,0.011574074074074073,0.0015432098765432098,Peak,Monday,November
2024-11-25 08:00:00,65,507,12,1,585,89,290,5,1,385,24.6,94,3,12.2,970,False,8,154,797,17,2,2024-11-25,False,False,False,0.8216494845360824,0.15876288659793814,0.01752577319587629,0.002061855670103093,Peak,Monday,November
2024-11-25 09:00:00,52,467,11,2,532,95,228,5,1,329,26.0,92,51,10.4,861,False,9,147,695,16,3,2024-11-25,False,False,False,0.8072009291521487,0.17073170731707318,0.018583042973286876,0.003484320557491289,Shoulder,Monday,November
2024-11-25 10:00:00,63,420,8,2,493,83,235,5,1,324,26.8,91,51,7.8,817,False,10,146,655,13,3,2024-11-25,False,False,False,0.8017135862913096,0.17870257037943696,0.01591187270501836,0.0036719706242350062,Shoulder,Monday,November
2024-11-25 11:00:00,50,478,10,2,540,90,321,5,1,417,27.8,87,51,8.7,957,False,11,140,799,15,3,2024-11-25,False,False,False,0.8349007314524556,0.14629049111807732,0.01567398119122257,0.003134796238244514,Peak,Monday,November
2024-11-25 12:00:00,53,437,11,2,503,90,303,6,1,400,28.8,82,51,7.7,903,False,12,143,740,17,3,2024-11-25,False,False,False,0.8194905869324474,0.1583610188261351,0.018826135105204873,0.0033222591362126247,Peak,Monday,November
2024-11-25 13:00:00,61,446,8,1,516,91,240,4,1,336,29.3,79,51,7.3,852,False,13,152,686,12,2,2024-11-25,False,False,False,0.8051643192488263,0.1784037558685446,0.014084507042253521,0.002347417840375587,Peak,Monday,November
2024-11-25 14:00:00,78,434,9,1,522,98,201,5,1,305,29.1,80,51,6.7,827,False,14,176,635,14,2,2024-11-25,False,False,False,0.7678355501813785,0.21281741233373638,0.016928657799274487,0.0024183796856106408,Peak,Monday,November
2024-11-25 15:00:00,70,475,11,1,557,90,323,5,1,419,27.7,83,63,13.0,976,False,15,160,798,16,2,2024-11-25,False,False,False,0.8176229508196722,0.16393442622950818,0.01639344262295082,0.0020491803278688526,Peak,Monday,November
2024-11-25 16:00:00,97,414,11,1,523,91,310,7,1,409,27.3,85,51,11.7,932,False,16,188,724,18,2,2024-11-25,False,False,False,0.776824034334764,0.2017167381974249,0.019313304721030045,0.002145922746781116,Peak,Monday,November
2024-11-25 17:00:00,94,423,8,2,527,97,269,7,1,374,28.0,83,3,11.0,901,False,17,191,692,15,3,2024-11-25,False,False,False,0.7680355160932297,0.21198668146503885,0.016648168701442843,0.003329633740288568,Peak,Monday,November
2024-11-25 18:00:00,90,483,12,1,586,90,202,6,1,299,27.8,84,3,8.5,885,False,18,180,685,18,2,2024-11-25,False,False,False,0.7740112994350282,0.2033898305084746,0.020338983050847456,0.0022598870056497176,Peak,Monday,November
2024-11-25 19:00:00,97,479,11,1,588,97,207,5,1,310,27.3,87,2,6.7,898,False,19,194,686,16,2,2024-11-25,False,False,False,0.7639198218262806,0.21603563474387527,0.017817371937639197,0.0022271714922048997,Peak,Monday,November
2024-11-25 20:00:00,85,387,7,2,481,95,295,6,0,396,26.8,89,3,8.5,877,False,20,180,682,13,2,2024-11-25,False,False,False,0.7776510832383124,0.20524515393386544,0.014823261117445839,0.002280501710376283,Shoulder,Monday,November
2024-11-25 21:00:00,76,413,8,1,498,93,310,6,0,409,25.9,91,3,12.6,907,False,21,169,723,14,1,2024-11-25,False,False,False,0.7971334068357222,0.18632855567805953,0.015435501653803748,0.0011025358324145535,Shoulder,Monday,November
2024-11-25 22:00:00,72,430,11,1,514,86,300,5,0,391,25.8,92,3,12.3,905,False,22,158,730,16,1,2024-11-25,False,False,False,0.8066298342541437,0.17458563535911603,0.017679558011049725,0.0011049723756906078,Shoulder,Monday,November
2024-11-25 23:00:00,85,349,9,0,443,85,289,4,0,378,25.6,93,3,13.6,821,False,23,170,638,13,0,2024-11-25,False,False,False,0.7771010962241169,0.20706455542021923,0.015834348355663823,0.0,Shoulder,Monday,November
2024-11-26 00:00:00,60,234,9,0,303,74,204,2,0,280,25.2,95,3,11.6,583,False,0,134,438,11,0,2024-11-26,False,False,False,0.7512864493996569,0.22984562607204118,0.018867924528301886,0.0,Off-Peak,Tuesday,November
2024-11-26 01:00:00,52,279,9,0,340,83,212,2,0,297,25.0,96,3,9.2,637,False,1,135,491,11,0,2024-11-26,False,False,False,0.7708006279434851,0.2119309262166405,0.01726844583987441,0.0,Off-Peak,Tuesday,November
2024-11-26 02:00:00,45,225,8,0,278,97,202,1,0,300,24.7,97,3,10.0,578,False,2,142,427,9,0,2024-11-26,False,False,False,0.7387543252595156,0.24567474048442905,0.015570934256055362,0.0,Off-Peak,Tuesday,November
2024-11-26 03:00:00,56,107,6,0,169,88,167,1,0,256,24.5,97,3,9.1,425,False,3,144,274,7,0,2024-11-26,False,False,False,0.6447058823529411,0.3388235294117647,0.01647058823529412,0.0,Off-Peak,Tuesday,November
2024-11-26 04:00:00,51,151,7,0,209,85,203,2,0,290,24.4,97,3,11.0,499,False,4,136,354,9,0,2024-11-26,False,False,False,0.7094188376753507,0.2725450901803607,0.018036072144288578,0.0,Off-Peak,Tuesday,November
2024-11-26 05:00:00,53,229,12,1,295,73,210,3,0,286,24.4,96,3,14.0,581,False,5,126,439,15,1,2024-11-26,False,False,False,0.7555938037865749,0.21686746987951808,0.025817555938037865,0.0017211703958691911,Shoulder,Tuesday,November
2024-11-26 06:00:00,58,431,12,1,502,78,224,5,0,307,24.3,97,3,11.2,809,False,6,136,655,17,1,2024-11-26,False,False,False,0.8096415327564895,0.1681087762669963,0.021013597033374538,0.0012360939431396785,Shoulder,Tuesday,November
2024-11-26 07:00:00,70,659,13,1,743,86,425,6,0,517,24.0,99,3,11.5,1260,False,7,156,1084,19,1,2024-11-26,False,False,False,0.8603174603174604,0.12380952380952381,0.01507936507936508,0.0007936507936507937,Peak,Tuesday,November
2024-11-26 08:00:00,46,407,12,1,466,90,317,7,0,414,24.8,94,3,9.3,880,False,8,136,724,19,1,2024-11-26,False,False,False,0.8227272727272728,0.15454545454545454,0.02159090909090909,0.0011363636363636363,Peak,Tuesday,November
2024-11-26 09:00:00,49,467,11,2,529,95,238,5,1,339,26.8,89,3,10.5,868,False,9,144,705,16,3,2024-11-26,False,False,False,0.8122119815668203,0.16589861751152074,0.018433179723502304,0.0034562211981566822,Shoulder,Tuesday,November
2024-11-26 10:00:00,71,420,11,2,504,81,315,5,1,402,28.3,83,3,10.1,906,False,10,152,735,16,3,2024-11-26,False,False,False,0.8112582781456954,0.16777041942604856,0.017660044150110375,0.0033112582781456954,Shoulder,Tuesday,November
2024-11-26 11:00:00,55,478,10,2,545,74,326,5,2,407,29.4,78,51,11.4,952,False,11,129,804,15,4,2024-11-26,False,False,False,0.8445378151260504,0.13550420168067226,0.015756302521008403,0.004201680672268907,Peak,Tuesday,November
2024-11-26 12:00:00,66,337,11,2,416,67,303,7,1,378,30.4,74,51,9.1,794,False,12,133,640,18,3,2024-11-26,False,False,False,0.8060453400503779,0.16750629722921914,0.022670025188916875,0.003778337531486146,Peak,Tuesday,November
2024-11-26 13:00:00,63,346,8,1,418,114,243,5,1,363,30.9,71,51,4.2,781,False,13,177,589,13,2,2024-11-26,False,False,False,0.7541613316261203,0.2266325224071703,0.016645326504481434,0.002560819462227913,Peak,Tuesday,November
2024-11-26 14:00:00,55,434,9,1,499,86,203,7,1,297,29.1,77,63,11.3,796,False,14,141,637,16,2,2024-11-26,False,False,False,0.800251256281407,0.1771356783919598,0.020100502512562814,0.002512562814070352,Peak,Tuesday,November
2024-11-26 15:00:00,62,375,11,1,449,114,323,7,1,445,27.6,87,61,5.8,894,False,15,176,698,18,2,2024-11-26,False,False,False,0.7807606263982103,0.19686800894854586,0.020134228187919462,0.0022371364653243847,Peak,Tuesday,November
2024-11-26 16:00:00,51,414,11,1,477,71,310,6,2,389,28.0,79,53,9.3,866,False,16,122,724,17,3,2024-11-26,False,False,False,0.836027713625866,0.14087759815242495,0.019630484988452657,0.003464203233256351,Peak,Tuesday,November
2024-11-26 17:00:00,43,623,12,2,680,89,259,5,1,354,27.7,82,51,8.5,1034,False,17,132,882,17,3,2024-11-26,False,False,False,0.8529980657640233,0.1276595744680851,0.01644100580270793,0.0029013539651837525,Peak,Tuesday,November
2024-11-26 18:00:00,56,583,12,1,652,80,239,7,1,327,27.0,87,51,8.3,979,False,18,136,822,19,2,2024-11-26,False,False,False,0.839632277834525,0.13891726251276812,0.01940755873340143,0.0020429009193054137,Peak,Tuesday,November
2024-11-26 19:00:00,66,279,11,1,357,85,208,6,1,300,26.2,93,51,8.8,657,False,19,151,487,17,2,2024-11-26,False,False,False,0.741248097412481,0.2298325722983257,0.0258751902587519,0.0030441400304414,Peak,Tuesday,November
2024-11-26 20:00:00,48,387,12,2,449,105,298,11,1,415,25.5,95,61,5.3,864,False,20,153,685,23,3,2024-11-26,False,False,False,0.7928240740740741,0.17708333333333334,0.02662037037037037,0.003472222222222222,Shoulder,Tuesday,November
2024-11-26 21:00:00,52,413,8,1,474,125,305,8,1,439,25.9,94,51,10.5,913,False,21,177,718,16,2,2024-11-26,False,False,False,0.7864184008762322,0.19386637458926614,0.017524644030668127,0.002190580503833516,Shoulder,Tuesday,November
2024-11-26 22:00:00,48,430,11,1,490,69,290,11,0,370,25.6,95,51,9.9,860,False,22,117,720,22,1,2024-11-26,False,False,False,0.8372093023255814,0.13604651162790699,0.02558139534883721,0.0011627906976744186,Shoulder,Tuesday,November
2024-11-26 23:00:00,68,349,10,0,427,79,286,3,0,368,25.4,96,3,6.8,795,False,23,147,635,13,0,2024-11-26,False,False,False,0.7987421383647799,0.18490566037735848,0.016352201257861635,0.0,Shoulder,Tuesday,November
2024-11-27 00:00:00,34,334,2,0,370,74,204,3,0,281,25.2,98,3,2.9,651,False,0,108,538,5,0,2024-11-27,False,False,False,0.82642089093702,0.16589861751152074,0.007680491551459293,0.0,Off-Peak,Wednesday,November
2024-11-27 01:00:00,43,179,2,0,224,83,212,2,0,297,25.0,98,51,4.9,521,False,1,126,391,4,0,2024-11-27,False,False,False,0.7504798464491362,0.2418426103646833,0.007677543186180422,0.0,Off-Peak,Wednesday,November
2024-11-27 02:00:00,48,185,1,0,234,97,202,4,0,303,24.9,97,53,3.0,537,False,2,145,387,5,0,2024-11-27,False,False,False,0.7206703910614525,0.27001862197392923,0.00931098696461825,0.0,Off-Peak,Wednesday,November
2024-11-27 03:00:00,36,127,1,0,164,88,167,2,0,257,24.4,95,63,6.7,421,False,3,124,294,3,0,2024-11-27,False,False,False,0.6983372921615202,0.29453681710213775,0.007125890736342043,0.0,Off-Peak,Wednesday,November
2024-11-27 04:00:00,33,191,2,0,226,85,203,2,0,290,24.3,96,3,7.1,516,False,4,118,394,4,0,2024-11-27,False,False,False,0.7635658914728682,0.22868217054263565,0.007751937984496124,0.0,Off-Peak,Wednesday,November
2024-11-27 05:00:00,48,229,3,1,281,73,210,3,0,286,23.9,97,3,10.3,567,False,5,121,439,6,1,2024-11-27,False,False,False,0.7742504409171076,0.21340388007054673,0.010582010582010581,0.001763668430335097,Shoulder,Wednesday,November
2024-11-27 06:00:00,46,431,5,1,483,78,270,5,0,353,23.5,97,3,10.4,836,False,6,124,701,10,1,2024-11-27,False,False,False,0.8385167464114832,0.14832535885167464,0.011961722488038277,0.0011961722488038277,Shoulder,Wednesday,November
2024-11-27 07:00:00,85,658,6,1,750,86,525,6,0,617,23.1,98,63,11.7,1367,False,7,171,1183,12,1,2024-11-27,False,False,False,0.8653986832479883,0.1250914411119239,0.008778346744696415,0.000731528895391368,Peak,Wednesday,November
2024-11-27 08:00:00,51,527,7,1,586,90,517,7,0,614,23.4,98,53,12.0,1200,False,8,141,1044,14,1,2024-11-27,False,False,False,0.87,0.1175,0.011666666666666667,0.0008333333333333334,Peak,Wednesday,November
2024-11-27 09:00:00,40,467,5,1,513,95,234,5,1,335,24.7,95,55,11.4,848,False,9,135,701,10,2,2024-11-27,False,False,False,0.8266509433962265,0.15919811320754718,0.01179245283018868,0.0023584905660377358,Shoulder,Wednesday,November
2024-11-27 10:00:00,48,440,5,1,494,81,315,6,0,402,25.2,91,61,16.3,896,False,10,129,755,11,1,2024-11-27,False,False,False,0.8426339285714286,0.14397321428571427,0.012276785714285714,0.0011160714285714285,Shoulder,Wednesday,November
2024-11-27 11:00:00,36,478,5,1,520,74,326,5,1,406,25.2,93,63,11.2,926,False,11,110,804,10,2,2024-11-27,False,False,False,0.8682505399568035,0.11879049676025918,0.01079913606911447,0.0021598272138228943,Peak,Wednesday,November
2024-11-27 12:00:00,42,437,7,1,487,67,303,6,1,377,27.0,85,51,11.6,864,False,12,109,740,13,2,2024-11-27,False,False,False,0.8564814814814815,0.1261574074074074,0.015046296296296295,0.0023148148148148147,Peak,Wednesday,November
2024-11-27 13:00:00,44,446,4,1,495,114,243,4,1,362,28.1,80,3,11.0,857,False,13,158,689,8,2,2024-11-27,False,False,False,0.8039673278879813,0.18436406067677946,0.009334889148191364,0.002333722287047841,Peak,Wednesday,November
2024-11-27 14:00:00,56,434,4,1,495,86,203,5,1,295,29.0,76,51,10.2,790,False,14,142,637,9,2,2024-11-27,False,False,False,0.8063291139240506,0.17974683544303796,0.01139240506329114,0.002531645569620253,Peak,Wednesday,November
2024-11-27 15:00:00,51,435,7,1,494,104,323,5,1,433,28.9,74,3,10.0,927,False,15,155,758,12,2,2024-11-27,False,False,False,0.8176914778856527,0.16720604099244876,0.012944983818770227,0.002157497303128371,Peak,Wednesday,November
2024-11-27 16:00:00,52,433,6,1,492,71,310,6,1,388,29.3,73,3,7.9,880,False,16,123,743,12,2,2024-11-27,False,False,False,0.8443181818181819,0.13977272727272727,0.013636363636363636,0.0022727272727272726,Peak,Wednesday,November
2024-11-27 17:00:00,89,453,5,1,548,89,259,7,1,356,28.1,80,3,6.2,904,False,17,178,712,12,2,2024-11-27,False,False,False,0.7876106194690266,0.19690265486725664,0.01327433628318584,0.0022123893805309734,Peak,Wednesday,November
2024-11-27 18:00:00,45,383,7,1,436,80,239,5,1,325,26.6,90,51,11.5,761,False,18,125,622,12,2,2024-11-27,False,False,False,0.8173455978975033,0.164257555847569,0.01576872536136662,0.002628120893561104,Peak,Wednesday,November
2024-11-27 19:00:00,42,477,6,1,526,85,208,6,1,300,26.0,92,51,9.9,826,False,19,127,685,12,2,2024-11-27,False,False,False,0.8292978208232445,0.15375302663438256,0.014527845036319613,0.002421307506053269,Peak,Wednesday,November
2024-11-27 20:00:00,43,583,11,1,638,105,298,5,1,409,25.6,93,51,15.7,1047,False,20,148,881,16,2,2024-11-27,False,False,False,0.8414517669531996,0.1413562559694365,0.015281757402101241,0.0019102196752626551,Shoulder,Wednesday,November
2024-11-27 21:00:00,47,473,8,0,528,115,305,6,0,426,24.6,96,61,11.6,954,False,21,162,778,14,0,2024-11-27,False,False,False,0.8155136268343816,0.16981132075471697,0.014675052410901468,0.0,Shoulder,Wednesday,November
2024-11-27 22:00:00,48,450,11,0,509,69,290,7,0,366,24.3,97,53,13.0,875,False,22,117,740,18,0,2024-11-27,False,False,False,0.8457142857142858,0.1337142857142857,0.02057142857142857,0.0,Shoulder,Wednesday,November
2024-11-27 23:00:00,35,349,3,0,387,79,286,4,0,369,24.1,97,53,10.3,756,False,23,114,635,7,0,2024-11-27,False,False,False,0.83994708994709,0.15079365079365079,0.009259259259259259,0.0,Shoulder,Wednesday,November
2024-11-28 00:00:00,34,334,3,0,371,84,101,3,0,188,24.1,97,53,10.6,559,False,0,118,435,6,0,2024-11-28,False,False,False,0.778175313059034,0.2110912343470483,0.01073345259391771,0.0,Off-Peak,Thursday,November
2024-11-28 01:00:00,43,179,2,0,224,110,91,4,0,205,23.9,97,53,12.4,429,False,1,153,270,6,0,2024-11-28,False,False,False,0.6293706293706294,0.35664335664335667,0.013986013986013986,0.0,Off-Peak,Thursday,November
2024-11-28 02:00:00,48,165,1,0,214,100,83,5,0,188,23.7,98,51,11.8,402,False,2,148,248,6,0,2024-11-28,False,False,False,0.6169154228855721,0.3681592039800995,0.014925373134328358,0.0,Off-Peak,Thursday,November
2024-11-28 03:00:00,36,157,1,0,194,77,50,4,0,131,23.7,98,51,10.0,325,False,3,113,207,5,0,2024-11-28,False,False,False,0.6369230769230769,0.3476923076923077,0.015384615384615385,0.0,Off-Peak,Thursday,November
2024-11-28 04:00:00,33,135,2,0,170,75,30,8,0,113,23.8,97,51,10.6,283,False,4,108,165,10,0,2024-11-28,False,False,False,0.5830388692579506,0.38162544169611307,0.0353356890459364,0.0,Off-Peak,Thursday,November
2024-11-28 05:00:00,48,129,3,1,181,89,56,4,0,149,23.7,98,53,11.0,330,False,5,137,185,7,1,2024-11-28,False,False,False,0.5606060606060606,0.41515151515151516,0.021212121212121213,0.0030303030303030303,Shoulder,Thursday,November
2024-11-28 06:00:00,46,231,5,1,283,105,214,5,0,324,23.7,96,51,11.1,607,False,6,151,445,10,1,2024-11-28,False,False,False,0.7331136738056013,0.2487644151565074,0.016474464579901153,0.0016474464579901153,Shoulder,Thursday,November
2024-11-28 07:00:00,85,358,6,1,450,178,450,6,0,634,23.7,96,3,12.0,1084,False,7,263,808,12,1,2024-11-28,False,False,False,0.7453874538745388,0.24261992619926198,0.01107011070110701,0.0009225092250922509,Peak,Thursday,November
2024-11-28 08:00:00,71,407,7,1,486,187,484,7,0,678,24.0,96,3,11.1,1164,False,8,258,891,14,1,2024-11-28,False,False,False,0.7654639175257731,0.22164948453608246,0.012027491408934709,0.000859106529209622,Peak,Thursday,November
2024-11-28 09:00:00,40,463,7,1,511,97,402,5,1,505,25.6,93,3,10.3,1016,False,9,137,865,12,2,2024-11-28,False,False,False,0.8513779527559056,0.13484251968503938,0.011811023622047244,0.001968503937007874,Shoulder,Thursday,November
2024-11-28 10:00:00,48,420,9,1,478,93,476,6,1,576,26.2,87,51,14.5,1054,False,10,141,896,15,2,2024-11-28,False,False,False,0.8500948766603416,0.13377609108159394,0.014231499051233396,0.0018975332068311196,Shoulder,Thursday,November
2024-11-28 11:00:00,36,448,5,1,490,103,433,5,2,543,27.7,80,51,13.8,1033,False,11,139,881,10,3,2024-11-28,False,False,False,0.8528557599225557,0.1345595353339787,0.00968054211035818,0.002904162633107454,Peak,Thursday,November
2024-11-28 12:00:00,42,437,9,1,489,96,480,4,1,581,29.2,77,51,10.7,1070,False,12,138,917,13,2,2024-11-28,False,False,False,0.8570093457943925,0.12897196261682242,0.012149532710280374,0.001869158878504673,Peak,Thursday,November
2024-11-28 13:00:00,44,346,8,1,399,60,421,7,1,489,29.7,74,51,8.9,888,False,13,104,767,15,2,2024-11-28,False,False,False,0.8637387387387387,0.11711711711711711,0.016891891891891893,0.0022522522522522522,Peak,Thursday,November
2024-11-28 14:00:00,56,434,6,2,498,100,467,5,1,573,27.2,81,63,15.0,1071,False,14,156,901,11,3,2024-11-28,False,False,False,0.8412698412698413,0.14565826330532214,0.01027077497665733,0.0028011204481792717,Peak,Thursday,November
2024-11-28 15:00:00,51,340,7,1,399,68,0,5,1,74,26.8,84,53,12.3,473,False,15,119,340,12,2,2024-11-28,False,False,False,0.718816067653277,0.25158562367864695,0.02536997885835095,0.004228329809725159,Peak,Thursday,November
2024-11-28 16:00:00,52,413,9,1,475,77,442,6,2,527,27.0,83,53,13.0,1002,False,16,129,855,15,3,2024-11-28,False,False,False,0.8532934131736527,0.12874251497005987,0.014970059880239521,0.0029940119760479044,Peak,Thursday,November
2024-11-28 17:00:00,89,453,8,1,551,130,472,7,1,610,26.6,86,51,12.4,1161,False,17,219,925,15,2,2024-11-28,False,False,False,0.7967269595176572,0.18863049095607234,0.012919896640826873,0.0017226528854435831,Peak,Thursday,November
2024-11-28 18:00:00,65,383,7,1,456,154,451,6,1,612,26.0,89,51,10.0,1068,False,18,219,834,13,2,2024-11-28,False,False,False,0.7808988764044944,0.2050561797752809,0.012172284644194757,0.0018726591760299626,Peak,Thursday,November
2024-11-28 19:00:00,52,277,8,1,338,104,425,6,1,536,25.4,92,53,11.0,874,False,19,156,702,14,2,2024-11-28,False,False,False,0.8032036613272311,0.17848970251716248,0.016018306636155607,0.002288329519450801,Peak,Thursday,November
2024-11-28 20:00:00,43,387,11,1,442,132,455,7,1,595,24.6,97,61,6.6,1037,False,20,175,842,18,2,2024-11-28,False,False,False,0.8119575699132112,0.16875602700096431,0.017357762777242044,0.0019286403085824494,Shoulder,Thursday,November
2024-11-28 21:00:00,47,473,8,0,528,136,424,5,1,566,24.4,98,63,10.5,1094,False,21,183,897,13,1,2024-11-28,False,False,False,0.819926873857404,0.16727605118829983,0.011882998171846435,0.0009140767824497258,Shoulder,Thursday,November
2024-11-28 22:00:00,48,430,11,0,489,106,327,5,0,438,24.6,97,65,5.1,927,False,22,154,757,16,0,2024-11-28,False,False,False,0.8166127292340885,0.16612729234088458,0.017259978425026967,0.0,Shoulder,Thursday,November
2024-11-28 23:00:00,45,349,5,0,399,73,260,5,0,338,24.3,98,61,7.9,737,False,23,118,609,10,0,2024-11-28,False,False,False,0.8263229308005428,0.16010854816824965,0.013568521031207599,0.0,Shoulder,Thursday,November
2024-11-29 00:00:00,73,389,9,0,471,137,326,4,0,467,24.1,98,55,7.3,938,False,0,210,715,13,0,2024-11-29,False,False,False,0.7622601279317697,0.22388059701492538,0.013859275053304905,0.0,Off-Peak,Friday,November
2024-11-29 01:00:00,66,238,9,0,313,118,222,6,0,346,24.0,98,51,5.8,659,False,1,184,460,15,0,2024-11-29,False,False,False,0.6980273141122914,0.27921092564491656,0.02276176024279211,0.0,Off-Peak,Friday,November
2024-11-29 02:00:00,66,169,8,0,243,118,155,6,0,279,23.8,98,51,8.5,522,False,2,184,324,14,0,2024-11-29,False,False,False,0.6206896551724138,0.3524904214559387,0.02681992337164751,0.0,Off-Peak,Friday,November
2024-11-29 03:00:00,62,199,6,0,267,102,150,4,0,256,23.8,98,3,6.7,523,False,3,164,349,10,0,2024-11-29,False,False,False,0.6673040152963671,0.3135755258126195,0.019120458891013385,0.0,Off-Peak,Friday,November
2024-11-29 04:00:00,69,162,7,0,238,107,122,5,0,234,23.7,98,3,11.6,472,False,4,176,284,12,0,2024-11-29,False,False,False,0.6016949152542372,0.3728813559322034,0.025423728813559324,0.0,Off-Peak,Friday,November
2024-11-29 05:00:00,72,322,16,0,410,109,376,5,1,491,23.5,97,3,10.9,901,False,5,181,698,21,1,2024-11-29,False,False,False,0.7746947835738068,0.2008879023307436,0.023307436182019976,0.0011098779134295228,Shoulder,Friday,November
2024-11-29 06:00:00,74,655,15,0,744,118,540,6,1,665,23.4,97,3,11.8,1409,False,6,192,1195,21,1,2024-11-29,False,False,True,0.8481192334989354,0.13626685592618878,0.014904187366926898,0.0007097232079489,Shoulder,Friday,November
2024-11-29 07:00:00,98,607,15,0,720,224,633,5,1,863,23.4,97,3,10.4,1583,False,7,322,1240,20,1,2024-11-29,False,False,True,0.7833228048010107,0.20341124447252054,0.012634238787113077,0.0006317119393556538,Peak,Friday,November
2024-11-29 08:00:00,85,637,16,0,738,123,535,7,1,666,23.9,95,3,12.2,1404,False,8,208,1172,23,1,2024-11-29,False,False,True,0.8347578347578347,0.14814814814814814,0.01638176638176638,0.0007122507122507123,Peak,Friday,November
2024-11-29 09:00:00,65,561,18,1,645,164,531,8,2,705,24.5,96,53,5.1,1350,False,9,229,1092,26,3,2024-11-29,False,False,False,0.8088888888888889,0.16962962962962963,0.01925925925925926,0.0022222222222222222,Shoulder,Friday,November
2024-11-29 10:00:00,63,577,15,1,656,184,541,8,1,734,25.2,93,53,5.2,1390,False,10,247,1118,23,2,2024-11-29,False,False,True,0.8043165467625899,0.1776978417266187,0.016546762589928057,0.0014388489208633094,Shoulder,Friday,November
2024-11-29 11:00:00,90,435,17,2,544,182,551,6,1,740,25.4,93,61,3.5,1284,False,11,272,986,23,3,2024-11-29,False,False,False,0.7679127725856698,0.2118380062305296,0.01791277258566978,0.002336448598130841,Peak,Friday,November
2024-11-29 12:00:00,90,551,15,1,657,155,548,9,1,713,25.4,94,53,1.6,1370,False,12,245,1099,24,2,2024-11-29,False,False,False,0.8021897810218979,0.17883211678832117,0.017518248175182483,0.00145985401459854,Peak,Friday,November
2024-11-29 13:00:00,61,538,15,1,615,150,528,8,1,687,26.5,89,53,2.0,1302,False,13,211,1066,23,2,2024-11-29,False,False,False,0.8187403993855606,0.1620583717357911,0.017665130568356373,0.0015360983102918587,Peak,Friday,November
2024-11-29 14:00:00,78,517,16,1,612,119,512,9,2,642,26.4,88,53,1.5,1254,False,14,197,1029,25,3,2024-11-29,False,False,False,0.8205741626794258,0.15709728867623604,0.019936204146730464,0.0023923444976076554,Peak,Friday,November
2024-11-29 15:00:00,90,518,18,1,627,151,521,10,1,683,26.5,88,53,0.8,1310,False,15,241,1039,28,2,2024-11-29,False,False,False,0.7931297709923664,0.18396946564885497,0.021374045801526718,0.0015267175572519084,Peak,Friday,November
2024-11-29 16:00:00,91,556,16,2,665,133,531,7,1,672,26.5,88,51,4.2,1337,False,16,224,1087,23,3,2024-11-29,False,False,False,0.8130142109199701,0.16753926701570682,0.01720269259536275,0.002243829468960359,Peak,Friday,November
2024-11-29 17:00:00,94,665,14,1,774,124,533,6,2,665,26.5,86,51,3.7,1439,False,17,218,1198,20,3,2024-11-29,False,False,True,0.8325225851285615,0.15149409312022238,0.01389854065323141,0.0020847810979847115,Peak,Friday,November
2024-11-29 18:00:00,90,548,15,1,654,141,578,8,1,728,26.6,84,51,3.5,1382,False,18,231,1126,23,2,2024-11-29,False,False,True,0.8147612156295224,0.1671490593342981,0.016642547033285094,0.001447178002894356,Peak,Friday,November
2024-11-29 19:00:00,97,538,17,1,653,154,536,8,1,699,25.6,93,51,5.8,1352,False,19,251,1074,25,2,2024-11-29,False,False,False,0.7943786982248521,0.1856508875739645,0.01849112426035503,0.0014792899408284023,Peak,Friday,November
2024-11-29 20:00:00,85,567,12,1,665,140,520,9,2,671,25.0,96,51,7.1,1336,False,20,225,1087,21,3,2024-11-29,False,False,False,0.813622754491018,0.16841317365269462,0.015718562874251496,0.002245508982035928,Shoulder,Friday,November
2024-11-29 21:00:00,56,404,15,1,476,103,428,6,1,538,24.9,97,51,9.1,1014,False,21,159,832,21,2,2024-11-29,False,False,False,0.8205128205128205,0.15680473372781065,0.020710059171597635,0.0019723865877712033,Shoulder,Friday,November
2024-11-29 22:00:00,72,436,13,0,521,172,443,7,1,623,24.7,97,51,8.5,1144,False,22,244,879,20,1,2024-11-29,False,False,False,0.7683566433566433,0.21328671328671328,0.017482517482517484,0.0008741258741258741,Shoulder,Friday,November
2024-11-29 23:00:00,85,420,12,0,517,141,493,6,0,640,24.4,97,53,7.3,1157,False,23,226,913,18,0,2024-11-29,False,False,False,0.7891097666378565,0.19533275713050993,0.015557476231633534,0.0,Shoulder,Friday,November
2024-11-30 00:00:00,73,389,9,0,471,137,334,3,0,474,24.2,97,53,8.4,945,True,0,210,723,12,0,2024-11-30,False,False,False,0.765079365079365,0.2222222222222222,0.012698412698412698,0.0,Off-Peak,Saturday,November
2024-11-30 01:00:00,66,338,9,0,413,118,179,2,0,299,24.0,98,61,7.2,712,True,1,184,517,11,0,2024-11-30,False,False,False,0.726123595505618,0.25842696629213485,0.01544943820224719,0.0,Off-Peak,Saturday,November
2024-11-30 02:00:00,66,169,8,0,243,118,155,4,0,277,23.9,98,51,6.9,520,True,2,184,324,12,0,2024-11-30,False,False,False,0.6230769230769231,0.35384615384615387,0.023076923076923078,0.0,Off-Peak,Saturday,November
2024-11-30 03:00:00,52,199,6,0,257,102,127,2,0,231,23.8,99,53,8.6,488,True,3,154,326,8,0,2024-11-30,False,False,False,0.6680327868852459,0.3155737704918033,0.01639344262295082,0.0,Off-Peak,Saturday,November
2024-11-30 04:00:00,62,162,7,0,231,107,191,3,0,301,23.8,98,51,7.5,532,True,4,169,353,10,0,2024-11-30,False,False,False,0.6635338345864662,0.3176691729323308,0.018796992481203006,0.0,Off-Peak,Saturday,November
2024-11-30 05:00:00,72,222,13,1,308,109,129,2,1,241,23.6,98,3,7.4,549,True,5,181,351,15,2,2024-11-30,False,False,False,0.639344262295082,0.3296903460837887,0.0273224043715847,0.0036429872495446266,Shoulder,Saturday,November
2024-11-30 06:00:00,64,455,15,1,535,118,331,8,1,458,23.7,97,3,5.5,993,True,6,182,786,23,2,2024-11-30,False,False,False,0.7915407854984894,0.18328298086606243,0.023162134944612285,0.002014098690835851,Shoulder,Saturday,November
2024-11-30 07:00:00,98,607,12,1,718,224,658,6,1,889,23.4,97,3,2.7,1607,True,7,322,1265,18,2,2024-11-30,False,False,True,0.7871810827629122,0.2003733665214686,0.01120099564405725,0.0012445550715619166,Peak,Saturday,November
2024-11-30 08:00:00,89,637,16,1,743,223,507,9,1,740,24.5,95,3,6.0,1483,True,8,312,1144,25,2,2024-11-30,False,False,True,0.7714093054619016,0.21038435603506406,0.016857720836142953,0.0013486176668914363,Peak,Saturday,November
2024-11-30 09:00:00,96,561,13,2,672,164,467,9,2,642,26.0,91,3,7.0,1314,True,9,260,1028,22,4,2024-11-30,False,False,False,0.7823439878234398,0.197869101978691,0.0167427701674277,0.0030441400304414,Shoulder,Saturday,November
2024-11-30 10:00:00,83,577,15,2,677,154,420,6,1,581,27.2,85,3,6.9,1258,True,10,237,997,21,3,2024-11-30,False,False,False,0.7925278219395866,0.18839427662957076,0.016693163751987282,0.0023847376788553257,Shoulder,Saturday,November
2024-11-30 11:00:00,90,535,17,2,644,132,478,9,1,620,29.1,75,3,5.7,1264,True,11,222,1013,26,3,2024-11-30,False,False,False,0.8014240506329114,0.17563291139240506,0.020569620253164556,0.0023734177215189874,Peak,Saturday,November
2024-11-30 12:00:00,90,451,15,1,557,165,637,7,1,810,29.8,68,3,3.4,1367,True,12,255,1088,22,2,2024-11-30,False,False,False,0.7959034381858083,0.18653986832479882,0.016093635698610095,0.001463057790782736,Peak,Saturday,November
2024-11-30 13:00:00,91,538,15,1,645,156,536,8,1,701,30.1,65,3,5.5,1346,True,13,247,1074,23,2,2024-11-30,False,False,False,0.7979197622585439,0.18350668647845467,0.017087667161961365,0.0014858841010401188,Peak,Saturday,November
2024-11-30 14:00:00,78,567,16,1,662,119,434,6,2,561,30.2,64,3,10.0,1223,True,14,197,1001,22,3,2024-11-30,False,False,False,0.8184791496320524,0.16107931316434995,0.017988552739165987,0.0024529844644317253,Peak,Saturday,November
2024-11-30 15:00:00,90,519,18,2,629,152,435,8,1,596,29.9,65,3,9.0,1225,True,15,242,954,26,3,2024-11-30,False,False,False,0.7787755102040816,0.19755102040816327,0.02122448979591837,0.0024489795918367346,Peak,Saturday,November
2024-11-30 16:00:00,91,556,16,1,664,133,413,6,1,553,29.6,67,3,7.9,1217,True,16,224,969,22,2,2024-11-30,False,False,False,0.7962202136400987,0.18405916187345933,0.018077239112571898,0.0016433853738701725,Peak,Saturday,November
2024-11-30 17:00:00,95,665,14,2,776,124,603,8,2,737,29.1,71,3,7.6,1513,True,17,219,1268,22,4,2024-11-30,False,False,True,0.838070059484468,0.14474553866490417,0.014540647719762063,0.0026437541308658294,Peak,Saturday,November
2024-11-30 18:00:00,90,680,15,1,786,141,562,6,1,710,28.6,76,3,6.3,1496,True,18,231,1242,21,2,2024-11-30,False,False,True,0.8302139037433155,0.15441176470588236,0.014037433155080214,0.001336898395721925,Peak,Saturday,November
2024-11-30 19:00:00,94,538,12,1,645,154,574,9,1,738,27.4,85,3,7.5,1383,True,19,248,1112,21,2,2024-11-30,False,False,True,0.8040491684743312,0.17932031814895155,0.015184381778741865,0.0014461315979754157,Peak,Saturday,November
2024-11-30 20:00:00,85,565,12,2,664,140,487,7,1,635,26.9,90,3,3.5,1299,True,20,225,1052,19,3,2024-11-30,False,False,False,0.8098537336412626,0.17321016166281755,0.014626635873749037,0.0023094688221709007,Shoulder,Saturday,November
2024-11-30 21:00:00,56,404,15,1,476,103,513,9,1,626,26.4,92,63,8.1,1102,True,21,159,917,24,2,2024-11-30,False,False,False,0.8321234119782214,0.1442831215970962,0.021778584392014518,0.0018148820326678765,Shoulder,Saturday,November
2024-11-30 22:00:00,72,336,13,1,422,172,435,5,1,613,25.6,96,63,5.7,1035,True,22,244,771,18,2,2024-11-30,False,False,False,0.744927536231884,0.2357487922705314,0.017391304347826087,0.001932367149758454,Shoulder,Saturday,November
2024-11-30 23:00:00,85,420,13,0,518,141,349,7,0,497,25.6,98,51,6.5,1015,True,23,226,769,20,0,2024-11-30,False,False,False,0.7576354679802956,0.22266009852216748,0.019704433497536946,0.0,Shoulder,Saturday,November
2024-12-01 00:00:00,16,23,1,2,42,15,112,11,2,140,25.3,97,51,11.6,182,True,0,31,135,12,4,2024-12-01,False,False,False,0.7417582417582418,0.17032967032967034,0.06593406593406594,0.02197802197802198,Off-Peak,Sunday,December
2024-12-01 01:00:00,17,20,0,0,37,5,213,8,0,226,24.8,95,51,11.9,263,True,1,22,233,8,0,2024-12-01,False,False,False,0.8859315589353612,0.08365019011406843,0.030418250950570342,0.0,Off-Peak,Sunday,December
2024-12-01 02:00:00,18,9,3,0,30,11,327,7,1,346,24.7,95,51,11.1,376,True,2,29,336,10,1,2024-12-01,False,False,False,0.8936170212765957,0.07712765957446809,0.026595744680851064,0.0026595744680851063,Off-Peak,Sunday,December
2024-12-01 03:00:00,5,35,2,0,42,6,663,2,0,671,24.8,95,3,9.8,713,True,3,11,698,4,0,2024-12-01,False,False,False,0.9789621318373072,0.015427769985974754,0.005610098176718092,0.0,Off-Peak,Sunday,December
2024-12-01 04:00:00,3,66,2,0,71,19,394,5,1,419,24.7,96,3,6.8,490,True,4,22,460,7,1,2024-12-01,False,False,False,0.9387755102040817,0.044897959183673466,0.014285714285714285,0.0020408163265306124,Off-Peak,Sunday,December
2024-12-01 05:00:00,33,69,6,0,108,31,316,0,0,347,24.8,95,51,6.5,455,True,5,64,385,6,0,2024-12-01,False,False,False,0.8461538461538461,0.14065934065934066,0.013186813186813187,0.0,Shoulder,Sunday,December
2024-12-01 06:00:00,37,144,11,2,194,75,614,6,1,696,24.8,96,51,2.3,890,True,6,112,758,17,3,2024-12-01,False,False,False,0.851685393258427,0.1258426966292135,0.019101123595505618,0.0033707865168539327,Shoulder,Sunday,December
2024-12-01 07:00:00,58,395,10,1,464,47,638,9,2,696,24.5,98,51,5.9,1160,True,7,105,1033,19,3,2024-12-01,False,False,False,0.8905172413793103,0.09051724137931035,0.016379310344827588,0.002586206896551724,Peak,Sunday,December
2024-12-01 08:00:00,60,477,15,1,553,84,396,2,0,482,24.7,97,51,5.5,1035,True,8,144,873,17,1,2024-12-01,False,False,False,0.8434782608695652,0.1391304347826087,0.01642512077294686,0.000966183574879227,Peak,Sunday,December
2024-12-01 09:00:00,73,555,13,0,641,50,753,7,1,811,25.2,95,53,16.0,1452,True,9,123,1308,20,1,2024-12-01,False,False,True,0.9008264462809917,0.08471074380165289,0.013774104683195593,0.0006887052341597796,Shoulder,Sunday,December
2024-12-01 10:00:00,94,634,10,0,738,487,818,9,1,1315,25.7,91,51,10.1,2053,True,10,581,1452,19,1,2024-12-01,False,False,True,0.7072576716999512,0.2830004870920604,0.009254749147588894,0.0004870920603994155,Shoulder,Sunday,December
2024-12-01 11:00:00,109,659,9,0,777,328,815,0,1,1144,27.8,86,3,9.6,1921,True,11,437,1474,9,1,2024-12-01,False,False,True,0.76730869338886,0.22748568453930246,0.004685059864653826,0.0005205622071837585,Peak,Sunday,December
2024-12-01 12:00:00,206,779,27,0,1012,379,1043,9,1,1432,29.4,78,3,13.0,2444,True,12,585,1822,36,1,2024-12-01,False,False,True,0.7454991816693944,0.2393617021276596,0.014729950900163666,0.0004091653027823241,Peak,Sunday,December
2024-12-01 13:00:00,213,1171,28,1,1413,845,1159,3,0,2007,29.9,74,51,13.9,3420,True,13,1058,2330,31,1,2024-12-01,False,False,True,0.6812865497076024,0.30935672514619883,0.009064327485380117,0.00029239766081871346,Peak,Sunday,December
2024-12-01 14:00:00,155,1255,31,2,1443,765,1055,1,0,1821,29.7,74,51,14.2,3264,True,14,920,2310,32,2,2024-12-01,False,False,True,0.7077205882352942,0.2818627450980392,0.00980392156862745,0.0006127450980392157,Peak,Sunday,December
2024-12-01 15:00:00,178,972,21,3,1174,607,1394,0,6,2007,28.4,80,63,9.8,3181,True,15,785,2366,21,9,2024-12-01,False,False,True,0.7437912606098711,0.24677774284816095,0.006601697579377554,0.0028292989625903803,Peak,Sunday,December
2024-12-01 16:00:00,190,887,23,1,1101,648,900,2,0,1550,27.2,84,61,8.9,2651,True,16,838,1787,25,1,2024-12-01,False,False,True,0.6740852508487363,0.3161071293851377,0.00943040362127499,0.0003772161448509996,Peak,Sunday,December
2024-12-01 17:00:00,210,976,9,2,1197,451,945,16,0,1412,27.9,83,51,7.5,2609,True,17,661,1921,25,2,2024-12-01,False,False,True,0.7362974319662706,0.25335377539287085,0.009582215408202376,0.0007665772326561902,Peak,Sunday,December
2024-12-01 18:00:00,215,1042,28,3,1288,537,927,8,1,1473,28.0,83,51,5.7,2761,True,18,752,1969,36,4,2024-12-01,False,False,True,0.7131474103585658,0.2723650851140891,0.013038754074610649,0.0014487504527345165,Peak,Sunday,December
2024-12-01 19:00:00,102,966,12,2,1082,429,707,4,2,1142,26.3,92,55,5.9,2224,True,19,531,1673,16,4,2024-12-01,False,False,True,0.752248201438849,0.23875899280575538,0.007194244604316547,0.0017985611510791368,Peak,Sunday,December
2024-12-01 20:00:00,141,492,17,1,651,418,210,8,1,637,25.7,96,3,2.5,1288,True,20,559,702,25,2,2024-12-01,False,False,False,0.5450310559006211,0.4340062111801242,0.019409937888198756,0.0015527950310559005,Shoulder,Sunday,December
2024-12-01 21:00:00,73,572,6,2,653,483,130,8,0,621,25.8,92,3,8.1,1274,True,21,556,702,14,2,2024-12-01,False,False,False,0.5510204081632653,0.4364207221350079,0.01098901098901099,0.0015698587127158557,Shoulder,Sunday,December
2024-12-01 22:00:00,80,293,2,3,378,99,97,3,2,201,25.7,90,3,10.2,579,True,22,179,390,5,5,2024-12-01,False,False,False,0.6735751295336787,0.30915371329879104,0.008635578583765112,0.008635578583765112,Shoulder,Sunday,December
2024-12-01 23:00:00,16,203,0,1,220,2,94,9,1,106,25.4,91,3,10.2,326,True,23,18,297,9,2,2024-12-01,False,False,False,0.911042944785276,0.05521472392638037,0.027607361963190184,0.006134969325153374,Shoulder,Sunday,December
2024-12-02 00:00:00,7,68,5,0,80,30,76,1,1,108,25.1,93,3,9.9,188,False,0,37,144,6,1,2024-12-02,False,False,False,0.7659574468085106,0.19680851063829788,0.031914893617021274,0.005319148936170213,Off-Peak,Monday,December
2024-12-02 01:00:00,4,34,1,0,39,26,45,1,1,73,24.8,93,51,12.2,112,False,1,30,79,2,1,2024-12-02,False,False,False,0.7053571428571429,0.26785714285714285,0.017857142857142856,0.008928571428571428,Off-Peak,Monday,December
2024-12-02 02:00:00,6,47,7,0,60,12,20,2,0,34,24.6,94,3,11.4,94,False,2,18,67,9,0,2024-12-02,False,False,False,0.7127659574468085,0.19148936170212766,0.09574468085106383,0.0,Off-Peak,Monday,December
2024-12-02 03:00:00,11,91,7,0,109,6,38,5,0,49,24.2,96,3,11.2,158,False,3,17,129,12,0,2024-12-02,False,False,False,0.8164556962025317,0.10759493670886076,0.0759493670886076,0.0,Off-Peak,Monday,December
2024-12-02 04:00:00,15,122,0,0,137,37,41,1,0,79,24.1,96,3,11.1,216,False,4,52,163,1,0,2024-12-02,False,False,False,0.7546296296296297,0.24074074074074073,0.004629629629629629,0.0,Off-Peak,Monday,December
2024-12-02 05:00:00,21,224,5,1,251,48,94,3,1,146,23.9,96,3,8.9,397,False,5,69,318,8,2,2024-12-02,False,False,False,0.801007556675063,0.17380352644836272,0.020151133501259445,0.005037783375314861,Shoulder,Monday,December
2024-12-02 06:00:00,24,362,7,0,393,90,159,6,1,256,23.9,97,3,6.2,649,False,6,114,521,13,1,2024-12-02,False,False,False,0.802773497688752,0.17565485362095531,0.020030816640986132,0.0015408320493066256,Shoulder,Monday,December
2024-12-02 07:00:00,41,298,1,0,340,79,118,1,1,199,23.7,98,3,7.1,539,False,7,120,416,2,1,2024-12-02,False,False,False,0.7717996289424861,0.22263450834879406,0.0037105751391465678,0.0018552875695732839,Peak,Monday,December
2024-12-02 08:00:00,58,421,2,0,481,85,202,4,0,291,24.5,96,3,6.7,772,False,8,143,623,6,0,2024-12-02,False,False,False,0.8069948186528497,0.18523316062176165,0.007772020725388601,0.0,Peak,Monday,December
2024-12-02 09:00:00,81,399,4,0,484,93,227,5,0,325,26.3,91,3,7.8,809,False,9,174,626,9,0,2024-12-02,False,False,False,0.7737948084054388,0.21508034610630408,0.011124845488257108,0.0,Shoulder,Monday,December
2024-12-02 10:00:00,71,328,9,2,410,166,394,4,1,565,27.4,84,51,8.5,975,False,10,237,722,13,3,2024-12-02,False,False,False,0.7405128205128205,0.24307692307692308,0.013333333333333334,0.003076923076923077,Shoulder,Monday,December
2024-12-02 11:00:00,55,389,7,1,452,209,431,8,0,648,28.6,78,51,8.1,1100,False,11,264,820,15,1,2024-12-02,False,False,False,0.7454545454545455,0.24,0.013636363636363636,0.0009090909090909091,Peak,Monday,December
2024-12-02 12:00:00,91,498,9,1,599,361,859,6,1,1227,28.7,78,51,8.0,1826,False,12,452,1357,15,2,2024-12-02,False,False,True,0.7431544359255202,0.2475355969331873,0.008214676889375685,0.001095290251916758,Peak,Monday,December
2024-12-02 13:00:00,188,961,8,1,1158,268,804,11,1,1084,29.5,77,51,8.5,2242,False,13,456,1765,19,2,2024-12-02,False,False,True,0.7872435325602141,0.2033898305084746,0.00847457627118644,0.0008920606601248885,Peak,Monday,December
2024-12-02 14:00:00,126,913,9,0,1048,217,773,13,2,1005,29.3,77,51,4.7,2053,False,14,343,1686,22,2,2024-12-02,False,False,True,0.8212372138334145,0.16707257671699952,0.01071602532878714,0.000974184120798831,Peak,Monday,December
2024-12-02 15:00:00,117,745,13,0,875,237,744,15,0,996,28.8,80,61,4.8,1871,False,15,354,1489,28,0,2024-12-02,False,False,True,0.7958311063602351,0.18920363442009622,0.014965259219668627,0.0,Peak,Monday,December
2024-12-02 16:00:00,126,662,2,0,790,354,469,7,1,831,27.9,84,63,6.4,1621,False,16,480,1131,9,1,2024-12-02,False,False,True,0.6977174583590376,0.2961135101789019,0.005552128315854411,0.0006169031462060457,Peak,Monday,December
2024-12-02 17:00:00,111,765,4,0,880,160,874,9,1,1044,26.6,86,65,3.5,1924,False,17,271,1639,13,1,2024-12-02,False,False,True,0.8518711018711018,0.14085239085239085,0.006756756756756757,0.0005197505197505198,Peak,Monday,December
2024-12-02 18:00:00,85,637,5,1,728,139,855,5,1,1000,26.1,87,53,4.5,1728,False,18,224,1492,10,2,2024-12-02,False,False,True,0.8634259259259259,0.12962962962962962,0.005787037037037037,0.0011574074074074073,Peak,Monday,December
2024-12-02 19:00:00,82,346,15,3,446,137,759,12,2,910,24.8,96,63,4.6,1356,False,19,219,1105,27,5,2024-12-02,False,False,False,0.8148967551622419,0.16150442477876106,0.01991150442477876,0.003687315634218289,Peak,Monday,December
2024-12-02 20:00:00,59,295,16,1,371,101,428,8,1,538,24.9,96,53,2.6,909,False,20,160,723,24,2,2024-12-02,False,False,False,0.7953795379537953,0.17601760176017603,0.026402640264026403,0.0022002200220022,Shoulder,Monday,December
2024-12-02 21:00:00,66,277,1,0,344,113,349,11,3,476,25.5,94,51,10.6,820,False,21,179,626,12,3,2024-12-02,False,False,False,0.7634146341463415,0.21829268292682927,0.014634146341463415,0.003658536585365854,Shoulder,Monday,December
2024-12-02 22:00:00,55,255,8,2,320,70,245,3,2,320,25.0,95,3,11.1,640,False,22,125,500,11,4,2024-12-02,False,False,False,0.78125,0.1953125,0.0171875,0.00625,Shoulder,Monday,December
2024-12-02 23:00:00,18,228,12,3,261,155,44,1,4,204,24.9,94,3,10.0,465,False,23,173,272,13,7,2024-12-02,False,False,False,0.5849462365591398,0.3720430107526882,0.02795698924731183,0.015053763440860216,Shoulder,Monday,December
2024-12-03 00:00:00,7,19,5,2,33,7,7,6,0,20,24.6,94,3,8.2,53,False,0,14,26,11,2,2024-12-03,False,False,False,0.49056603773584906,0.2641509433962264,0.20754716981132076,0.03773584905660377,Off-Peak,Tuesday,December
2024-12-03 01:00:00,18,39,1,0,58,9,27,2,0,38,24.4,95,3,4.3,96,False,1,27,66,3,0,2024-12-03,False,False,False,0.6875,0.28125,0.03125,0.0,Off-Peak,Tuesday,December
2024-12-03 02:00:00,4,31,7,0,42,19,14,1,1,35,23.8,96,3,2.9,77,False,2,23,45,8,1,2024-12-03,False,False,False,0.5844155844155844,0.2987012987012987,0.1038961038961039,0.012987012987012988,Off-Peak,Tuesday,December
2024-12-03 03:00:00,28,28,7,0,63,22,75,0,1,98,23.8,96,3,5.6,161,False,3,50,103,7,1,2024-12-03,False,False,False,0.639751552795031,0.3105590062111801,0.043478260869565216,0.006211180124223602,Off-Peak,Tuesday,December
2024-12-03 04:00:00,24,32,0,0,56,39,66,5,1,111,23.6,97,3,4.0,167,False,4,63,98,5,1,2024-12-03,False,False,False,0.5868263473053892,0.3772455089820359,0.029940119760479042,0.005988023952095809,Off-Peak,Tuesday,December
2024-12-03 05:00:00,43,97,5,0,145,33,58,5,1,97,23.4,96,3,3.3,242,False,5,76,155,10,1,2024-12-03,False,False,False,0.640495867768595,0.3140495867768595,0.04132231404958678,0.004132231404958678,Shoulder,Tuesday,December
2024-12-03 06:00:00,33,98,7,2,140,69,92,2,0,163,23.6,95,3,4.4,303,False,6,102,190,9,2,2024-12-03,False,False,False,0.6270627062706271,0.33663366336633666,0.0297029702970297,0.006600660066006601,Shoulder,Tuesday,December
2024-12-03 07:00:00,52,176,1,1,230,71,45,4,0,120,23.6,95,3,6.5,350,False,7,123,221,5,1,2024-12-03,False,False,False,0.6314285714285715,0.3514285714285714,0.014285714285714285,0.002857142857142857,Peak,Tuesday,December
2024-12-03 08:00:00,40,252,2,1,295,83,51,3,0,137,24.7,91,3,8.6,432,False,8,123,303,5,1,2024-12-03,False,False,False,0.7013888888888888,0.2847222222222222,0.011574074074074073,0.0023148148148148147,Peak,Tuesday,December
2024-12-03 09:00:00,45,421,4,0,470,90,41,7,1,139,25.9,87,2,8.3,609,False,9,135,462,11,1,2024-12-03,False,False,False,0.7586206896551724,0.22167487684729065,0.0180623973727422,0.0016420361247947454,Shoulder,Tuesday,December
2024-12-03 10:00:00,32,439,9,0,480,115,102,3,0,220,27.7,83,3,9.2,700,False,10,147,541,12,0,2024-12-03,False,False,False,0.7728571428571429,0.21,0.017142857142857144,0.0,Shoulder,Tuesday,December
2024-12-03 11:00:00,73,640,7,3,723,129,102,3,2,236,28.7,80,51,7.5,959,False,11,202,742,10,5,2024-12-03,False,False,False,0.7737226277372263,0.21063607924921793,0.010427528675703858,0.005213764337851929,Peak,Tuesday,December
2024-12-03 12:00:00,100,759,9,0,868,159,229,7,1,396,29.3,77,51,8.7,1264,False,12,259,988,16,1,2024-12-03,False,False,False,0.7816455696202531,0.20490506329113925,0.012658227848101266,0.0007911392405063291,Peak,Tuesday,December
2024-12-03 13:00:00,147,1086,8,1,1242,135,215,10,0,360,28.0,78,63,10.0,1602,False,13,282,1301,18,1,2024-12-03,False,False,True,0.8121098626716604,0.1760299625468165,0.011235955056179775,0.0006242197253433209,Peak,Tuesday,December
2024-12-03 14:00:00,155,1060,9,0,1224,153,321,11,1,486,28.0,82,51,4.6,1710,False,14,308,1381,20,1,2024-12-03,False,False,True,0.8076023391812865,0.18011695906432748,0.011695906432748537,0.0005847953216374269,Peak,Tuesday,December
2024-12-03 15:00:00,169,682,13,0,864,248,306,7,0,561,27.6,83,51,5.5,1425,False,15,417,988,20,0,2024-12-03,False,False,True,0.6933333333333334,0.2926315789473684,0.014035087719298246,0.0,Peak,Tuesday,December
2024-12-03 16:00:00,132,954,2,1,1089,233,277,14,1,525,27.4,84,51,6.6,1614,False,16,365,1231,16,2,2024-12-03,False,False,True,0.7627013630731103,0.22614622057001238,0.009913258983890954,0.0012391573729863693,Peak,Tuesday,December
2024-12-03 17:00:00,113,688,4,2,807,204,249,7,1,461,27.4,85,51,5.0,1268,False,17,317,937,11,3,2024-12-03,False,False,False,0.7389589905362776,0.25,0.008675078864353312,0.002365930599369085,Peak,Tuesday,December
2024-12-03 18:00:00,114,617,5,0,736,123,204,9,0,336,27.2,85,3,5.0,1072,False,18,237,821,14,0,2024-12-03,False,False,False,0.7658582089552238,0.22108208955223882,0.013059701492537313,0.0,Peak,Tuesday,December
2024-12-03 19:00:00,71,491,15,2,579,254,169,11,0,434,26.4,92,3,4.8,1013,False,19,325,660,26,2,2024-12-03,False,False,False,0.6515301085883515,0.32082922013820336,0.02566633761105627,0.0019743336623889436,Peak,Tuesday,December
2024-12-03 20:00:00,88,353,16,1,458,289,135,11,2,437,26.1,93,51,4.1,895,False,20,377,488,27,3,2024-12-03,False,False,False,0.5452513966480447,0.4212290502793296,0.030167597765363128,0.0033519553072625698,Shoulder,Tuesday,December
2024-12-03 21:00:00,92,352,1,2,447,192,112,3,0,307,25.8,92,61,10.5,754,False,21,284,464,4,2,2024-12-03,False,False,False,0.6153846153846154,0.376657824933687,0.005305039787798408,0.002652519893899204,Shoulder,Tuesday,December
2024-12-03 22:00:00,66,366,8,3,443,193,106,2,3,304,25.6,96,53,2.7,747,False,22,259,472,10,6,2024-12-03,False,False,False,0.6318607764390897,0.3467202141900937,0.013386880856760375,0.008032128514056224,Shoulder,Tuesday,December
2024-12-03 23:00:00,14,168,12,1,195,57,116,1,7,181,25.4,95,53,3.1,376,False,23,71,284,13,8,2024-12-03,False,False,False,0.7553191489361702,0.18882978723404256,0.034574468085106384,0.02127659574468085,Shoulder,Tuesday,December
2024-12-04 00:00:00,7,75,5,2,89,31,126,1,0,158,25.4,95,51,5.4,247,False,0,38,201,6,2,2024-12-04,False,False,False,0.8137651821862348,0.15384615384615385,0.024291497975708502,0.008097165991902834,Off-Peak,Wednesday,December
2024-12-04 01:00:00,4,44,1,0,49,25,195,1,1,222,25.4,94,55,9.3,271,False,1,29,239,2,1,2024-12-04,False,False,False,0.8819188191881919,0.1070110701107011,0.007380073800738007,0.0036900369003690036,Off-Peak,Wednesday,December
2024-12-04 02:00:00,6,55,4,0,65,9,108,2,1,120,25.2,96,53,3.4,185,False,2,15,163,6,1,2024-12-04,False,False,False,0.8810810810810811,0.08108108108108109,0.032432432432432434,0.005405405405405406,Off-Peak,Wednesday,December
2024-12-04 03:00:00,11,98,0,1,110,23,96,5,0,124,25.1,97,3,3.4,234,False,3,34,194,5,1,2024-12-04,False,False,False,0.8290598290598291,0.1452991452991453,0.021367521367521368,0.004273504273504274,Off-Peak,Wednesday,December
2024-12-04 04:00:00,15,53,3,0,71,53,41,1,1,96,24.8,97,51,5.3,167,False,4,68,94,4,1,2024-12-04,False,False,False,0.562874251497006,0.40718562874251496,0.023952095808383235,0.005988023952095809,Off-Peak,Wednesday,December
2024-12-04 05:00:00,21,120,2,0,143,82,135,3,0,220,24.8,97,3,5.7,363,False,5,103,255,5,0,2024-12-04,False,False,False,0.7024793388429752,0.2837465564738292,0.013774104683195593,0.0,Shoulder,Wednesday,December
2024-12-04 06:00:00,24,170,0,0,194,198,111,6,1,316,24.5,97,3,7.7,510,False,6,222,281,6,1,2024-12-04,False,False,False,0.5509803921568628,0.43529411764705883,0.011764705882352941,0.00196078431372549,Shoulder,Wednesday,December
2024-12-04 07:00:00,41,196,2,1,240,114,200,3,1,318,24.5,96,3,8.0,558,False,7,155,396,5,2,2024-12-04,False,False,False,0.7096774193548387,0.2777777777777778,0.008960573476702509,0.0035842293906810036,Peak,Wednesday,December
2024-12-04 08:00:00,58,245,2,2,307,138,257,4,0,399,25.0,96,3,8.3,706,False,8,196,502,6,2,2024-12-04,False,False,False,0.7110481586402266,0.2776203966005666,0.0084985835694051,0.0028328611898017,Peak,Wednesday,December
2024-12-04 09:00:00,71,246,0,0,317,170,333,5,1,509,25.5,95,3,3.9,826,False,9,241,579,5,1,2024-12-04,False,False,False,0.7009685230024213,0.2917675544794189,0.006053268765133172,0.0012106537530266344,Shoulder,Wednesday,December
2024-12-04 10:00:00,61,397,1,1,460,212,479,4,1,696,26.7,91,3,5.8,1156,False,10,273,876,5,2,2024-12-04,False,False,False,0.7577854671280276,0.23615916955017302,0.004325259515570935,0.0017301038062283738,Shoulder,Wednesday,December
2024-12-04 11:00:00,55,466,3,0,524,293,636,8,0,937,28.7,77,51,7.1,1461,False,11,348,1102,11,0,2024-12-04,False,False,True,0.7542778918548939,0.23819301848049282,0.007529089664613279,0.0,Peak,Wednesday,December
2024-12-04 12:00:00,71,704,3,0,778,513,962,6,2,1483,29.3,72,3,10.3,2261,False,12,584,1666,9,2,2024-12-04,False,False,True,0.7368421052631579,0.25829279080053075,0.003980539584254755,0.0008845643520566122,Peak,Wednesday,December
2024-12-04 13:00:00,78,821,3,0,902,453,939,8,2,1402,29.4,72,3,11.1,2304,False,13,531,1760,11,2,2024-12-04,False,False,True,0.7638888888888888,0.23046875,0.004774305555555556,0.0008680555555555555,Peak,Wednesday,December
2024-12-04 14:00:00,96,969,1,0,1066,457,826,12,2,1297,29.7,71,3,14.2,2363,False,14,553,1795,13,2,2024-12-04,False,False,True,0.7596275920440119,0.23402454506982648,0.005501481168006771,0.0008463817181548879,Peak,Wednesday,December
2024-12-04 15:00:00,117,849,4,0,970,329,760,15,3,1107,29.2,71,53,16.0,2077,False,15,446,1609,19,3,2024-12-04,False,False,True,0.7746750120365913,0.21473278767453058,0.0091478093403948,0.0014443909484833895,Peak,Wednesday,December
2024-12-04 16:00:00,119,802,8,0,929,385,780,7,2,1174,28.9,76,53,15.1,2103,False,16,504,1582,15,2,2024-12-04,False,False,True,0.7522586780789349,0.2396576319543509,0.007132667617689016,0.0009510223490252021,Peak,Wednesday,December
2024-12-04 17:00:00,111,753,5,0,869,411,913,9,2,1335,28.1,77,51,13.3,2204,False,17,522,1666,14,2,2024-12-04,False,False,True,0.7558983666061706,0.23684210526315788,0.006352087114337568,0.0009074410163339383,Peak,Wednesday,December
2024-12-04 18:00:00,75,720,6,0,801,381,512,5,0,898,27.7,81,3,10.6,1699,False,18,456,1232,11,0,2024-12-04,False,False,True,0.7251324308416716,0.26839317245438493,0.006474396703943496,0.0,Peak,Wednesday,December
2024-12-04 19:00:00,72,330,6,2,410,231,482,12,1,726,26.9,85,3,9.9,1136,False,19,303,812,18,3,2024-12-04,False,False,False,0.7147887323943662,0.26672535211267606,0.01584507042253521,0.002640845070422535,Peak,Wednesday,December
2024-12-04 20:00:00,49,386,9,0,444,216,387,8,3,614,26.2,87,3,8.9,1058,False,20,265,773,17,3,2024-12-04,False,False,False,0.7306238185255198,0.2504725897920605,0.01606805293005671,0.002835538752362949,Shoulder,Wednesday,December
2024-12-04 21:00:00,56,64,6,0,126,100,503,11,2,616,26.3,85,3,8.6,742,False,21,156,567,17,2,2024-12-04,False,False,False,0.7641509433962265,0.21024258760107817,0.022911051212938006,0.0026954177897574125,Shoulder,Wednesday,December
2024-12-04 22:00:00,45,237,0,1,283,134,345,3,2,484,25.8,88,3,7.3,767,False,22,179,582,3,3,2024-12-04,False,False,False,0.758800521512386,0.2333767926988266,0.003911342894393742,0.003911342894393742,Shoulder,Wednesday,December
2024-12-04 23:00:00,18,180,9,0,207,138,434,1,6,579,25.5,89,3,8.0,786,False,23,156,614,10,6,2024-12-04,False,False,False,0.7811704834605598,0.1984732824427481,0.01272264631043257,0.007633587786259542,Shoulder,Wednesday,December
2024-12-05 00:00:00,7,44,5,0,56,18,18,11,1,48,25.4,89,3,7.1,104,False,0,25,62,16,1,2024-12-05,False,False,False,0.5961538461538461,0.2403846153846154,0.15384615384615385,0.009615384615384616,Off-Peak,Thursday,December
2024-12-05 01:00:00,4,87,1,0,92,16,74,8,1,99,25.3,89,51,6.6,191,False,1,20,161,9,1,2024-12-05,False,False,False,0.8429319371727748,0.10471204188481675,0.04712041884816754,0.005235602094240838,Off-Peak,Thursday,December
2024-12-05 02:00:00,6,105,7,0,118,30,97,7,0,134,25.2,89,3,8.3,252,False,2,36,202,14,0,2024-12-05,False,False,False,0.8015873015873016,0.14285714285714285,0.05555555555555555,0.0,Off-Peak,Thursday,December
2024-12-05 03:00:00,11,99,7,0,117,67,31,2,0,100,24.9,90,3,8.2,217,False,3,78,130,9,0,2024-12-05,False,False,False,0.5990783410138248,0.35944700460829493,0.041474654377880185,0.0,Off-Peak,Thursday,December
2024-12-05 04:00:00,15,169,0,0,184,71,156,5,0,232,24.8,90,3,5.9,416,False,4,86,325,5,0,2024-12-05,False,False,False,0.78125,0.20673076923076922,0.01201923076923077,0.0,Off-Peak,Thursday,December
2024-12-05 05:00:00,21,163,5,1,190,75,226,0,1,302,24.8,92,3,6.2,492,False,5,96,389,5,2,2024-12-05,False,False,False,0.790650406504065,0.1951219512195122,0.01016260162601626,0.0040650406504065045,Shoulder,Thursday,December
2024-12-05 06:00:00,24,93,7,0,124,93,340,6,1,440,24.5,97,3,8.1,564,False,6,117,433,13,1,2024-12-05,False,False,False,0.7677304964539007,0.2074468085106383,0.02304964539007092,0.0017730496453900709,Shoulder,Thursday,December
2024-12-05 07:00:00,41,109,1,0,151,85,433,9,1,528,24.2,98,3,7.8,679,False,7,126,542,10,1,2024-12-05,False,False,False,0.7982326951399117,0.18556701030927836,0.014727540500736377,0.0014727540500736377,Peak,Thursday,December
2024-12-05 08:00:00,58,438,2,0,498,182,557,2,0,741,24.7,96,3,8.3,1239,False,8,240,995,4,0,2024-12-05,False,False,False,0.8030669895076675,0.1937046004842615,0.003228410008071025,0.0,Peak,Thursday,December
2024-12-05 09:00:00,81,477,4,0,562,139,530,7,0,676,26.6,91,51,4.1,1238,False,9,220,1007,11,0,2024-12-05,False,False,False,0.8134087237479806,0.1777059773828756,0.008885298869143781,0.0,Shoulder,Thursday,December
2024-12-05 10:00:00,71,535,9,2,617,166,654,9,1,830,28.1,83,3,4.4,1447,False,10,237,1189,18,3,2024-12-05,False,False,True,0.8217000691085004,0.16378714581893572,0.01243953006219765,0.002073255010366275,Shoulder,Thursday,December
2024-12-05 11:00:00,55,729,7,1,792,215,656,0,0,871,28.6,76,3,8.2,1663,False,11,270,1385,7,1,2024-12-05,False,False,True,0.8328322309079976,0.1623571858087793,0.004209260372820205,0.0006013229104028864,Peak,Thursday,December
2024-12-05 12:00:00,97,693,9,1,800,441,889,9,1,1340,28.8,74,3,10.5,2140,False,12,538,1582,18,2,2024-12-05,False,False,True,0.7392523364485981,0.2514018691588785,0.008411214953271028,0.0009345794392523365,Peak,Thursday,December
2024-12-05 13:00:00,188,900,6,1,1095,683,995,3,0,1681,29.7,70,3,13.1,2776,False,13,871,1895,9,1,2024-12-05,False,False,True,0.6826368876080692,0.3137608069164265,0.0032420749279538905,0.00036023054755043225,Peak,Thursday,December
2024-12-05 14:00:00,126,637,3,0,766,657,1090,1,0,1748,29.9,70,2,13.2,2514,False,14,783,1727,4,0,2024-12-05,False,False,True,0.6869530628480509,0.31145584725536996,0.0015910898965791568,0.0,Peak,Thursday,December
2024-12-05 15:00:00,147,535,7,0,689,596,717,0,0,1313,30.4,67,3,13.9,2002,False,15,743,1252,7,0,2024-12-05,False,False,True,0.6253746253746254,0.3711288711288711,0.0034965034965034965,0.0,Peak,Thursday,December
2024-12-05 16:00:00,126,614,2,0,742,355,733,2,0,1090,30.3,66,3,14.8,1832,False,16,481,1347,4,0,2024-12-05,False,False,True,0.7352620087336245,0.2625545851528384,0.002183406113537118,0.0,Peak,Thursday,December
2024-12-05 17:00:00,111,607,4,0,722,357,635,16,0,1008,29.7,70,3,13.3,1730,False,17,468,1242,20,0,2024-12-05,False,False,True,0.7179190751445087,0.2705202312138728,0.011560693641618497,0.0,Peak,Thursday,December
2024-12-05 18:00:00,85,593,5,0,683,248,286,8,0,542,29.1,76,3,10.2,1225,False,18,333,879,13,0,2024-12-05,False,False,False,0.7175510204081633,0.27183673469387754,0.010612244897959184,0.0,Peak,Thursday,December
2024-12-05 19:00:00,82,354,15,0,451,121,304,4,2,431,28.1,81,2,7.9,882,False,19,203,658,19,2,2024-12-05,False,False,False,0.746031746031746,0.23015873015873015,0.021541950113378686,0.0022675736961451248,Peak,Thursday,December
2024-12-05 20:00:00,59,220,16,1,296,137,262,8,0,407,27.5,86,3,6.7,703,False,20,196,482,24,1,2024-12-05,False,False,False,0.6856330014224751,0.27880512091038406,0.034139402560455195,0.001422475106685633,Shoulder,Thursday,December
2024-12-05 21:00:00,66,325,1,0,392,92,234,8,3,337,27.5,80,3,7.7,729,False,21,158,559,9,3,2024-12-05,False,False,False,0.766803840877915,0.2167352537722908,0.012345679012345678,0.00411522633744856,Shoulder,Thursday,December
2024-12-05 22:00:00,55,348,8,2,413,42,252,3,1,298,26.9,84,3,8.6,711,False,22,97,600,11,3,2024-12-05,False,False,False,0.8438818565400844,0.13642756680731363,0.015471167369901548,0.004219409282700422,Shoulder,Thursday,December
2024-12-05 23:00:00,18,321,12,3,354,35,219,9,2,265,26.4,87,3,9.9,619,False,23,53,540,21,5,2024-12-05,False,False,False,0.8723747980613893,0.08562197092084006,0.033925686591276254,0.008077544426494346,Shoulder,Thursday,December
2024-12-06 00:00:00,16,18,1,2,37,15,18,11,0,44,26.1,86,51,11.3,81,False,0,31,36,12,2,2024-12-06,False,False,False,0.4444444444444444,0.38271604938271603,0.14814814814814814,0.024691358024691357,Off-Peak,Friday,December
2024-12-06 01:00:00,17,93,0,0,110,5,93,8,1,107,25.5,91,3,14.5,217,False,1,22,186,8,1,2024-12-06,False,False,False,0.8571428571428571,0.10138248847926268,0.03686635944700461,0.004608294930875576,Off-Peak,Friday,December
2024-12-06 02:00:00,18,139,3,0,160,11,139,7,1,158,25.2,93,3,14.1,318,False,2,29,278,10,1,2024-12-06,False,False,False,0.8742138364779874,0.09119496855345911,0.031446540880503145,0.0031446540880503146,Off-Peak,Friday,December
2024-12-06 03:00:00,5,134,2,1,142,6,134,2,0,142,25.0,93,3,13.7,284,False,3,11,268,4,1,2024-12-06,False,False,False,0.9436619718309859,0.03873239436619718,0.014084507042253521,0.0035211267605633804,Off-Peak,Friday,December
2024-12-06 04:00:00,3,156,2,0,161,19,156,5,1,181,24.9,93,2,12.6,342,False,4,22,312,7,1,2024-12-06,False,False,False,0.9122807017543859,0.06432748538011696,0.02046783625730994,0.0029239766081871343,Off-Peak,Friday,December
2024-12-06 05:00:00,33,262,6,1,302,31,262,0,0,293,24.6,94,3,11.9,595,False,5,64,524,6,1,2024-12-06,False,False,False,0.880672268907563,0.10756302521008404,0.010084033613445379,0.0016806722689075631,Shoulder,Friday,December
2024-12-06 06:00:00,37,293,11,0,341,175,293,6,1,475,24.6,94,3,11.7,816,False,6,212,586,17,1,2024-12-06,False,False,False,0.7181372549019608,0.25980392156862747,0.020833333333333332,0.0012254901960784314,Shoulder,Friday,December
2024-12-06 07:00:00,58,304,10,1,373,47,304,9,1,361,24.6,95,3,8.7,734,False,7,105,608,19,2,2024-12-06,False,False,False,0.8283378746594006,0.14305177111716622,0.025885558583106268,0.0027247956403269754,Peak,Friday,December
2024-12-06 08:00:00,60,478,15,2,555,84,478,2,5,569,25.1,95,3,7.6,1124,False,8,144,956,17,7,2024-12-06,False,False,False,0.8505338078291815,0.12811387900355872,0.015124555160142349,0.006227758007117438,Peak,Friday,December
2024-12-06 09:00:00,73,755,13,4,845,50,655,7,1,713,27.3,90,3,6.5,1558,False,9,123,1410,20,5,2024-12-06,False,False,True,0.9050064184852374,0.07894736842105263,0.012836970474967908,0.003209242618741977,Shoulder,Friday,December
2024-12-06 10:00:00,108,806,10,1,925,387,606,9,1,1003,29.0,80,3,6.5,1928,False,10,495,1412,19,2,2024-12-06,False,False,True,0.7323651452282157,0.2567427385892116,0.009854771784232365,0.001037344398340249,Shoulder,Friday,December
2024-12-06 11:00:00,109,1785,9,0,1903,228,485,0,4,717,30.5,68,3,5.0,2620,False,11,337,2270,9,4,2024-12-06,False,False,True,0.8664122137404581,0.12862595419847328,0.003435114503816794,0.0015267175572519084,Peak,Friday,December
2024-12-06 12:00:00,206,1249,27,0,1482,279,1049,9,2,1339,31.5,62,3,5.2,2821,False,12,485,2298,36,2,2024-12-06,False,False,True,0.8146047500886211,0.17192484934420418,0.012761432116270826,0.0007089684509039348,Peak,Friday,December
2024-12-06 13:00:00,213,1178,28,0,1419,745,1119,3,2,1869,32.0,60,3,8.1,3288,False,13,958,2297,31,2,2024-12-06,False,False,True,0.6986009732360098,0.2913625304136253,0.009428223844282239,0.0006082725060827251,Peak,Friday,December
2024-12-06 14:00:00,155,1281,32,2,1470,665,1280,1,2,1948,31.7,62,3,10.5,3418,False,14,820,2561,33,4,2024-12-06,False,False,True,0.7492685781158572,0.23990637799882972,0.00965476887068461,0.0011702750146284377,Peak,Friday,December
2024-12-06 15:00:00,178,1035,21,1,1235,607,1035,0,3,1645,31.4,65,51,11.2,2880,False,15,785,2070,21,4,2024-12-06,False,False,True,0.71875,0.2725694444444444,0.007291666666666667,0.001388888888888889,Peak,Friday,December
2024-12-06 16:00:00,190,1181,19,0,1390,642,1081,16,2,1741,31.1,67,1,11.9,3131,False,16,832,2262,35,2,2024-12-06,False,False,True,0.7224528904503353,0.26572979878633024,0.011178537208559566,0.0006387735547748323,Peak,Friday,December
2024-12-06 17:00:00,210,873,9,2,1094,452,973,2,2,1429,30.2,73,1,12.0,2523,False,17,662,1846,11,4,2024-12-06,False,False,True,0.7316686484344035,0.2623860483551328,0.004359889021006738,0.0015854141894569957,Peak,Friday,December
2024-12-06 18:00:00,215,802,28,0,1045,537,802,8,0,1347,29.7,73,1,7.8,2392,False,18,752,1604,36,0,2024-12-06,False,False,True,0.6705685618729097,0.31438127090301005,0.015050167224080268,0.0,Peak,Friday,December
2024-12-06 19:00:00,102,739,12,2,855,429,739,4,2,1174,28.6,82,1,5.6,2029,False,19,531,1478,16,4,2024-12-06,False,False,True,0.728437654016757,0.2617052735337605,0.007885657959586003,0.001971414489896501,Peak,Friday,December
2024-12-06 20:00:00,141,639,9,0,789,418,539,8,3,968,28.0,84,1,6.0,1757,False,20,559,1178,17,3,2024-12-06,False,False,True,0.6704610130904952,0.31815594763801935,0.009675583380762664,0.001707455890722823,Shoulder,Friday,December
2024-12-06 21:00:00,173,570,6,0,749,483,470,8,2,963,28.2,78,3,5.4,1712,False,21,656,1040,14,2,2024-12-06,False,False,True,0.6074766355140186,0.38317757009345793,0.008177570093457943,0.0011682242990654205,Shoulder,Friday,December
2024-12-06 22:00:00,80,331,2,1,414,99,331,3,2,435,27.3,82,3,5.8,849,False,22,179,662,5,3,2024-12-06,False,False,False,0.7797408716136631,0.21083627797408716,0.005889281507656066,0.0035335689045936395,Shoulder,Friday,December
2024-12-06 23:00:00,16,259,0,0,275,2,159,9,6,176,26.5,87,3,9.6,451,False,23,18,418,9,6,2024-12-06,False,False,False,0.926829268292683,0.03991130820399113,0.019955654101995565,0.013303769401330377,Shoulder,Friday,December
2024-12-07 00:00:00,16,18,1,2,37,31,58,6,0,95,26.1,93,3,9.5,132,True,0,47,76,7,2,2024-12-07,False,False,False,0.5757575757575758,0.3560606060606061,0.05303030303030303,0.015151515151515152,Off-Peak,Saturday,December
2024-12-07 01:00:00,17,93,0,0,110,25,71,2,1,99,25.7,95,3,10.3,209,True,1,42,164,2,1,2024-12-07,False,False,False,0.784688995215311,0.20095693779904306,0.009569377990430622,0.004784688995215311,Off-Peak,Saturday,December
2024-12-07 02:00:00,18,139,3,0,160,9,82,1,1,93,25.3,93,3,9.1,253,True,2,27,221,4,1,2024-12-07,False,False,False,0.8735177865612648,0.1067193675889328,0.015810276679841896,0.003952569169960474,Off-Peak,Saturday,December
2024-12-07 03:00:00,5,134,2,0,141,23,76,0,0,99,25.1,91,3,9.2,240,True,3,28,210,2,0,2024-12-07,False,False,False,0.875,0.11666666666666667,0.008333333333333333,0.0,Off-Peak,Saturday,December
2024-12-07 04:00:00,3,156,2,0,161,53,174,5,1,233,24.8,91,3,8.3,394,True,4,56,330,7,1,2024-12-07,False,False,False,0.8375634517766497,0.14213197969543148,0.017766497461928935,0.0025380710659898475,Off-Peak,Saturday,December
2024-12-07 05:00:00,33,262,6,0,301,82,135,5,0,222,24.5,92,3,6.1,523,True,5,115,397,11,0,2024-12-07,False,False,False,0.7590822179732314,0.2198852772466539,0.021032504780114723,0.0,Shoulder,Saturday,December
2024-12-07 06:00:00,37,293,11,2,343,198,182,2,1,383,24.6,92,3,5.9,726,True,6,235,475,13,3,2024-12-07,False,False,False,0.6542699724517906,0.3236914600550964,0.01790633608815427,0.004132231404958678,Shoulder,Saturday,December
2024-12-07 07:00:00,58,304,10,1,373,114,262,4,1,381,24.6,93,3,6.6,754,True,7,172,566,14,2,2024-12-07,False,False,False,0.7506631299734748,0.22811671087533156,0.01856763925729443,0.002652519893899204,Peak,Saturday,December
2024-12-07 08:00:00,60,478,15,1,554,138,266,3,5,412,25.0,92,3,6.8,966,True,8,198,744,18,6,2024-12-07,False,False,False,0.7701863354037267,0.20496894409937888,0.018633540372670808,0.006211180124223602,Peak,Saturday,December
2024-12-07 09:00:00,73,755,13,0,841,170,222,7,1,400,27.4,88,3,5.4,1241,True,9,243,977,20,1,2024-12-07,False,False,False,0.7872683319903304,0.19580983078162773,0.016116035455278,0.0008058017727639,Shoulder,Saturday,December
2024-12-07 10:00:00,108,806,10,0,924,212,479,3,1,695,28.7,80,3,4.5,1619,True,10,320,1285,13,1,2024-12-07,False,False,True,0.7936998147004324,0.19765287214329832,0.008029647930821495,0.0006176652254478073,Shoulder,Saturday,December
2024-12-07 11:00:00,109,785,9,0,903,273,356,3,4,636,29.7,73,3,4.9,1539,True,11,382,1141,12,4,2024-12-07,False,False,True,0.7413905133203379,0.24821312540610785,0.007797270955165692,0.002599090318388564,Peak,Saturday,December
2024-12-07 12:00:00,206,1049,27,0,1282,513,422,7,2,944,30.6,69,3,6.4,2226,True,12,719,1471,34,2,2024-12-07,False,False,True,0.660826594788859,0.3230008984725966,0.015274034141958671,0.0008984725965858042,Peak,Saturday,December
2024-12-07 13:00:00,213,1158,28,1,1400,453,495,10,2,960,31.2,64,3,8.1,2360,True,13,666,1653,38,3,2024-12-07,False,False,True,0.7004237288135593,0.28220338983050847,0.016101694915254237,0.001271186440677966,Peak,Saturday,December
2024-12-07 14:00:00,155,1282,32,2,1471,457,465,11,2,935,31.8,61,1,11.6,2406,True,14,612,1747,43,4,2024-12-07,False,False,True,0.7261014131338321,0.2543640897755611,0.017871986699916874,0.0016625103906899418,Peak,Saturday,December
2024-12-07 15:00:00,171,1035,21,3,1230,329,573,7,3,912,32.0,60,1,12.6,2142,True,15,500,1608,28,6,2024-12-07,False,False,True,0.7507002801120448,0.2334267040149393,0.013071895424836602,0.0028011204481792717,Peak,Saturday,December
2024-12-07 16:00:00,190,1181,19,1,1391,355,487,14,2,858,31.6,62,1,13.6,2249,True,16,545,1668,33,3,2024-12-07,False,False,True,0.7416629613161405,0.24232992441084927,0.014673188083592708,0.0013339261894175188,Peak,Saturday,December
2024-12-07 17:00:00,210,873,9,2,1094,414,558,7,2,981,30.7,68,1,14.3,2075,True,17,624,1431,16,4,2024-12-07,False,False,True,0.6896385542168675,0.3007228915662651,0.0077108433734939755,0.0019277108433734939,Peak,Saturday,December
2024-12-07 18:00:00,215,802,28,3,1048,381,424,9,0,814,29.6,73,3,14.7,1862,True,18,596,1226,37,3,2024-12-07,False,False,True,0.6584317937701396,0.3200859291084855,0.01987110633727175,0.001611170784103115,Peak,Saturday,December
2024-12-07 19:00:00,102,739,12,2,855,231,455,11,2,699,28.8,79,3,11.7,1554,True,19,333,1194,23,4,2024-12-07,False,False,True,0.7683397683397684,0.21428571428571427,0.014800514800514801,0.002574002574002574,Peak,Saturday,December
2024-12-07 20:00:00,141,639,9,1,790,216,448,11,3,678,28.5,82,3,12.8,1468,True,20,357,1087,20,4,2024-12-07,False,False,True,0.7404632152588556,0.24318801089918257,0.013623978201634877,0.0027247956403269754,Shoulder,Saturday,December
2024-12-07 21:00:00,165,570,6,2,743,100,258,3,2,363,28.7,73,2,8.5,1106,True,21,265,828,9,4,2024-12-07,False,False,False,0.7486437613019892,0.23960216998191683,0.0081374321880651,0.003616636528028933,Shoulder,Saturday,December
2024-12-07 22:00:00,80,331,2,3,416,124,260,2,2,388,28.0,75,0,8.4,804,True,22,204,591,4,5,2024-12-07,False,False,False,0.7350746268656716,0.2537313432835821,0.004975124378109453,0.006218905472636816,Shoulder,Saturday,December
2024-12-07 23:00:00,16,259,2,1,278,118,274,1,4,397,26.4,82,1,12.4,675,True,23,134,533,3,5,2024-12-07,False,False,False,0.7896296296296297,0.1985185185185185,0.0044444444444444444,0.007407407407407408,Shoulder,Saturday,December
2024-12-08 00:00:00,30,182,4,0,216,145,195,3,1,344,25.9,86,3,14.7,560,True,0,175,377,7,1,2024-12-08,False,False,False,0.6732142857142858,0.3125,0.0125,0.0017857142857142857,Off-Peak,Sunday,December
2024-12-08 01:00:00,34,217,4,0,255,146,189,4,1,340,25.7,88,3,16.4,595,True,1,180,406,8,1,2024-12-08,False,False,False,0.6823529411764706,0.3025210084033613,0.013445378151260505,0.0016806722689075631,Off-Peak,Sunday,December
2024-12-08 02:00:00,42,268,4,0,314,153,183,5,1,342,25.6,89,3,15.8,656,True,2,195,451,9,1,2024-12-08,False,False,False,0.6875,0.2972560975609756,0.013719512195121951,0.001524390243902439,Off-Peak,Sunday,December
2024-12-08 03:00:00,45,277,5,0,327,134,187,4,1,326,25.5,90,2,12.2,653,True,3,179,464,9,1,2024-12-08,False,False,False,0.7105666156202144,0.27411944869831545,0.013782542113323124,0.0015313935681470138,Off-Peak,Sunday,December
2024-12-08 04:00:00,54,331,6,0,391,129,230,4,1,364,25.2,91,0,11.3,755,True,4,183,561,10,1,2024-12-08,False,False,False,0.743046357615894,0.2423841059602649,0.013245033112582781,0.0013245033112582781,Off-Peak,Sunday,December
2024-12-08 05:00:00,57,349,6,1,413,163,281,4,2,450,24.9,92,0,13.2,863,True,5,220,630,10,3,2024-12-08,False,False,False,0.7300115874855156,0.2549246813441483,0.011587485515643106,0.0034762456546929316,Shoulder,Sunday,December
2024-12-08 06:00:00,59,370,6,1,436,238,404,5,1,648,24.7,92,0,12.6,1084,True,6,297,774,11,2,2024-12-08,False,False,False,0.7140221402214022,0.27398523985239853,0.01014760147601476,0.0018450184501845018,Shoulder,Sunday,December
2024-12-08 07:00:00,61,401,7,1,470,336,694,7,2,1039,24.5,92,0,11.9,1509,True,7,397,1095,14,3,2024-12-08,False,False,True,0.7256461232604374,0.26308813783962887,0.00927766732935719,0.0019880715705765406,Peak,Sunday,December
2024-12-08 08:00:00,68,425,8,1,502,369,606,6,2,983,25.1,91,2,10.9,1485,True,8,437,1031,14,3,2024-12-08,False,False,True,0.6942760942760943,0.2942760942760943,0.009427609427609427,0.00202020202020202,Peak,Sunday,December
2024-12-08 09:00:00,78,511,8,1,598,403,650,6,2,1061,27.8,84,1,9.1,1659,True,9,481,1161,14,3,2024-12-08,False,False,True,0.6998191681735986,0.2899336949969861,0.008438818565400843,0.0018083182640144665,Shoulder,Sunday,December
2024-12-08 10:00:00,82,528,9,1,620,235,399,5,1,640,29.8,73,2,8.6,1260,True,10,317,927,14,2,2024-12-08,False,False,False,0.7357142857142858,0.2515873015873016,0.011111111111111112,0.0015873015873015873,Shoulder,Sunday,December
2024-12-08 11:00:00,84,564,9,1,658,353,576,7,2,938,30.9,67,51,9.0,1596,True,11,437,1140,16,3,2024-12-08,False,False,True,0.7142857142857143,0.27380952380952384,0.010025062656641603,0.0018796992481203006,Peak,Sunday,December
2024-12-08 12:00:00,89,564,9,1,663,384,715,5,2,1106,31.2,67,51,10.2,1769,True,12,473,1279,14,3,2024-12-08,False,False,True,0.723007348784624,0.26738270209157716,0.00791407574901074,0.0016958733747880158,Peak,Sunday,December
2024-12-08 13:00:00,90,579,10,1,680,351,684,7,2,1044,31.9,65,3,11.1,1724,True,13,441,1263,17,3,2024-12-08,False,False,True,0.7325986078886311,0.255800464037123,0.009860788863109048,0.0017401392111368909,Peak,Sunday,December
2024-12-08 14:00:00,94,592,12,1,699,315,696,7,2,1020,31.8,65,3,10.6,1719,True,14,409,1288,19,3,2024-12-08,False,False,True,0.7492728330424665,0.23792902850494474,0.011052937754508435,0.0017452006980802793,Peak,Sunday,December
2024-12-08 15:00:00,94,607,12,1,714,212,391,6,1,610,30.6,69,3,4.6,1324,True,15,306,998,18,2,2024-12-08,False,False,False,0.7537764350453172,0.2311178247734139,0.013595166163141994,0.0015105740181268882,Peak,Sunday,December
2024-12-08 16:00:00,106,684,13,1,804,242,381,4,2,629,27.3,80,63,7.0,1433,True,16,348,1065,17,3,2024-12-08,False,False,True,0.7431960921144453,0.24284717376133985,0.011863224005582694,0.00209351011863224,Peak,Sunday,December
2024-12-08 17:00:00,110,716,14,1,841,395,607,7,2,1011,26.5,85,61,8.6,1852,True,17,505,1323,21,3,2024-12-08,False,False,True,0.7143628509719222,0.2726781857451404,0.011339092872570195,0.0016198704103671706,Peak,Sunday,December
2024-12-08 18:00:00,112,725,14,1,852,355,584,6,2,947,26.8,85,51,7.4,1799,True,18,467,1309,20,3,2024-12-08,False,False,True,0.7276264591439688,0.2595886603668705,0.011117287381878822,0.0016675931072818232,Peak,Sunday,December
2024-12-08 19:00:00,125,816,14,1,956,320,547,6,3,876,26.5,89,51,7.8,1832,True,19,445,1363,20,4,2024-12-08,False,False,True,0.743995633187773,0.24290393013100436,0.010917030567685589,0.002183406113537118,Peak,Sunday,December
2024-12-08 20:00:00,131,843,15,1,990,393,604,7,2,1006,26.2,90,3,8.5,1996,True,20,524,1447,22,3,2024-12-08,False,False,True,0.7249498997995992,0.2625250501002004,0.011022044088176353,0.001503006012024048,Shoulder,Sunday,December
2024-12-08 21:00:00,133,879,16,1,1029,236,366,5,1,608,25.4,96,65,8.4,1637,True,21,369,1245,21,2,2024-12-08,False,False,True,0.7605375687232743,0.22541233964569335,0.012828344532681736,0.0012217470983506415,Shoulder,Sunday,December
2024-12-08 22:00:00,135,893,16,1,1045,219,412,5,1,637,25.4,97,65,5.2,1682,True,22,354,1305,21,2,2024-12-08,False,False,True,0.7758620689655172,0.21046373365041618,0.01248513674197384,0.0011890606420927466,Shoulder,Sunday,December
2024-12-08 23:00:00,143,947,17,2,1109,217,422,5,2,646,24.9,99,61,8.7,1755,True,23,360,1369,22,4,2024-12-08,False,False,True,0.7800569800569801,0.20512820512820512,0.012535612535612535,0.002279202279202279,Shoulder,Sunday,December
2024-12-09 00:00:00,18,119,5,0,142,60,76,8,1,145,24.8,98,61,3.2,287,False,0,78,195,13,1,2024-12-09,False,False,False,0.6794425087108014,0.27177700348432055,0.04529616724738676,0.003484320557491289,Off-Peak,Monday,December
2024-12-09 01:00:00,23,151,4,0,178,69,89,4,1,163,24.4,97,55,8.0,341,False,1,92,240,8,1,2024-12-09,False,False,False,0.7038123167155426,0.2697947214076246,0.02346041055718475,0.002932551319648094,Off-Peak,Monday,December
2024-12-09 02:00:00,26,171,4,0,201,81,107,3,2,193,24.3,94,61,9.7,394,False,2,107,278,7,2,2024-12-09,False,False,False,0.7055837563451777,0.2715736040609137,0.017766497461928935,0.005076142131979695,Off-Peak,Monday,December
2024-12-09 03:00:00,28,181,2,0,211,91,118,5,1,215,24.5,94,3,12.3,426,False,3,119,299,7,1,2024-12-09,False,False,False,0.7018779342723005,0.2793427230046948,0.01643192488262911,0.002347417840375587,Off-Peak,Monday,December
2024-12-09 04:00:00,36,225,5,0,266,108,141,8,1,258,24.1,95,3,12.5,524,False,4,144,366,13,1,2024-12-09,False,False,False,0.6984732824427481,0.2748091603053435,0.02480916030534351,0.0019083969465648854,Off-Peak,Monday,December
2024-12-09 05:00:00,40,263,2,0,305,112,153,3,1,269,24.0,94,3,14.0,574,False,5,152,416,5,1,2024-12-09,False,False,False,0.7247386759581882,0.26480836236933797,0.008710801393728223,0.0017421602787456446,Shoulder,Monday,December
2024-12-09 06:00:00,41,274,5,0,320,121,160,5,1,287,24.0,94,3,10.4,607,False,6,162,434,10,1,2024-12-09,False,False,False,0.71499176276771,0.26688632619439867,0.016474464579901153,0.0016474464579901153,Shoulder,Monday,December
2024-12-09 07:00:00,44,287,9,0,340,129,176,4,2,311,24.3,91,51,8.7,651,False,7,173,463,13,2,2024-12-09,False,False,False,0.7112135176651305,0.26574500768049153,0.019969278033794162,0.0030721966205837174,Peak,Monday,December
2024-12-09 08:00:00,45,288,2,0,335,134,178,3,1,316,24.5,92,51,7.0,651,False,8,179,466,5,1,2024-12-09,False,False,False,0.7158218125960062,0.2749615975422427,0.007680491551459293,0.0015360983102918587,Peak,Monday,December
2024-12-09 09:00:00,47,305,9,0,361,139,186,4,1,330,24.6,95,61,10.6,691,False,9,186,491,13,1,2024-12-09,False,False,False,0.7105643994211288,0.2691751085383502,0.01881331403762663,0.001447178002894356,Shoulder,Monday,December
2024-12-09 10:00:00,50,310,4,0,364,141,191,5,2,339,25.1,96,61,10.1,703,False,10,191,501,9,2,2024-12-09,False,False,False,0.7126600284495022,0.2716927453769559,0.012802275960170697,0.002844950213371266,Shoulder,Monday,December
2024-12-09 11:00:00,51,329,3,1,384,145,195,4,1,345,25.2,96,61,10.7,729,False,11,196,524,7,2,2024-12-09,False,False,False,0.7187928669410151,0.26886145404663925,0.009602194787379973,0.0027434842249657062,Peak,Monday,December
2024-12-09 12:00:00,53,329,4,1,387,159,215,4,1,379,25.3,96,61,11.5,766,False,12,212,544,8,2,2024-12-09,False,False,False,0.7101827676240209,0.27676240208877284,0.010443864229765013,0.0026109660574412533,Peak,Monday,December
2024-12-09 13:00:00,54,349,4,2,409,163,220,8,1,392,25.3,96,61,11.0,801,False,13,217,569,12,3,2024-12-09,False,False,False,0.7103620474406991,0.27091136079900124,0.0149812734082397,0.003745318352059925,Peak,Monday,December
2024-12-09 14:00:00,55,351,9,1,416,165,222,2,1,390,25.1,96,61,10.3,806,False,14,220,573,11,2,2024-12-09,False,False,False,0.7109181141439206,0.2729528535980149,0.013647642679900745,0.0024813895781637717,Peak,Monday,December
2024-12-09 15:00:00,55,357,4,1,417,173,235,5,1,414,26.5,90,53,12.6,831,False,15,228,592,9,2,2024-12-09,False,False,False,0.7123947051744886,0.2743682310469314,0.010830324909747292,0.0024067388688327317,Peak,Monday,December
2024-12-09 16:00:00,55,359,6,1,421,200,273,4,1,478,27.2,84,3,14.7,899,False,16,255,632,10,2,2024-12-09,False,False,False,0.7030033370411568,0.2836484983314794,0.011123470522803115,0.002224694104560623,Peak,Monday,December
2024-12-09 17:00:00,66,427,8,1,502,224,304,2,1,531,27.9,81,3,15.1,1033,False,17,290,731,10,2,2024-12-09,False,False,False,0.707647628267183,0.2807357212003872,0.00968054211035818,0.001936108422071636,Peak,Monday,December
2024-12-09 18:00:00,68,429,7,1,505,235,317,10,2,564,27.2,83,3,14.3,1069,False,18,303,746,17,3,2024-12-09,False,False,False,0.6978484565014031,0.28344246959775493,0.015902712815715623,0.002806361085126286,Peak,Monday,December
2024-12-09 19:00:00,73,445,6,1,525,260,357,5,1,623,26.2,88,3,12.7,1148,False,19,333,802,11,2,2024-12-09,False,False,False,0.6986062717770035,0.29006968641114983,0.009581881533101045,0.0017421602787456446,Peak,Monday,December
2024-12-09 20:00:00,75,479,10,1,565,262,358,8,3,631,25.8,90,3,12.0,1196,False,20,337,837,18,4,2024-12-09,False,False,False,0.6998327759197325,0.2817725752508361,0.015050167224080268,0.0033444816053511705,Shoulder,Monday,December
2024-12-09 21:00:00,80,534,6,1,621,280,385,10,3,678,25.2,96,51,9.9,1299,False,21,360,919,16,4,2024-12-09,False,False,False,0.7074672825250192,0.27713625866050806,0.012317167051578136,0.003079291762894534,Shoulder,Monday,December
2024-12-09 22:00:00,82,548,6,1,637,305,416,12,2,735,25.1,97,51,4.8,1372,False,22,387,964,18,3,2024-12-09,False,False,False,0.7026239067055393,0.2820699708454811,0.013119533527696793,0.002186588921282799,Shoulder,Monday,December
2024-12-09 23:00:00,90,599,11,1,701,308,423,2,1,734,25.1,98,51,7.4,1435,False,23,398,1022,13,2,2024-12-09,False,False,True,0.7121951219512195,0.27735191637630663,0.009059233449477353,0.0013937282229965157,Shoulder,Monday,December
2024-12-10 00:00:00,2,21,1,0,24,90,175,6,2,273,25.0,97,51,12.3,297,False,0,92,196,7,2,2024-12-10,False,False,False,0.6599326599326599,0.30976430976430974,0.02356902356902357,0.006734006734006734,Off-Peak,Tuesday,December
2024-12-10 01:00:00,3,28,6,0,37,104,205,4,1,314,24.4,97,51,8.6,351,False,1,107,233,10,1,2024-12-10,False,False,False,0.6638176638176638,0.30484330484330485,0.02849002849002849,0.002849002849002849,Off-Peak,Tuesday,December
2024-12-10 02:00:00,5,29,6,0,40,139,275,4,1,419,24.3,98,53,6.4,459,False,2,144,304,10,1,2024-12-10,False,False,False,0.6623093681917211,0.3137254901960784,0.02178649237472767,0.002178649237472767,Off-Peak,Tuesday,December
2024-12-10 03:00:00,9,72,5,0,86,177,354,7,2,540,24.2,98,55,6.2,626,False,3,186,426,12,2,2024-12-10,False,False,False,0.6805111821086262,0.2971246006389776,0.019169329073482427,0.003194888178913738,Off-Peak,Tuesday,December
2024-12-10 04:00:00,16,112,6,0,134,178,362,5,1,546,23.9,97,61,13.9,680,False,4,194,474,11,1,2024-12-10,False,False,False,0.6970588235294117,0.2852941176470588,0.016176470588235296,0.0014705882352941176,Off-Peak,Tuesday,December
2024-12-10 05:00:00,16,115,4,0,135,185,379,4,1,569,23.6,96,63,6.4,704,False,5,201,494,8,1,2024-12-10,False,False,False,0.7017045454545454,0.28551136363636365,0.011363636363636364,0.0014204545454545455,Shoulder,Tuesday,December
2024-12-10 06:00:00,18,136,8,0,162,188,372,4,1,565,23.9,94,61,11.6,727,False,6,206,508,12,1,2024-12-10,False,False,False,0.6987620357634112,0.2833562585969739,0.016506189821182942,0.001375515818431912,Shoulder,Tuesday,December
2024-12-10 07:00:00,32,234,6,0,272,198,396,6,1,601,23.7,96,63,4.0,873,False,7,230,630,12,1,2024-12-10,False,False,False,0.7216494845360825,0.2634593356242841,0.013745704467353952,0.001145475372279496,Peak,Tuesday,December
2024-12-10 08:00:00,34,261,3,0,298,198,400,6,2,606,23.8,96,53,7.3,904,False,8,232,661,9,2,2024-12-10,False,False,False,0.7311946902654868,0.25663716814159293,0.00995575221238938,0.0022123893805309734,Peak,Tuesday,December
2024-12-10 09:00:00,35,246,2,0,283,209,423,2,1,635,24.7,95,63,7.7,918,False,9,244,669,4,1,2024-12-10,False,False,False,0.7287581699346405,0.2657952069716776,0.004357298474945534,0.0010893246187363835,Shoulder,Tuesday,December
2024-12-10 10:00:00,41,306,7,0,354,211,432,9,3,655,24.5,97,63,7.7,1009,False,10,252,738,16,3,2024-12-10,False,False,False,0.7314172447968286,0.24975222993062438,0.015857284440039643,0.002973240832507433,Shoulder,Tuesday,December
2024-12-10 11:00:00,47,346,3,1,397,233,471,4,1,709,25.3,93,61,6.5,1106,False,11,280,817,7,2,2024-12-10,False,False,False,0.7386980108499096,0.25316455696202533,0.006329113924050633,0.0018083182640144665,Peak,Tuesday,December
2024-12-10 12:00:00,48,348,7,2,405,241,484,3,1,729,26.7,89,53,4.0,1134,False,12,289,832,10,3,2024-12-10,False,False,False,0.7336860670194003,0.25485008818342153,0.008818342151675485,0.0026455026455026454,Peak,Tuesday,December
2024-12-10 13:00:00,56,414,2,1,473,260,531,7,2,800,27.3,85,51,4.6,1273,False,13,316,945,9,3,2024-12-10,False,False,False,0.7423409269442263,0.24823252160251374,0.007069913589945012,0.002356637863315004,Peak,Tuesday,December
2024-12-10 14:00:00,58,408,8,1,475,274,560,4,1,839,27.8,84,51,5.9,1314,False,14,332,968,12,2,2024-12-10,False,False,False,0.7366818873668188,0.2526636225266362,0.0091324200913242,0.0015220700152207,Peak,Tuesday,December
2024-12-10 15:00:00,65,477,8,1,551,282,576,8,2,868,28.1,81,51,8.2,1419,False,15,347,1053,16,3,2024-12-10,False,False,True,0.7420718816067653,0.244538407329105,0.01127554615926709,0.0021141649048625794,Peak,Tuesday,December
2024-12-10 16:00:00,70,514,3,1,588,286,590,5,2,883,27.9,76,51,10.5,1471,False,16,356,1104,8,3,2024-12-10,False,False,True,0.7505098572399728,0.24201223657375934,0.005438477226376614,0.0020394289598912306,Peak,Tuesday,December
2024-12-10 17:00:00,70,503,4,1,578,286,580,7,2,875,27.4,80,3,9.6,1453,False,17,356,1083,11,3,2024-12-10,False,False,True,0.7453544390915348,0.24501032346868548,0.007570543702684102,0.0020646937370956643,Peak,Tuesday,December
2024-12-10 18:00:00,75,536,4,1,616,296,598,7,2,903,27.1,83,3,8.8,1519,False,18,371,1134,11,3,2024-12-10,False,False,True,0.7465437788018433,0.24423963133640553,0.007241606319947334,0.0019749835418038184,Peak,Tuesday,December
2024-12-10 19:00:00,81,595,3,1,680,314,643,2,1,960,26.5,86,3,11.6,1640,False,19,395,1238,5,2,2024-12-10,False,False,True,0.7548780487804878,0.24085365853658536,0.003048780487804878,0.0012195121951219512,Peak,Tuesday,December
2024-12-10 20:00:00,83,605,6,1,695,322,653,8,4,987,25.8,84,3,14.5,1682,False,20,405,1258,14,5,2024-12-10,False,False,True,0.7479191438763377,0.2407847800237812,0.008323424494649227,0.002972651605231867,Shoulder,Tuesday,December
2024-12-10 21:00:00,87,627,12,1,727,330,678,6,2,1016,25.7,83,51,8.0,1743,False,21,417,1305,18,3,2024-12-10,False,False,True,0.7487091222030982,0.23924268502581755,0.010327022375215147,0.0017211703958691911,Shoulder,Tuesday,December
2024-12-10 22:00:00,100,726,5,1,832,340,690,9,4,1043,25.4,83,3,12.0,1875,False,22,440,1416,14,5,2024-12-10,False,False,True,0.7552,0.23466666666666666,0.007466666666666667,0.0026666666666666666,Shoulder,Tuesday,December
2024-12-10 23:00:00,103,747,14,1,865,251,513,4,2,770,25.2,83,3,10.3,1635,False,23,354,1260,18,3,2024-12-10,False,False,True,0.7706422018348624,0.21651376146788992,0.011009174311926606,0.001834862385321101,Shoulder,Tuesday,December
2024-12-11 00:00:00,6,52,0,0,58,7,13,0,1,21,25.0,82,3,10.4,79,False,0,13,65,0,1,2024-12-11,False,True,False,0.8227848101265823,0.16455696202531644,0.0,0.012658227848101266,Off-Peak,Wednesday,December
2024-12-11 01:00:00,9,80,3,0,92,9,13,1,2,25,24.8,82,3,11.6,117,False,1,18,93,4,2,2024-12-11,False,True,False,0.7948717948717948,0.15384615384615385,0.03418803418803419,0.017094017094017096,Off-Peak,Wednesday,December
2024-12-11 02:00:00,11,88,5,0,104,46,77,1,1,125,24.6,83,3,11.1,229,False,2,57,165,6,1,2024-12-11,False,True,False,0.7205240174672489,0.24890829694323144,0.026200873362445413,0.004366812227074236,Off-Peak,Wednesday,December
2024-12-11 03:00:00,15,118,3,0,136,92,155,2,1,250,24.3,84,3,10.7,386,False,3,107,273,5,1,2024-12-11,False,True,False,0.7072538860103627,0.2772020725388601,0.012953367875647668,0.0025906735751295338,Off-Peak,Wednesday,December
2024-12-11 04:00:00,17,141,1,0,159,107,179,2,0,288,24.3,86,3,11.8,447,False,4,124,320,3,0,2024-12-11,False,True,False,0.7158836689038032,0.27740492170022374,0.006711409395973154,0.0,Off-Peak,Wednesday,December
2024-12-11 05:00:00,18,153,2,0,173,118,195,3,1,317,24.3,87,3,12.9,490,False,5,136,348,5,1,2024-12-11,False,True,False,0.710204081632653,0.27755102040816326,0.01020408163265306,0.0020408163265306124,Shoulder,Wednesday,December
2024-12-11 06:00:00,21,176,5,0,202,129,215,3,1,348,24.3,89,3,12.4,550,False,6,150,391,8,1,2024-12-11,False,True,False,0.7109090909090909,0.2727272727272727,0.014545454545454545,0.0018181818181818182,Shoulder,Wednesday,December
2024-12-11 07:00:00,30,241,4,0,275,132,221,3,1,357,24.2,91,3,11.3,632,False,7,162,462,7,1,2024-12-11,False,True,False,0.7310126582278481,0.2563291139240506,0.011075949367088608,0.0015822784810126582,Peak,Wednesday,December
2024-12-11 08:00:00,30,257,0,0,287,155,262,4,1,422,24.8,89,3,9.9,709,False,8,185,519,4,1,2024-12-11,False,True,False,0.7320169252468265,0.2609308885754584,0.005641748942172073,0.0014104372355430183,Peak,Wednesday,December
2024-12-11 09:00:00,42,359,0,0,401,169,284,4,1,458,26.8,84,3,5.7,859,False,9,211,643,4,1,2024-12-11,False,True,False,0.7485448195576252,0.24563445867287545,0.004656577415599534,0.0011641443538998836,Shoulder,Wednesday,December
2024-12-11 10:00:00,46,368,7,0,421,208,347,5,1,561,28.4,80,3,7.5,982,False,10,254,715,12,1,2024-12-11,False,True,False,0.7281059063136456,0.25865580448065173,0.012219959266802444,0.0010183299389002036,Shoulder,Wednesday,December
2024-12-11 11:00:00,47,399,2,0,448,219,370,5,1,595,28.9,76,3,10.5,1043,False,11,266,769,7,1,2024-12-11,False,True,False,0.7372962607861937,0.2550335570469799,0.006711409395973154,0.0009587727708533077,Peak,Wednesday,December
2024-12-11 12:00:00,50,414,2,1,467,220,365,7,1,593,29.4,75,3,12.8,1060,False,12,270,779,9,2,2024-12-11,False,True,False,0.7349056603773585,0.25471698113207547,0.008490566037735849,0.0018867924528301887,Peak,Wednesday,December
2024-12-11 13:00:00,51,427,3,0,481,229,384,6,1,620,29.4,75,3,13.0,1101,False,13,280,811,9,1,2024-12-11,False,True,False,0.7366030881017257,0.254314259763851,0.008174386920980926,0.0009082652134423251,Peak,Wednesday,December
2024-12-11 14:00:00,60,487,3,1,551,237,396,7,1,641,29.9,75,3,11.7,1192,False,14,297,883,10,2,2024-12-11,False,True,False,0.7407718120805369,0.24916107382550334,0.008389261744966443,0.0016778523489932886,Peak,Wednesday,December
2024-12-11 15:00:00,64,544,1,1,610,257,431,7,1,696,30.4,72,2,13.6,1306,False,15,321,975,8,2,2024-12-11,False,True,False,0.7465543644716692,0.24578866768759572,0.006125574272588055,0.0015313935681470138,Peak,Wednesday,December
2024-12-11 16:00:00,74,621,1,1,697,313,526,7,1,847,30.1,72,2,12.9,1544,False,16,387,1147,8,2,2024-12-11,False,True,True,0.7428756476683938,0.2506476683937824,0.0051813471502590676,0.0012953367875647669,Peak,Wednesday,December
2024-12-11 17:00:00,85,714,9,1,809,313,527,7,1,848,29.7,74,2,11.8,1657,False,17,398,1241,16,2,2024-12-11,False,True,True,0.7489438744719372,0.24019312009656005,0.009656004828002414,0.0012070006035003018,Peak,Wednesday,December
2024-12-11 18:00:00,86,715,7,1,809,315,529,6,0,850,29.2,77,51,13.1,1659,False,18,401,1244,13,1,2024-12-11,False,True,True,0.7498493068113321,0.24171187462326701,0.007836045810729355,0.0006027727546714888,Peak,Wednesday,December
2024-12-11 19:00:00,91,763,9,1,864,316,532,7,0,855,28.2,79,3,13.2,1719,False,19,407,1295,16,1,2024-12-11,False,True,True,0.7533449680046539,0.2367655613728912,0.009307737056428156,0.0005817335660267597,Peak,Wednesday,December
2024-12-11 20:00:00,96,802,7,1,906,347,579,10,1,937,28.0,80,3,12.6,1843,False,20,443,1381,17,2,2024-12-11,False,True,True,0.7493217580032555,0.24036896364622898,0.009224091155724362,0.0010851871947911015,Shoulder,Wednesday,December
2024-12-11 21:00:00,97,822,5,1,925,364,609,10,1,984,27.6,82,2,11.6,1909,False,21,461,1431,15,2,2024-12-11,False,True,True,0.749607124148769,0.24148768988999475,0.00785751702462022,0.0010476689366160294,Shoulder,Wednesday,December
2024-12-11 22:00:00,97,823,5,1,926,418,695,14,1,1128,26.9,84,3,10.3,2054,False,22,515,1518,19,2,2024-12-11,False,True,True,0.73904576436222,0.250730282375852,0.009250243427458617,0.0009737098344693282,Shoulder,Wednesday,December
2024-12-11 23:00:00,99,826,5,1,931,424,706,13,1,1144,26.4,89,3,18.5,2075,False,23,523,1532,18,2,2024-12-11,False,True,True,0.7383132530120482,0.2520481927710843,0.008674698795180723,0.0009638554216867469,Shoulder,Wednesday,December
2024-12-12 00:00:00,14,92,1,0,107,18,29,0,1,48,25.8,89,3,15.4,155,False,0,32,121,1,1,2024-12-12,False,False,False,0.7806451612903226,0.2064516129032258,0.0064516129032258064,0.0064516129032258064,Off-Peak,Thursday,December
2024-12-12 01:00:00,14,90,1,1,106,23,40,0,0,63,26.0,90,3,18.2,169,False,1,37,130,1,1,2024-12-12,False,False,False,0.7692307692307693,0.21893491124260356,0.005917159763313609,0.005917159763313609,Off-Peak,Thursday,December
2024-12-12 02:00:00,14,86,1,1,102,62,109,1,0,172,26.1,90,3,16.5,274,False,2,76,195,2,1,2024-12-12,False,False,False,0.7116788321167883,0.2773722627737226,0.0072992700729927005,0.0036496350364963502,Off-Peak,Thursday,December
2024-12-12 03:00:00,27,182,2,1,212,67,119,2,1,189,25.8,94,3,14.4,401,False,3,94,301,4,2,2024-12-12,False,False,False,0.7506234413965087,0.2344139650872818,0.00997506234413965,0.004987531172069825,Off-Peak,Thursday,December
2024-12-12 04:00:00,30,200,3,0,233,77,133,2,0,212,25.5,92,3,14.9,445,False,4,107,333,5,0,2024-12-12,False,False,False,0.748314606741573,0.24044943820224718,0.011235955056179775,0.0,Off-Peak,Thursday,December
2024-12-12 05:00:00,34,226,4,1,265,91,158,2,1,252,25.2,92,3,13.3,517,False,5,125,384,6,2,2024-12-12,False,False,False,0.7427466150870407,0.24177949709864605,0.01160541586073501,0.0038684719535783366,Shoulder,Thursday,December
2024-12-12 06:00:00,35,231,6,1,273,113,197,3,0,313,25.0,92,53,12.2,586,False,6,148,428,9,1,2024-12-12,False,False,False,0.7303754266211604,0.2525597269624573,0.015358361774744027,0.0017064846416382253,Shoulder,Thursday,December
2024-12-12 07:00:00,36,238,5,1,280,114,197,4,2,317,24.7,92,3,13.5,597,False,7,150,435,9,3,2024-12-12,False,False,False,0.7286432160804021,0.25125628140703515,0.01507537688442211,0.005025125628140704,Peak,Thursday,December
2024-12-12 08:00:00,37,255,4,0,296,149,259,4,1,413,25.0,92,51,14.3,709,False,8,186,514,8,1,2024-12-12,False,False,False,0.7249647390691114,0.2623413258110014,0.011283497884344146,0.0014104372355430183,Peak,Thursday,December
2024-12-12 09:00:00,37,225,4,0,266,164,285,4,0,453,26.8,88,51,9.6,719,False,9,201,510,8,0,2024-12-12,False,False,False,0.7093184979137691,0.2795549374130737,0.011126564673157162,0.0,Shoulder,Thursday,December
2024-12-12 10:00:00,37,245,4,1,287,169,294,5,1,469,27.7,84,3,12.0,756,False,10,206,539,9,2,2024-12-12,False,False,False,0.7129629629629629,0.2724867724867725,0.011904761904761904,0.0026455026455026454,Shoulder,Thursday,December
2024-12-12 11:00:00,61,387,7,1,456,230,399,6,0,635,29.1,77,3,15.6,1091,False,11,291,786,13,1,2024-12-12,False,False,False,0.7204399633363886,0.26672777268560954,0.011915673693858845,0.0009165902841429881,Peak,Thursday,December
2024-12-12 12:00:00,72,478,7,0,557,231,400,6,0,637,29.8,72,3,15.0,1194,False,12,303,878,13,0,2024-12-12,False,False,False,0.7353433835845896,0.2537688442211055,0.010887772194304857,0.0,Peak,Thursday,December
2024-12-12 13:00:00,77,506,10,1,594,234,405,8,1,648,30.3,70,3,14.3,1242,False,13,311,911,18,2,2024-12-12,False,False,False,0.7334943639291466,0.250402576489533,0.014492753623188406,0.001610305958132045,Peak,Thursday,December
2024-12-12 14:00:00,80,529,7,0,616,244,423,10,1,678,30.7,67,3,15.6,1294,False,14,324,952,17,1,2024-12-12,False,False,False,0.7357032457496137,0.250386398763524,0.01313755795981453,0.0007727975270479134,Peak,Thursday,December
2024-12-12 15:00:00,81,543,7,0,631,255,444,7,0,706,29.7,72,3,16.2,1337,False,15,336,987,14,0,2024-12-12,False,False,False,0.7382198952879581,0.2513089005235602,0.010471204188481676,0.0,Peak,Thursday,December
2024-12-12 16:00:00,81,561,10,1,653,256,446,9,1,712,29.0,76,3,14.8,1365,False,16,337,1007,19,2,2024-12-12,False,False,False,0.7377289377289378,0.2468864468864469,0.01391941391941392,0.0014652014652014652,Peak,Thursday,December
2024-12-12 17:00:00,84,561,9,1,655,262,456,7,0,725,28.9,75,3,13.2,1380,False,17,346,1017,16,1,2024-12-12,False,False,True,0.7369565217391304,0.25072463768115943,0.011594202898550725,0.0007246376811594203,Peak,Thursday,December
2024-12-12 18:00:00,87,579,8,0,674,271,469,10,1,751,28.6,77,3,11.5,1425,False,18,358,1048,18,1,2024-12-12,False,False,True,0.7354385964912281,0.2512280701754386,0.01263157894736842,0.0007017543859649122,Peak,Thursday,December
2024-12-12 19:00:00,89,549,13,1,652,280,490,7,0,777,27.7,81,3,14.0,1429,False,19,369,1039,20,1,2024-12-12,False,False,True,0.7270818754373688,0.258222533240028,0.013995801259622114,0.0006997900629811056,Peak,Thursday,December
2024-12-12 20:00:00,90,600,10,0,700,287,499,11,1,798,26.5,88,51,10.7,1498,False,20,377,1099,21,1,2024-12-12,False,False,True,0.7336448598130841,0.25166889185580776,0.014018691588785047,0.0006675567423230974,Shoulder,Thursday,December
2024-12-12 21:00:00,97,634,12,0,743,294,511,10,1,816,28.2,78,3,11.6,1559,False,21,391,1145,22,1,2024-12-12,False,False,True,0.7344451571520205,0.2508017960230917,0.014111610006414367,0.0006414368184733803,Shoulder,Thursday,December
2024-12-12 22:00:00,98,662,10,0,770,332,576,10,1,919,27.6,81,3,8.9,1689,False,22,430,1238,20,1,2024-12-12,False,False,True,0.7329780935464772,0.2545885139135583,0.011841326228537596,0.0005920663114268798,Shoulder,Thursday,December
2024-12-12 23:00:00,117,792,11,0,920,347,600,11,0,958,26.9,84,3,7.1,1878,False,23,464,1392,22,0,2024-12-12,False,False,True,0.7412140575079872,0.2470713525026624,0.011714589989350373,0.0,Shoulder,Thursday,December
2024-12-13 00:00:00,3,22,1,1,27,26,37,1,2,66,26.8,83,3,11.3,93,False,0,29,59,2,3,2024-12-13,False,False,False,0.6344086021505376,0.3118279569892473,0.021505376344086023,0.03225806451612903,Off-Peak,Friday,December
2024-12-13 01:00:00,5,26,1,1,33,30,44,1,2,77,26.6,80,3,13.4,110,False,1,35,70,2,3,2024-12-13,False,False,False,0.6363636363636364,0.3181818181818182,0.01818181818181818,0.02727272727272727,Off-Peak,Friday,December
2024-12-13 02:00:00,15,96,1,1,113,32,47,0,1,80,26.4,79,3,13.2,193,False,2,47,143,1,2,2024-12-13,False,False,False,0.7409326424870466,0.24352331606217617,0.0051813471502590676,0.010362694300518135,Off-Peak,Friday,December
2024-12-13 03:00:00,21,136,2,0,159,36,54,1,1,92,26.0,85,3,11.8,251,False,3,57,190,3,1,2024-12-13,False,False,False,0.7569721115537849,0.22709163346613545,0.01195219123505976,0.00398406374501992,Off-Peak,Friday,December
2024-12-13 04:00:00,25,153,2,1,181,80,118,3,2,203,25.8,90,3,12.9,384,False,4,105,271,5,3,2024-12-13,False,False,False,0.7057291666666666,0.2734375,0.013020833333333334,0.0078125,Off-Peak,Friday,December
2024-12-13 05:00:00,83,495,8,2,588,89,132,3,1,225,25.9,90,3,11.6,813,False,5,172,627,11,3,2024-12-13,False,False,False,0.7712177121771218,0.2115621156211562,0.013530135301353014,0.0036900369003690036,Shoulder,Friday,December
2024-12-13 06:00:00,83,509,8,1,601,123,181,4,1,309,25.9,89,3,13.3,910,False,6,206,690,12,2,2024-12-13,False,False,False,0.7582417582417582,0.22637362637362637,0.013186813186813187,0.002197802197802198,Shoulder,Friday,December
2024-12-13 07:00:00,90,545,9,1,645,140,207,5,1,353,25.5,90,3,11.8,998,False,7,230,752,14,2,2024-12-13,False,False,False,0.7535070140280561,0.23046092184368738,0.014028056112224449,0.002004008016032064,Peak,Friday,December
2024-12-13 08:00:00,91,527,13,1,632,145,215,4,1,365,25.4,91,51,12.8,997,False,8,236,742,17,2,2024-12-13,False,False,False,0.7442326980942828,0.23671013039117353,0.017051153460381142,0.0020060180541624875,Peak,Friday,December
2024-12-13 09:00:00,95,559,9,1,664,154,227,4,1,386,25.4,94,51,11.5,1050,False,9,249,786,13,2,2024-12-13,False,False,False,0.7485714285714286,0.23714285714285716,0.012380952380952381,0.0019047619047619048,Shoulder,Friday,December
2024-12-13 10:00:00,96,572,9,1,678,154,229,5,1,389,26.3,90,51,13.7,1067,False,10,250,801,14,2,2024-12-13,False,False,False,0.7507029053420806,0.23430178069353327,0.013120899718837863,0.0018744142455482662,Shoulder,Friday,December
2024-12-13 11:00:00,105,639,10,1,755,156,230,4,1,391,28.0,81,51,15.6,1146,False,11,261,869,14,2,2024-12-13,False,False,False,0.7582897033158813,0.22774869109947643,0.012216404886561954,0.0017452006980802793,Peak,Friday,December
2024-12-13 12:00:00,106,637,11,1,755,167,246,6,2,421,28.6,79,3,14.0,1176,False,12,273,883,17,3,2024-12-13,False,False,False,0.7508503401360545,0.23214285714285715,0.01445578231292517,0.002551020408163265,Peak,Friday,December
2024-12-13 13:00:00,115,689,11,1,816,218,320,8,2,548,29.0,73,3,13.8,1364,False,13,333,1009,19,3,2024-12-13,False,False,False,0.7397360703812317,0.24413489736070382,0.013929618768328446,0.0021994134897360706,Peak,Friday,December
2024-12-13 14:00:00,116,701,11,0,828,221,325,7,1,554,29.2,71,3,14.1,1382,False,14,337,1026,18,1,2024-12-13,False,False,True,0.7424023154848046,0.243849493487699,0.013024602026049204,0.000723589001447178,Peak,Friday,December
2024-12-13 15:00:00,127,763,14,1,905,229,335,6,1,571,29.5,68,3,13.2,1476,False,15,356,1098,20,2,2024-12-13,False,False,True,0.7439024390243902,0.24119241192411925,0.013550135501355014,0.0013550135501355014,Peak,Friday,December
2024-12-13 16:00:00,145,879,13,0,1037,235,347,7,1,590,29.5,69,3,12.6,1627,False,16,380,1226,20,1,2024-12-13,False,False,True,0.7535341118623233,0.23355869698832207,0.012292562999385371,0.0006146281499692685,Peak,Friday,December
2024-12-13 17:00:00,171,1015,17,1,1204,242,359,7,1,609,29.3,70,3,11.9,1813,False,17,413,1374,24,2,2024-12-13,False,False,True,0.7578599007170436,0.2277992277992278,0.013237727523441808,0.0011031439602868175,Peak,Friday,December
2024-12-13 18:00:00,180,1082,16,0,1278,246,363,7,1,617,28.6,76,3,10.5,1895,False,18,426,1445,23,1,2024-12-13,False,False,True,0.762532981530343,0.22480211081794196,0.012137203166226913,0.0005277044854881266,Peak,Friday,December
2024-12-13 19:00:00,180,1086,18,1,1285,268,391,9,1,669,27.7,82,3,11.3,1954,False,19,448,1477,27,2,2024-12-13,False,False,True,0.755885363357216,0.2292732855680655,0.013817809621289662,0.0010235414534288639,Peak,Friday,December
2024-12-13 20:00:00,181,1080,16,1,1278,274,401,8,1,684,27.1,86,3,8.9,1962,False,20,455,1481,24,2,2024-12-13,False,False,True,0.754841997961264,0.23190621814475026,0.012232415902140673,0.0010193679918450561,Shoulder,Friday,December
2024-12-13 21:00:00,196,1178,20,1,1395,275,403,14,2,694,26.7,87,51,6.4,2089,False,21,471,1581,34,3,2024-12-13,False,False,True,0.7568214456677836,0.22546673049305888,0.016275730014360938,0.0014360938247965534,Shoulder,Friday,December
2024-12-13 22:00:00,205,1235,19,0,1459,281,414,9,1,705,26.5,90,51,7.3,2164,False,22,486,1649,28,1,2024-12-13,False,False,True,0.762014787430684,0.2245841035120148,0.012939001848428836,0.0004621072088724584,Shoulder,Friday,December
2024-12-13 23:00:00,213,1248,26,1,1488,324,477,10,1,812,26.1,89,51,9.9,2300,False,23,537,1725,36,2,2024-12-13,False,False,True,0.75,0.23347826086956522,0.01565217391304348,0.0008695652173913044,Shoulder,Friday,December
2024-12-14 00:00:00,12,75,1,1,89,30,48,0,2,80,25.9,85,3,10.6,169,True,0,42,123,1,3,2024-12-14,False,False,False,0.727810650887574,0.2485207100591716,0.005917159763313609,0.01775147928994083,Off-Peak,Saturday,December
2024-12-14 01:00:00,25,154,2,1,182,74,114,3,2,193,25.4,85,3,12.4,375,True,1,99,268,5,3,2024-12-14,False,False,False,0.7146666666666667,0.264,0.013333333333333334,0.008,Off-Peak,Saturday,December
2024-12-14 02:00:00,26,159,3,1,189,92,142,3,2,239,25.2,86,3,12.5,428,True,2,118,301,6,3,2024-12-14,False,False,False,0.7032710280373832,0.2757009345794392,0.014018691588785047,0.007009345794392523,Off-Peak,Saturday,December
2024-12-14 03:00:00,32,193,4,2,231,100,157,3,1,261,24.9,88,3,11.7,492,True,3,132,350,7,3,2024-12-14,False,False,False,0.7113821138211383,0.2682926829268293,0.014227642276422764,0.006097560975609756,Off-Peak,Saturday,December
2024-12-14 04:00:00,33,207,3,1,244,101,157,3,2,263,24.8,89,3,9.4,507,True,4,134,364,6,3,2024-12-14,False,False,False,0.717948717948718,0.26429980276134124,0.011834319526627219,0.005917159763313609,Off-Peak,Saturday,December
2024-12-14 05:00:00,61,366,6,1,434,121,186,4,1,312,24.7,90,3,10.1,746,True,5,182,552,10,2,2024-12-14,False,False,False,0.739946380697051,0.24396782841823056,0.013404825737265416,0.002680965147453083,Shoulder,Saturday,December
2024-12-14 06:00:00,66,389,7,1,463,123,188,5,2,318,24.8,91,3,8.2,781,True,6,189,577,12,3,2024-12-14,False,False,False,0.7387964148527529,0.24199743918053776,0.015364916773367477,0.0038412291933418692,Shoulder,Saturday,December
2024-12-14 07:00:00,71,438,7,1,517,138,211,4,1,354,24.7,92,51,13.4,871,True,7,209,649,11,2,2024-12-14,False,False,False,0.7451205510907003,0.2399540757749713,0.012629161882893225,0.002296211251435132,Peak,Saturday,December
2024-12-14 08:00:00,75,446,8,1,530,145,219,6,2,372,25.1,92,51,13.8,902,True,8,220,665,14,3,2024-12-14,False,False,False,0.7372505543237251,0.24390243902439024,0.015521064301552107,0.0033259423503325942,Peak,Saturday,December
2024-12-14 09:00:00,83,475,9,1,568,147,226,4,1,378,26.8,86,51,9.3,946,True,9,230,701,13,2,2024-12-14,False,False,False,0.741014799154334,0.24312896405919662,0.013742071881606765,0.0021141649048625794,Shoulder,Saturday,December
2024-12-14 10:00:00,88,509,11,1,609,160,246,4,1,411,27.8,81,3,8.5,1020,True,10,248,755,15,2,2024-12-14,False,False,False,0.7401960784313726,0.24313725490196078,0.014705882352941176,0.00196078431372549,Shoulder,Saturday,December
2024-12-14 11:00:00,122,728,12,1,863,164,249,4,1,418,29.5,71,3,9.2,1281,True,11,286,977,16,2,2024-12-14,False,False,False,0.7626854020296643,0.2232630757220921,0.01249024199843872,0.00156128024980484,Peak,Saturday,December
2024-12-14 12:00:00,123,732,12,1,868,168,257,6,2,433,30.0,67,3,10.4,1301,True,12,291,989,18,3,2024-12-14,False,False,False,0.760184473481937,0.22367409684857803,0.013835511145272867,0.0023059185242121443,Peak,Saturday,December
2024-12-14 13:00:00,127,765,13,1,906,207,314,7,1,529,30.1,67,51,10.2,1435,True,13,334,1079,20,2,2024-12-14,False,False,True,0.7519163763066202,0.23275261324041813,0.013937282229965157,0.0013937282229965157,Peak,Saturday,December
2024-12-14 14:00:00,130,778,13,1,922,211,322,7,2,542,29.8,68,3,12.0,1464,True,14,341,1100,20,3,2024-12-14,False,False,True,0.7513661202185792,0.23292349726775957,0.01366120218579235,0.0020491803278688526,Peak,Saturday,December
2024-12-14 15:00:00,132,775,13,1,921,218,332,7,1,558,30.5,66,3,10.7,1479,True,15,350,1107,20,2,2024-12-14,False,False,True,0.7484787018255578,0.23664638269100743,0.013522650439486139,0.001352265043948614,Peak,Saturday,December
2024-12-14 16:00:00,141,830,15,1,987,222,337,8,2,569,30.6,66,3,9.6,1556,True,16,363,1167,23,3,2024-12-14,False,False,True,0.75,0.2332904884318766,0.014781491002570694,0.0019280205655526992,Peak,Saturday,December
2024-12-14 17:00:00,142,841,15,1,999,235,364,8,2,609,29.8,71,3,8.1,1608,True,17,377,1205,23,3,2024-12-14,False,False,True,0.7493781094527363,0.23445273631840796,0.014303482587064677,0.0018656716417910447,Peak,Saturday,December
2024-12-14 18:00:00,143,851,14,1,1009,242,371,7,1,621,28.9,78,2,8.5,1630,True,18,385,1222,21,2,2024-12-14,False,False,True,0.7496932515337423,0.2361963190184049,0.012883435582822086,0.001226993865030675,Peak,Saturday,December
2024-12-14 19:00:00,146,858,17,2,1023,242,375,9,2,628,28.2,83,3,9.6,1651,True,19,388,1233,26,4,2024-12-14,False,False,True,0.7468201090248334,0.2350090854027862,0.015748031496062992,0.0024227740763173833,Peak,Saturday,December
2024-12-14 20:00:00,151,872,18,1,1042,251,381,7,2,641,27.8,85,2,7.8,1683,True,20,402,1253,25,3,2024-12-14,False,False,True,0.744503862150921,0.23885918003565063,0.014854426619132501,0.0017825311942959,Shoulder,Saturday,December
2024-12-14 21:00:00,167,987,16,1,1171,282,433,9,1,725,28.0,81,2,5.3,1896,True,21,449,1420,25,2,2024-12-14,False,False,True,0.7489451476793249,0.23681434599156118,0.013185654008438819,0.0010548523206751054,Shoulder,Saturday,December
2024-12-14 22:00:00,171,1007,19,1,1198,298,457,9,1,765,27.2,82,3,10.5,1963,True,22,469,1464,28,2,2024-12-14,False,False,True,0.7457972491085074,0.23892002037697402,0.014263881813550688,0.0010188487009679063,Shoulder,Saturday,December
2024-12-14 23:00:00,174,1030,18,1,1223,336,516,9,1,862,26.6,86,3,12.3,2085,True,23,510,1546,27,2,2024-12-14,False,False,True,0.7414868105515587,0.2446043165467626,0.012949640287769784,0.0009592326139088729,Shoulder,Saturday,December
2024-12-15 00:00:00,134,524,11,0,669,240,447,6,1,694,26.5,87,3,13.4,1363,True,0,374,971,17,1,2024-12-15,False,False,False,0.7123991195891416,0.2743947175348496,0.012472487160674981,0.0007336757153338225,Off-Peak,Sunday,December
2024-12-15 01:00:00,121,455,9,0,585,181,322,4,1,508,25.8,88,3,12.8,1093,True,1,302,777,13,1,2024-12-15,False,False,False,0.7108874656907593,0.27630375114364136,0.011893870082342177,0.0009149130832570906,Off-Peak,Sunday,December
2024-12-15 02:00:00,122,342,12,0,476,172,295,4,1,472,25.4,91,2,14.7,948,True,2,294,637,16,1,2024-12-15,False,False,False,0.6719409282700421,0.310126582278481,0.016877637130801686,0.0010548523206751054,Off-Peak,Sunday,December
2024-12-15 03:00:00,91,221,9,0,321,200,167,4,1,372,25.0,94,3,13.2,693,True,3,291,388,13,1,2024-12-15,False,False,False,0.5598845598845599,0.4199134199134199,0.01875901875901876,0.001443001443001443,Off-Peak,Sunday,December
2024-12-15 04:00:00,112,265,10,0,387,203,165,5,1,374,24.9,94,3,12.2,761,True,4,315,430,15,1,2024-12-15,False,False,False,0.5650459921156373,0.41392904073587383,0.01971090670170828,0.001314060446780552,Off-Peak,Sunday,December
2024-12-15 05:00:00,115,304,10,0,429,170,290,4,1,465,24.7,94,3,11.2,894,True,5,285,594,14,1,2024-12-15,False,False,False,0.6644295302013423,0.3187919463087248,0.015659955257270694,0.0011185682326621924,Shoulder,Sunday,December
2024-12-15 06:00:00,96,567,8,0,671,218,406,6,1,631,24.6,93,3,10.3,1302,True,6,314,973,14,1,2024-12-15,False,False,False,0.7473118279569892,0.2411674347158218,0.010752688172043012,0.0007680491551459293,Shoulder,Sunday,December
2024-12-15 07:00:00,117,675,10,0,802,223,711,7,1,942,24.4,94,3,9.8,1744,True,7,340,1386,17,1,2024-12-15,False,False,True,0.7947247706422018,0.19495412844036697,0.00974770642201835,0.0005733944954128441,Peak,Sunday,December
2024-12-15 08:00:00,104,798,9,1,912,224,415,7,1,647,24.9,93,3,9.8,1559,True,8,328,1213,16,2,2024-12-15,False,False,True,0.7780628608082104,0.21039127645926875,0.010262989095574085,0.0012828736369467607,Peak,Sunday,December
2024-12-15 09:00:00,91,807,8,1,907,166,390,6,1,563,27.4,87,3,8.6,1470,True,9,257,1197,14,2,2024-12-15,False,False,True,0.8142857142857143,0.17482993197278912,0.009523809523809525,0.0013605442176870747,Shoulder,Sunday,December
2024-12-15 10:00:00,99,757,9,2,867,211,382,6,1,600,29.1,77,51,7.2,1467,True,10,310,1139,15,3,2024-12-15,False,False,True,0.776414451261077,0.2113156100886162,0.010224948875255624,0.002044989775051125,Shoulder,Sunday,December
2024-12-15 11:00:00,125,780,11,1,917,215,397,9,3,624,29.9,75,51,9.1,1541,True,11,340,1177,20,4,2024-12-15,False,False,True,0.7637897469175859,0.22063595068137573,0.012978585334198572,0.0025957170668397143,Peak,Sunday,December
2024-12-15 12:00:00,128,778,12,1,919,233,434,7,1,675,28.5,78,63,8.7,1594,True,12,361,1212,19,2,2024-12-15,False,False,True,0.7603513174404015,0.22647427854454202,0.01191969887076537,0.0012547051442910915,Peak,Sunday,December
2024-12-15 13:00:00,104,723,9,1,837,183,327,5,1,516,29.7,75,51,5.2,1353,True,13,287,1050,14,2,2024-12-15,False,False,False,0.7760532150776053,0.21212121212121213,0.010347376201034738,0.0014781966001478197,Peak,Sunday,December
2024-12-15 14:00:00,91,824,8,1,924,205,380,6,2,593,31.2,65,3,2.5,1517,True,14,296,1204,14,3,2024-12-15,False,False,True,0.7936717205009888,0.1951219512195122,0.00922874093605801,0.001977587343441002,Peak,Sunday,December
2024-12-15 15:00:00,111,768,11,1,891,238,434,7,2,681,31.7,61,3,5.9,1572,True,15,349,1202,18,3,2024-12-15,False,False,True,0.7646310432569975,0.22201017811704835,0.011450381679389313,0.0019083969465648854,Peak,Sunday,December
2024-12-15 16:00:00,103,701,9,1,814,194,350,5,2,551,31.6,63,3,6.7,1365,True,16,297,1051,14,3,2024-12-15,False,False,False,0.76996336996337,0.2175824175824176,0.010256410256410256,0.002197802197802198,Peak,Sunday,December
2024-12-15 17:00:00,88,690,8,1,787,164,280,5,2,451,31.0,66,3,7.0,1238,True,17,252,970,13,3,2024-12-15,False,False,False,0.7835218093699515,0.2035541195476575,0.01050080775444265,0.0024232633279483036,Peak,Sunday,December
2024-12-15 18:00:00,132,783,13,1,929,172,294,5,2,473,30.1,72,3,6.5,1402,True,18,304,1077,18,3,2024-12-15,False,False,True,0.7681883024251069,0.21683309557774608,0.012838801711840228,0.0021398002853067048,Peak,Sunday,December
2024-12-15 19:00:00,94,852,10,1,957,178,302,5,2,487,28.9,79,2,7.9,1444,True,19,272,1154,15,3,2024-12-15,False,False,True,0.7991689750692521,0.1883656509695291,0.01038781163434903,0.002077562326869806,Peak,Sunday,December
2024-12-15 20:00:00,111,890,12,1,1014,189,335,6,2,532,28.1,83,3,3.6,1546,True,20,300,1225,18,3,2024-12-15,False,False,True,0.7923673997412678,0.19404915912031048,0.01164294954721863,0.0019404915912031048,Shoulder,Sunday,December
2024-12-15 21:00:00,110,668,10,1,789,272,526,8,2,808,26.1,90,3,9.3,1597,True,21,382,1194,18,3,2024-12-15,False,False,True,0.7476518472135254,0.23919849718221667,0.011271133375078271,0.001878522229179712,Shoulder,Sunday,December
2024-12-15 22:00:00,129,761,13,1,904,235,442,7,2,686,26.1,90,3,12.5,1590,True,22,364,1203,20,3,2024-12-15,False,False,True,0.7566037735849057,0.2289308176100629,0.012578616352201259,0.0018867924528301887,Shoulder,Sunday,December
2024-12-15 23:00:00,92,612,9,1,714,191,338,7,2,538,25.8,90,3,8.4,1252,True,23,283,950,16,3,2024-12-15,False,False,False,0.7587859424920128,0.22603833865814696,0.012779552715654952,0.0023961661341853034,Shoulder,Sunday,December
2024-12-16 00:00:00,74,288,6,0,368,141,214,5,0,360,25.6,91,3,8.2,728,False,0,215,502,11,0,2024-12-16,False,False,False,0.6895604395604396,0.29532967032967034,0.01510989010989011,0.0,Off-Peak,Monday,December
2024-12-16 01:00:00,61,133,7,0,201,123,170,4,1,298,25.3,93,3,6.6,499,False,1,184,303,11,1,2024-12-16,False,False,False,0.6072144288577155,0.3687374749498998,0.022044088176352707,0.002004008016032064,Off-Peak,Monday,December
2024-12-16 02:00:00,92,137,8,0,237,132,190,6,1,329,24.9,94,3,10.1,566,False,2,224,327,14,1,2024-12-16,False,False,False,0.5777385159010601,0.3957597173144876,0.024734982332155476,0.0017667844522968198,Off-Peak,Monday,December
2024-12-16 03:00:00,68,166,8,0,242,145,118,5,1,269,24.6,92,51,12.0,511,False,3,213,284,13,1,2024-12-16,False,False,False,0.5557729941291585,0.41682974559686886,0.025440313111545987,0.0019569471624266144,Off-Peak,Monday,December
2024-12-16 04:00:00,83,271,9,0,363,132,98,5,1,236,24.9,91,51,10.1,599,False,4,215,369,14,1,2024-12-16,False,False,False,0.6160267111853088,0.3589315525876461,0.02337228714524207,0.001669449081803005,Off-Peak,Monday,December
2024-12-16 05:00:00,78,249,8,0,335,124,173,4,1,302,24.7,94,51,9.2,637,False,5,202,422,12,1,2024-12-16,False,False,False,0.6624803767660911,0.31711145996860285,0.018838304552590265,0.0015698587127158557,Shoulder,Monday,December
2024-12-16 06:00:00,68,381,7,0,456,107,224,4,1,336,24.1,97,1,8.8,792,False,6,175,605,11,1,2024-12-16,False,False,False,0.7638888888888888,0.22095959595959597,0.013888888888888888,0.0012626262626262627,Shoulder,Monday,December
2024-12-16 07:00:00,72,605,7,0,684,117,548,4,1,670,23.9,97,3,7.2,1354,False,7,189,1153,11,1,2024-12-16,False,False,False,0.8515509601181684,0.1395864106351551,0.00812407680945347,0.0007385524372230429,Peak,Monday,December
2024-12-16 08:00:00,86,592,10,2,690,125,459,4,1,589,24.6,95,1,6.6,1279,False,8,211,1051,14,3,2024-12-16,False,False,False,0.8217357310398749,0.16497263487099295,0.0109460516028147,0.0023455824863174357,Peak,Monday,December
2024-12-16 09:00:00,74,494,8,1,577,143,320,6,1,470,27.1,83,3,10.9,1047,False,9,217,814,14,2,2024-12-16,False,False,False,0.7774594078319007,0.2072588347659981,0.013371537726838587,0.0019102196752626551,Shoulder,Monday,December
2024-12-16 10:00:00,78,530,9,1,618,133,496,6,1,636,28.5,80,51,11.3,1254,False,10,211,1026,15,2,2024-12-16,False,False,False,0.8181818181818182,0.1682615629984051,0.011961722488038277,0.001594896331738437,Shoulder,Monday,December
2024-12-16 11:00:00,68,471,9,1,549,136,288,7,1,432,29.1,75,51,13.1,981,False,11,204,759,16,2,2024-12-16,False,False,False,0.7737003058103975,0.20795107033639143,0.0163098878695209,0.0020387359836901123,Peak,Monday,December
2024-12-16 12:00:00,76,511,9,1,597,137,307,6,1,451,30.0,73,51,12.1,1048,False,12,213,818,15,2,2024-12-16,False,False,False,0.7805343511450382,0.2032442748091603,0.01431297709923664,0.0019083969465648854,Peak,Monday,December
2024-12-16 13:00:00,90,524,11,1,626,107,220,6,1,334,28.6,78,61,14.8,960,False,13,197,744,17,2,2024-12-16,False,False,False,0.775,0.20520833333333333,0.017708333333333333,0.0020833333333333333,Peak,Monday,December
2024-12-16 14:00:00,82,577,9,1,669,114,229,6,1,350,28.0,81,3,11.8,1019,False,14,196,806,15,2,2024-12-16,False,False,False,0.7909715407262021,0.19234543670264967,0.014720314033366046,0.001962708537782139,Peak,Monday,December
2024-12-16 15:00:00,76,429,9,1,515,120,254,5,1,380,30.0,72,51,9.7,895,False,15,196,683,14,2,2024-12-16,False,False,False,0.7631284916201118,0.21899441340782122,0.01564245810055866,0.0022346368715083797,Peak,Monday,December
2024-12-16 16:00:00,76,420,8,1,505,115,242,6,1,364,30.7,71,53,9.1,869,False,16,191,662,14,2,2024-12-16,False,False,False,0.761795166858458,0.21979286536248563,0.01611047180667434,0.0023014959723820483,Peak,Monday,December
2024-12-16 17:00:00,90,624,9,1,724,145,418,8,1,572,30.7,70,3,10.3,1296,False,17,235,1042,17,2,2024-12-16,False,False,False,0.8040123456790124,0.18132716049382716,0.013117283950617283,0.0015432098765432098,Peak,Monday,December
2024-12-16 18:00:00,83,556,10,1,650,152,342,6,1,501,26.2,89,63,16.0,1151,False,18,235,898,16,2,2024-12-16,False,False,False,0.7801911381407471,0.20417028670721113,0.013900955690703735,0.0017376194613379669,Peak,Monday,December
2024-12-16 19:00:00,77,518,9,1,605,109,231,6,1,347,25.7,88,55,5.1,952,False,19,186,749,15,2,2024-12-16,False,False,False,0.7867647058823529,0.1953781512605042,0.015756302521008403,0.0021008403361344537,Peak,Monday,December
2024-12-16 20:00:00,85,567,10,1,663,151,346,8,1,506,25.5,92,51,1.5,1169,False,20,236,913,18,2,2024-12-16,False,False,False,0.7810094097519247,0.2018819503849444,0.015397775876817793,0.001710863986313088,Shoulder,Monday,December
2024-12-16 21:00:00,68,461,9,1,539,115,234,6,1,356,25.2,96,63,12.4,895,False,21,183,695,15,2,2024-12-16,False,False,False,0.776536312849162,0.20446927374301677,0.01675977653631285,0.0022346368715083797,Shoulder,Monday,December
2024-12-16 22:00:00,83,478,10,1,572,158,356,7,1,522,24.7,97,61,14.8,1094,False,22,241,834,17,2,2024-12-16,False,False,False,0.7623400365630713,0.2202925045703839,0.015539305301645339,0.0018281535648994515,Shoulder,Monday,December
2024-12-16 23:00:00,81,414,12,1,508,121,260,7,1,389,24.6,98,53,8.9,897,False,23,202,674,19,2,2024-12-16,False,False,False,0.7513935340022296,0.22519509476031216,0.021181716833890748,0.002229654403567447,Shoulder,Monday,December
2024-12-17 00:00:00,63,272,6,0,341,197,220,5,0,422,24.4,96,53,12.9,763,False,0,260,492,11,0,2024-12-17,False,False,False,0.6448230668414154,0.34076015727391873,0.014416775884665793,0.0,Off-Peak,Tuesday,December
2024-12-17 01:00:00,72,179,7,0,258,159,122,4,1,286,24.5,95,51,13.4,544,False,1,231,301,11,1,2024-12-17,False,False,False,0.5533088235294118,0.42463235294117646,0.02022058823529412,0.001838235294117647,Off-Peak,Tuesday,December
2024-12-17 02:00:00,79,139,7,0,225,168,144,5,1,318,24.4,96,51,15.2,543,False,2,247,283,12,1,2024-12-17,False,False,False,0.5211786372007366,0.4548802946593002,0.022099447513812154,0.001841620626151013,Off-Peak,Tuesday,December
2024-12-17 03:00:00,72,174,7,0,253,213,166,5,1,385,24.3,97,3,13.1,638,False,3,285,340,12,1,2024-12-17,False,False,False,0.5329153605015674,0.44670846394984326,0.018808777429467086,0.001567398119122257,Off-Peak,Tuesday,December
2024-12-17 04:00:00,59,180,6,0,245,158,215,6,1,380,24.0,97,3,11.3,625,False,4,217,395,12,1,2024-12-17,False,False,False,0.632,0.3472,0.0192,0.0016,Off-Peak,Tuesday,December
2024-12-17 05:00:00,66,313,8,1,388,212,365,5,1,583,23.9,97,3,11.0,971,False,5,278,678,13,2,2024-12-17,False,False,False,0.698249227600412,0.286302780638517,0.013388259526261586,0.0020597322348094747,Shoulder,Tuesday,December
2024-12-17 06:00:00,85,462,7,0,554,175,460,4,1,640,23.9,96,3,11.0,1194,False,6,260,922,11,1,2024-12-17,False,False,False,0.7721943048576214,0.21775544388609716,0.009212730318257957,0.0008375209380234506,Shoulder,Tuesday,December
2024-12-17 07:00:00,65,614,7,0,686,148,598,4,1,751,23.9,96,3,9.2,1437,False,7,213,1212,11,1,2024-12-17,False,False,True,0.8434237995824635,0.14822546972860126,0.007654836464857342,0.0006958942240779402,Peak,Tuesday,December
2024-12-17 08:00:00,59,556,6,0,621,150,498,5,1,654,24.5,94,3,12.4,1275,False,8,209,1054,11,1,2024-12-17,False,False,False,0.8266666666666667,0.16392156862745097,0.008627450980392156,0.000784313725490196,Peak,Tuesday,December
2024-12-17 09:00:00,81,544,7,0,632,213,467,5,1,686,26.7,89,3,10.4,1318,False,9,294,1011,12,1,2024-12-17,False,False,False,0.7670713201820941,0.22306525037936267,0.009104704097116844,0.0007587253414264037,Shoulder,Tuesday,December
2024-12-17 10:00:00,82,608,7,0,697,169,445,4,1,619,28.3,82,3,13.0,1316,False,10,251,1053,11,1,2024-12-17,False,False,False,0.8001519756838906,0.19072948328267478,0.008358662613981762,0.0007598784194528875,Shoulder,Tuesday,December
2024-12-17 11:00:00,75,513,8,1,597,163,429,4,1,597,29.3,76,51,17.8,1194,False,11,238,942,12,2,2024-12-17,False,False,False,0.7889447236180904,0.19932998324958123,0.010050251256281407,0.0016750418760469012,Peak,Tuesday,December
2024-12-17 12:00:00,66,535,7,1,609,197,428,5,1,631,30.0,70,51,18.6,1240,False,12,263,963,12,2,2024-12-17,False,False,False,0.7766129032258065,0.2120967741935484,0.00967741935483871,0.0016129032258064516,Peak,Tuesday,December
2024-12-17 13:00:00,68,549,7,1,625,203,441,6,1,651,30.3,67,51,20.2,1276,False,13,271,990,13,2,2024-12-17,False,False,False,0.7758620689655172,0.21238244514106583,0.01018808777429467,0.001567398119122257,Peak,Tuesday,December
2024-12-17 14:00:00,83,527,9,1,620,184,485,6,1,676,29.8,71,51,19.2,1296,False,14,267,1012,15,2,2024-12-17,False,False,False,0.7808641975308642,0.20601851851851852,0.011574074074074073,0.0015432098765432098,Peak,Tuesday,December
2024-12-17 15:00:00,81,531,9,1,622,205,439,7,1,652,29.4,72,53,20.7,1274,False,15,286,970,16,2,2024-12-17,False,False,False,0.7613814756671899,0.22448979591836735,0.012558869701726845,0.0015698587127158557,Peak,Tuesday,December
2024-12-17 16:00:00,73,690,8,1,772,209,443,6,1,659,28.6,77,55,14.6,1431,False,16,282,1133,14,2,2024-12-17,False,False,True,0.7917540181691125,0.1970649895178197,0.009783368273934312,0.001397624039133473,Peak,Tuesday,December
2024-12-17 17:00:00,64,612,7,1,684,154,405,5,1,565,28.5,76,51,13.9,1249,False,17,218,1017,12,2,2024-12-17,False,False,False,0.8142514011208967,0.1745396317053643,0.009607686148919135,0.0016012810248198558,Peak,Tuesday,December
2024-12-17 18:00:00,73,478,8,1,560,172,469,5,1,647,28.3,78,3,12.4,1207,False,18,245,947,13,2,2024-12-17,False,False,False,0.7845898922949461,0.20298260149130073,0.010770505385252692,0.0016570008285004142,Peak,Tuesday,December
2024-12-17 19:00:00,66,423,7,1,497,173,348,6,2,529,27.4,82,3,11.6,1026,False,19,239,771,13,3,2024-12-17,False,False,False,0.7514619883040936,0.23294346978557504,0.012670565302144249,0.0029239766081871343,Peak,Tuesday,December
2024-12-17 20:00:00,71,672,9,1,753,175,361,5,2,543,26.8,84,3,11.0,1296,False,20,246,1033,14,3,2024-12-17,False,False,False,0.7970679012345679,0.18981481481481483,0.010802469135802469,0.0023148148148148147,Shoulder,Tuesday,December
2024-12-17 21:00:00,71,540,10,1,622,194,413,7,2,616,25.7,94,3,8.6,1238,False,21,265,953,17,3,2024-12-17,False,False,False,0.7697899838449112,0.21405492730210016,0.013731825525040387,0.0024232633279483036,Shoulder,Tuesday,December
2024-12-17 22:00:00,58,438,9,1,506,173,358,6,2,539,25.7,94,53,10.0,1045,False,22,231,796,15,3,2024-12-17,False,False,False,0.7617224880382775,0.22105263157894736,0.014354066985645933,0.0028708133971291866,Shoulder,Tuesday,December
2024-12-17 23:00:00,78,496,11,1,586,224,495,8,2,729,25.4,96,53,7.9,1315,False,23,302,991,19,3,2024-12-17,False,False,False,0.7536121673003803,0.22965779467680608,0.014448669201520912,0.0022813688212927757,Shoulder,Tuesday,December
2024-12-18 00:00:00,68,214,5,0,287,157,231,4,0,392,25.3,98,51,5.0,679,False,0,225,445,9,0,2024-12-18,False,False,False,0.6553755522827688,0.33136966126656847,0.013254786450662739,0.0,Off-Peak,Wednesday,December
2024-12-18 01:00:00,53,168,6,0,227,163,155,5,0,323,25.2,98,53,5.4,550,False,1,216,323,11,0,2024-12-18,False,False,False,0.5872727272727273,0.3927272727272727,0.02,0.0,Off-Peak,Wednesday,December
2024-12-18 02:00:00,64,188,6,0,258,131,159,5,0,295,25.1,98,53,2.8,553,False,2,195,347,11,0,2024-12-18,False,False,False,0.6274864376130199,0.352622061482821,0.019891500904159132,0.0,Off-Peak,Wednesday,December
2024-12-18 03:00:00,60,141,6,0,207,175,185,5,0,365,24.9,98,51,5.9,572,False,3,235,326,11,0,2024-12-18,False,False,False,0.5699300699300699,0.41083916083916083,0.019230769230769232,0.0,Off-Peak,Wednesday,December
2024-12-18 04:00:00,53,181,4,0,238,163,152,6,0,321,24.7,98,51,3.9,559,False,4,216,333,10,0,2024-12-18,False,False,False,0.5957066189624329,0.38640429338103754,0.017889087656529516,0.0,Off-Peak,Wednesday,December
2024-12-18 05:00:00,62,364,5,0,431,171,267,7,0,445,24.4,99,3,3.2,876,False,5,233,631,12,0,2024-12-18,False,False,False,0.7203196347031964,0.2659817351598174,0.0136986301369863,0.0,Shoulder,Wednesday,December
2024-12-18 06:00:00,56,430,4,0,490,127,355,4,0,486,24.4,98,3,7.2,976,False,6,183,785,8,0,2024-12-18,False,False,False,0.8043032786885246,0.1875,0.00819672131147541,0.0,Shoulder,Wednesday,December
2024-12-18 07:00:00,71,637,5,0,713,171,572,5,1,749,24.2,98,3,5.9,1462,False,7,242,1209,10,1,2024-12-18,False,False,True,0.8269493844049247,0.16552667578659372,0.006839945280437756,0.0006839945280437756,Peak,Wednesday,December
2024-12-18 08:00:00,60,535,6,0,601,140,490,4,1,635,24.7,96,3,7.2,1236,False,8,200,1025,10,1,2024-12-18,False,False,False,0.8292880258899676,0.16181229773462782,0.008090614886731391,0.0008090614886731392,Peak,Wednesday,December
2024-12-18 09:00:00,64,556,5,1,626,185,403,5,1,594,25.3,95,53,12.8,1220,False,9,249,959,10,2,2024-12-18,False,False,False,0.7860655737704918,0.2040983606557377,0.00819672131147541,0.001639344262295082,Shoulder,Wednesday,December
2024-12-18 10:00:00,56,501,4,1,562,165,361,6,1,533,26.6,89,53,13.9,1095,False,10,221,862,10,2,2024-12-18,False,False,False,0.7872146118721461,0.20182648401826483,0.0091324200913242,0.0018264840182648401,Shoulder,Wednesday,December
2024-12-18 11:00:00,54,504,4,1,563,145,303,4,1,453,26.7,85,53,12.5,1016,False,11,199,807,8,2,2024-12-18,False,False,False,0.7942913385826772,0.19586614173228348,0.007874015748031496,0.001968503937007874,Peak,Wednesday,December
2024-12-18 12:00:00,49,545,4,1,599,130,362,6,1,499,26.8,85,53,10.1,1098,False,12,179,907,10,2,2024-12-18,False,False,False,0.8260473588342441,0.16302367941712204,0.009107468123861567,0.0018214936247723133,Peak,Wednesday,December
2024-12-18 13:00:00,63,492,6,1,562,184,405,6,1,596,27.0,85,55,9.4,1158,False,13,247,897,12,2,2024-12-18,False,False,False,0.7746113989637305,0.21329879101899826,0.010362694300518135,0.0017271157167530224,Peak,Wednesday,December
2024-12-18 14:00:00,53,456,4,1,514,176,391,7,1,575,27.1,85,53,13.6,1089,False,14,229,847,11,2,2024-12-18,False,False,False,0.7777777777777778,0.21028466483011937,0.010101010101010102,0.0018365472910927456,Peak,Wednesday,December
2024-12-18 15:00:00,68,521,5,1,595,136,274,5,1,416,27.0,86,61,9.2,1011,False,15,204,795,10,2,2024-12-18,False,False,False,0.7863501483679525,0.20178041543026706,0.009891196834817012,0.0019782393669634025,Peak,Wednesday,December
2024-12-18 16:00:00,56,402,4,1,463,156,332,6,1,495,27.5,85,53,10.6,958,False,16,212,734,10,2,2024-12-18,False,False,False,0.7661795407098121,0.22129436325678498,0.010438413361169102,0.0020876826722338203,Peak,Wednesday,December
2024-12-18 17:00:00,58,684,6,1,749,146,410,5,1,562,25.9,87,63,12.6,1311,False,17,204,1094,11,2,2024-12-18,False,False,False,0.8344774980930587,0.15560640732265446,0.008390541571319604,0.0015255530129672007,Peak,Wednesday,December
2024-12-18 18:00:00,53,485,5,1,544,162,345,6,1,514,26.1,89,51,13.1,1058,False,18,215,830,11,2,2024-12-18,False,False,False,0.7844990548204159,0.20321361058601134,0.010396975425330813,0.001890359168241966,Peak,Wednesday,December
2024-12-18 19:00:00,74,552,6,1,633,169,363,6,1,539,25.6,91,51,8.0,1172,False,19,243,915,12,2,2024-12-18,False,False,False,0.7807167235494881,0.20733788395904437,0.010238907849829351,0.0017064846416382253,Peak,Wednesday,December
2024-12-18 20:00:00,58,501,6,1,566,135,479,5,1,620,25.3,92,53,7.7,1186,False,20,193,980,11,2,2024-12-18,False,False,False,0.8263069139966274,0.1627318718381113,0.00927487352445194,0.0016863406408094434,Shoulder,Wednesday,December
2024-12-18 21:00:00,61,520,5,1,587,189,418,9,1,617,25.4,91,3,13.2,1204,False,21,250,938,14,2,2024-12-18,False,False,False,0.7790697674418605,0.20764119601328904,0.011627906976744186,0.0016611295681063123,Shoulder,Wednesday,December
2024-12-18 22:00:00,55,376,6,1,438,170,370,7,1,548,25.1,92,3,13.2,986,False,22,225,746,13,2,2024-12-18,False,False,False,0.7565922920892495,0.2281947261663286,0.013184584178498986,0.002028397565922921,Shoulder,Wednesday,December
2024-12-18 23:00:00,77,569,8,1,655,154,321,7,1,483,24.9,93,3,12.6,1138,False,23,231,890,15,2,2024-12-18,False,False,False,0.7820738137082601,0.20298769771529,0.013181019332161687,0.0017574692442882249,Shoulder,Wednesday,December
2024-12-19 00:00:00,75,219,7,0,301,152,228,5,0,385,24.6,94,3,13.3,686,False,0,227,447,12,0,2024-12-19,False,False,False,0.6516034985422741,0.33090379008746357,0.01749271137026239,0.0,Off-Peak,Thursday,December
2024-12-19 01:00:00,64,227,6,0,297,149,220,4,0,373,24.4,95,3,10.4,670,False,1,213,447,10,0,2024-12-19,False,False,False,0.6671641791044776,0.31791044776119404,0.014925373134328358,0.0,Off-Peak,Thursday,December
2024-12-19 02:00:00,74,106,7,0,187,140,199,5,0,344,24.3,96,3,9.4,531,False,2,214,305,12,0,2024-12-19,False,False,False,0.5743879472693032,0.4030131826741996,0.022598870056497175,0.0,Off-Peak,Thursday,December
2024-12-19 03:00:00,77,136,9,0,222,144,105,5,0,254,24.6,94,3,5.1,476,False,3,221,241,14,0,2024-12-19,False,False,False,0.5063025210084033,0.4642857142857143,0.029411764705882353,0.0,Off-Peak,Thursday,December
2024-12-19 04:00:00,63,114,6,0,183,187,136,5,0,328,24.1,97,2,3.8,511,False,4,250,250,11,0,2024-12-19,False,False,False,0.4892367906066536,0.4892367906066536,0.021526418786692758,0.0,Off-Peak,Thursday,December
2024-12-19 05:00:00,62,291,6,0,359,179,207,6,0,392,23.8,98,3,4.0,751,False,5,241,498,12,0,2024-12-19,False,False,False,0.6631158455392809,0.3209054593874834,0.015978695073235686,0.0,Shoulder,Thursday,December
2024-12-19 06:00:00,69,368,7,0,444,207,381,5,0,593,23.6,98,3,5.8,1037,False,6,276,749,12,0,2024-12-19,False,False,False,0.7222757955641272,0.266152362584378,0.011571841851494697,0.0,Shoulder,Thursday,December
2024-12-19 07:00:00,62,625,6,1,694,187,525,6,0,718,23.6,97,3,6.6,1412,False,7,249,1150,12,1,2024-12-19,False,False,True,0.8144475920679887,0.1763456090651558,0.0084985835694051,0.000708215297450425,Peak,Thursday,December
2024-12-19 08:00:00,64,529,6,1,600,137,589,5,0,731,24.2,95,3,6.2,1331,False,8,201,1118,11,1,2024-12-19,False,False,False,0.8399699474079639,0.15101427498121714,0.008264462809917356,0.0007513148009015778,Peak,Thursday,December
2024-12-19 09:00:00,75,598,8,1,682,192,446,6,0,644,26.0,91,3,11.2,1326,False,9,267,1044,14,1,2024-12-19,False,False,False,0.7873303167420814,0.20135746606334842,0.010558069381598794,0.0007541478129713424,Shoulder,Thursday,December
2024-12-19 10:00:00,67,531,6,1,605,175,401,6,0,582,27.2,84,3,12.6,1187,False,10,242,932,12,1,2024-12-19,False,False,False,0.785172704296546,0.2038753159224937,0.010109519797809604,0.0008424599831508003,Shoulder,Thursday,December
2024-12-19 11:00:00,58,487,6,1,552,168,380,5,0,553,28.7,74,3,15.0,1105,False,11,226,867,11,1,2024-12-19,False,False,False,0.7846153846153846,0.20452488687782805,0.009954751131221719,0.0009049773755656109,Peak,Thursday,December
2024-12-19 12:00:00,64,595,9,1,669,174,497,7,0,678,30.0,68,51,18.2,1347,False,12,238,1092,16,1,2024-12-19,False,False,False,0.8106904231625836,0.17668893838158872,0.011878247958426132,0.0007423904974016332,Peak,Thursday,December
2024-12-19 13:00:00,60,575,7,1,643,147,318,5,0,470,30.6,65,3,19.9,1113,False,13,207,893,12,1,2024-12-19,False,False,False,0.8023360287511231,0.18598382749326145,0.01078167115902965,0.0008984725965858042,Peak,Thursday,December
2024-12-19 14:00:00,60,561,7,2,630,204,482,6,0,692,29.7,68,53,18.9,1322,False,14,264,1043,13,2,2024-12-19,False,False,False,0.7889561270801816,0.19969742813918306,0.009833585476550681,0.0015128593040847202,Peak,Thursday,December
2024-12-19 15:00:00,61,489,8,1,559,168,376,7,0,551,29.8,70,51,11.9,1110,False,15,229,865,15,1,2024-12-19,False,False,False,0.7792792792792793,0.2063063063063063,0.013513513513513514,0.0009009009009009009,Peak,Thursday,December
2024-12-19 16:00:00,63,512,7,1,583,179,404,6,0,589,30.1,66,51,13.9,1172,False,16,242,916,13,1,2024-12-19,False,False,False,0.7815699658703071,0.20648464163822525,0.011092150170648464,0.0008532423208191126,Peak,Thursday,December
2024-12-19 17:00:00,80,562,8,1,651,204,570,6,0,780,29.3,69,51,12.0,1431,False,17,284,1132,14,1,2024-12-19,False,False,True,0.7910552061495457,0.1984626135569532,0.009783368273934312,0.0006988120195667365,Peak,Thursday,December
2024-12-19 18:00:00,84,583,8,1,676,149,423,6,2,580,28.1,76,61,10.4,1256,False,18,233,1006,14,3,2024-12-19,False,False,False,0.8009554140127388,0.18550955414012738,0.011146496815286623,0.0023885350318471337,Peak,Thursday,December
2024-12-19 19:00:00,61,577,8,1,647,141,496,5,1,643,26.7,86,53,7.1,1290,False,19,202,1073,13,2,2024-12-19,False,False,False,0.8317829457364341,0.15658914728682172,0.010077519379844961,0.0015503875968992248,Peak,Thursday,December
2024-12-19 20:00:00,76,597,8,1,682,187,628,7,1,823,25.5,94,61,9.0,1505,False,20,263,1225,15,2,2024-12-19,False,False,True,0.813953488372093,0.17475083056478405,0.009966777408637873,0.00132890365448505,Shoulder,Thursday,December
2024-12-19 21:00:00,60,478,8,1,547,190,433,7,1,631,25.5,97,61,5.0,1178,False,21,250,911,15,2,2024-12-19,False,False,False,0.7733446519524618,0.21222410865874364,0.012733446519524618,0.001697792869269949,Shoulder,Thursday,December
2024-12-19 22:00:00,72,489,8,1,570,191,440,7,1,639,25.6,96,53,5.1,1209,False,22,263,929,15,2,2024-12-19,False,False,False,0.7684036393713813,0.21753515301902399,0.01240694789081886,0.0016542597187758478,Shoulder,Thursday,December
2024-12-19 23:00:00,78,526,10,1,615,170,380,7,1,558,25.2,97,53,8.2,1173,False,23,248,906,17,2,2024-12-19,False,False,False,0.7723785166240409,0.21142369991474852,0.014492753623188406,0.0017050298380221654,Shoulder,Thursday,December
2024-12-20 00:00:00,135,744,16,1,896,233,237,6,2,478,24.9,97,61,6.3,1374,False,0,368,981,22,3,2024-12-20,False,False,True,0.7139737991266376,0.2678311499272198,0.01601164483260553,0.002183406113537118,Off-Peak,Friday,December
2024-12-20 01:00:00,115,532,12,1,660,205,263,6,1,475,24.7,97,61,8.6,1135,False,1,320,795,18,2,2024-12-20,False,False,False,0.7004405286343612,0.28193832599118945,0.015859030837004406,0.001762114537444934,Off-Peak,Friday,December
2024-12-20 02:00:00,129,311,15,1,456,180,111,4,1,296,24.5,95,53,15.4,752,False,2,309,422,19,2,2024-12-20,False,False,False,0.5611702127659575,0.4109042553191489,0.02526595744680851,0.0026595744680851063,Off-Peak,Friday,December
2024-12-20 03:00:00,105,391,11,1,508,176,110,4,1,291,24.4,94,51,14.0,799,False,3,281,501,15,2,2024-12-20,False,False,False,0.6270337922403004,0.35168961201501875,0.01877346683354193,0.0025031289111389237,Off-Peak,Friday,December
2024-12-20 04:00:00,114,305,12,1,432,225,112,5,1,343,24.0,94,3,14.5,775,False,4,339,417,17,2,2024-12-20,False,False,False,0.5380645161290323,0.4374193548387097,0.02193548387096774,0.0025806451612903226,Off-Peak,Friday,December
2024-12-20 05:00:00,89,421,10,1,521,168,186,5,1,360,23.8,94,3,14.1,881,False,5,257,607,15,2,2024-12-20,False,False,False,0.6889897843359818,0.2917139614074915,0.0170261066969353,0.0022701475595913734,Shoulder,Friday,December
2024-12-20 06:00:00,112,586,13,1,712,223,313,5,1,542,23.7,94,3,14.1,1254,False,6,335,899,18,2,2024-12-20,False,False,False,0.7169059011164274,0.2671451355661882,0.014354066985645933,0.001594896331738437,Shoulder,Friday,December
2024-12-20 07:00:00,99,698,12,1,810,179,509,5,1,694,23.7,92,3,10.8,1504,False,7,278,1207,17,2,2024-12-20,False,False,True,0.8025265957446809,0.1848404255319149,0.011303191489361703,0.0013297872340425532,Peak,Friday,December
2024-12-20 08:00:00,123,725,14,2,864,183,525,4,1,713,24.4,89,3,10.4,1577,False,8,306,1250,18,3,2024-12-20,False,False,True,0.7926442612555485,0.19403931515535827,0.011414077362079899,0.0019023462270133164,Peak,Friday,December
2024-12-20 09:00:00,107,832,13,1,953,215,486,5,1,707,25.3,92,51,9.9,1660,False,9,322,1318,18,2,2024-12-20,False,False,True,0.7939759036144578,0.19397590361445782,0.010843373493975903,0.0012048192771084338,Shoulder,Friday,December
2024-12-20 10:00:00,112,870,14,1,997,164,478,4,1,647,26.2,88,51,13.9,1644,False,10,276,1348,18,2,2024-12-20,False,False,True,0.8199513381995134,0.1678832116788321,0.010948905109489052,0.0012165450121654502,Shoulder,Friday,December
2024-12-20 11:00:00,104,809,12,1,926,195,551,4,1,751,27.2,82,51,15.6,1677,False,11,299,1360,16,2,2024-12-20,False,False,True,0.8109719737626714,0.17829457364341086,0.009540846750149075,0.0011926058437686344,Peak,Friday,December
2024-12-20 12:00:00,98,562,11,1,672,178,498,5,1,682,27.7,79,51,15.6,1354,False,12,276,1060,16,2,2024-12-20,False,False,False,0.7828655834564254,0.2038404726735598,0.011816838995568686,0.0014771048744460858,Peak,Friday,December
2024-12-20 13:00:00,100,598,11,1,710,186,426,4,1,617,28.6,74,51,16.1,1327,False,13,286,1024,15,2,2024-12-20,False,False,False,0.771665410700829,0.2155237377543331,0.011303692539562924,0.0015071590052750565,Peak,Friday,December
2024-12-20 14:00:00,134,837,15,1,987,175,301,5,1,482,29.6,72,51,13.0,1469,False,14,309,1138,20,2,2024-12-20,False,False,True,0.7746766507828454,0.21034717494894487,0.013614703880190605,0.0013614703880190605,Peak,Friday,December
2024-12-20 15:00:00,116,722,14,1,853,190,333,5,1,529,28.7,72,53,14.1,1382,False,15,306,1055,19,2,2024-12-20,False,False,True,0.7633863965267728,0.22141823444283648,0.013748191027496382,0.001447178002894356,Peak,Friday,December
2024-12-20 16:00:00,123,721,15,1,860,176,307,5,1,489,29.1,74,51,12.4,1349,False,16,299,1028,20,2,2024-12-20,False,False,False,0.7620459599703484,0.22164566345441067,0.014825796886582653,0.0014825796886582653,Peak,Friday,December
2024-12-20 17:00:00,115,878,13,1,1007,182,316,6,1,505,28.9,73,51,12.9,1512,False,17,297,1194,19,2,2024-12-20,False,False,True,0.7896825396825397,0.19642857142857142,0.012566137566137565,0.0013227513227513227,Peak,Friday,December
2024-12-20 18:00:00,116,898,15,1,1030,203,367,7,2,579,28.4,74,3,10.6,1609,False,18,319,1265,22,3,2024-12-20,False,False,True,0.786202610316967,0.19825978868862648,0.013673088875077687,0.0018645121193287756,Peak,Friday,December
2024-12-20 19:00:00,103,893,12,2,1010,181,317,6,2,506,27.2,83,51,10.2,1516,False,19,284,1210,18,4,2024-12-20,False,False,True,0.7981530343007915,0.18733509234828497,0.011873350923482849,0.002638522427440633,Peak,Friday,December
2024-12-20 20:00:00,93,742,13,3,851,249,468,7,2,726,25.8,90,51,7.6,1577,False,20,342,1210,20,5,2024-12-20,False,False,True,0.7672796448953709,0.21686746987951808,0.012682308180088777,0.0031705770450221942,Shoulder,Friday,December
2024-12-20 21:00:00,113,679,15,2,809,201,361,6,2,570,24.9,96,63,13.8,1379,False,21,314,1040,21,4,2024-12-20,False,False,True,0.7541696881798404,0.22770123277737492,0.015228426395939087,0.0029006526468455403,Shoulder,Friday,December
2024-12-20 22:00:00,125,770,16,2,913,247,468,7,2,724,24.7,97,55,10.6,1637,False,22,372,1238,23,4,2024-12-20,False,False,True,0.7562614538790471,0.2272449602932193,0.014050091631032376,0.002443494196701283,Shoulder,Friday,December
2024-12-20 23:00:00,127,780,16,2,925,245,459,8,2,714,24.6,96,51,10.7,1639,False,23,372,1239,24,4,2024-12-20,False,False,True,0.7559487492373398,0.22696766320927395,0.01464307504575961,0.0024405125076266015,Shoulder,Friday,December
2024-12-21 00:00:00,104,604,12,0,720,259,423,5,1,688,24.3,96,51,12.9,1408,True,0,363,1027,17,1,2024-12-21,False,False,True,0.7294034090909091,0.2578125,0.012073863636363636,0.0007102272727272727,Off-Peak,Saturday,December
2024-12-21 01:00:00,119,540,12,1,672,327,285,8,2,622,24.2,96,51,11.9,1294,True,1,446,825,20,3,2024-12-21,False,False,False,0.6375579598145286,0.3446676970633694,0.015455950540958269,0.00231839258114374,Off-Peak,Saturday,December
2024-12-21 02:00:00,136,350,14,1,501,288,301,7,2,598,24.1,97,3,13.7,1099,True,2,424,651,21,3,2024-12-21,False,False,False,0.5923566878980892,0.38580527752502275,0.01910828025477707,0.00272975432211101,Off-Peak,Saturday,December
2024-12-21 03:00:00,109,353,10,1,473,238,309,7,2,556,24.2,97,3,14.3,1029,True,3,347,662,17,3,2024-12-21,False,False,False,0.6433430515063168,0.337220602526725,0.01652089407191448,0.0029154518950437317,Off-Peak,Saturday,December
2024-12-21 04:00:00,103,239,10,1,353,222,462,8,2,694,24.1,97,3,12.6,1047,True,4,325,701,18,3,2024-12-21,False,False,False,0.6695319961795606,0.3104106972301815,0.017191977077363897,0.0028653295128939827,Off-Peak,Saturday,December
2024-12-21 05:00:00,107,447,11,1,566,259,432,7,2,700,23.9,98,3,11.9,1266,True,5,366,879,18,3,2024-12-21,False,False,False,0.6943127962085308,0.2890995260663507,0.014218009478672985,0.002369668246445498,Shoulder,Saturday,December
2024-12-21 06:00:00,108,535,12,1,656,290,602,7,3,902,23.6,98,3,9.0,1558,True,6,398,1137,19,4,2024-12-21,False,False,True,0.7297817715019256,0.2554557124518614,0.012195121951219513,0.0025673940949935813,Shoulder,Saturday,December
2024-12-21 07:00:00,105,632,12,1,750,290,795,6,2,1093,23.5,98,3,9.1,1843,True,7,395,1427,18,3,2024-12-21,False,False,True,0.7742810634834509,0.21432447097124255,0.009766684753119913,0.0016277807921866521,Peak,Saturday,December
2024-12-21 08:00:00,98,694,11,2,805,353,643,7,2,1005,24.3,94,3,9.4,1810,True,8,451,1337,18,4,2024-12-21,False,False,True,0.7386740331491712,0.24917127071823206,0.009944751381215469,0.0022099447513812156,Peak,Saturday,December
2024-12-21 09:00:00,108,753,11,1,873,298,711,7,3,1019,25.9,91,51,13.3,1892,True,9,406,1464,18,4,2024-12-21,False,False,True,0.773784355179704,0.21458773784355178,0.009513742071881607,0.0021141649048625794,Shoulder,Saturday,December
2024-12-21 10:00:00,104,824,10,1,939,342,619,7,2,970,27.2,84,2,14.6,1909,True,10,446,1443,17,3,2024-12-21,False,False,True,0.7558931377684651,0.23363017286537455,0.00890518596123625,0.001571503404924044,Shoulder,Saturday,December
2024-12-21 11:00:00,119,819,11,1,950,492,702,7,3,1204,28.7,75,51,14.7,2154,True,11,611,1521,18,4,2024-12-21,False,False,True,0.7061281337047354,0.28365831012070564,0.008356545961002786,0.0018570102135561746,Peak,Saturday,December
2024-12-21 12:00:00,104,847,11,1,963,308,532,7,2,849,29.0,73,51,13.0,1812,True,12,412,1379,18,3,2024-12-21,False,False,True,0.7610375275938189,0.22737306843267108,0.009933774834437087,0.0016556291390728477,Peak,Saturday,December
2024-12-21 13:00:00,142,879,14,1,1036,326,575,7,2,910,29.4,71,3,12.6,1946,True,13,468,1454,21,3,2024-12-21,False,False,True,0.7471736896197327,0.24049331963001028,0.01079136690647482,0.001541623843782117,Peak,Saturday,December
2024-12-21 14:00:00,104,880,10,1,995,285,486,8,2,781,28.5,75,51,12.9,1776,True,14,389,1366,18,3,2024-12-21,False,False,True,0.7691441441441441,0.21903153153153154,0.010135135135135136,0.0016891891891891893,Peak,Saturday,December
2024-12-21 15:00:00,133,855,14,1,1003,291,507,8,2,808,27.4,82,51,14.3,1811,True,15,424,1362,22,3,2024-12-21,False,False,True,0.7520706791827719,0.23412479293208172,0.012147984538928768,0.0016565433462175593,Peak,Saturday,December
2024-12-21 16:00:00,102,868,14,1,985,339,701,8,2,1050,26.7,86,53,15.8,2035,True,16,441,1569,22,3,2024-12-21,False,False,True,0.771007371007371,0.2167076167076167,0.010810810810810811,0.0014742014742014742,Peak,Saturday,December
2024-12-21 17:00:00,121,773,14,1,909,269,453,7,2,731,27.4,81,51,15.0,1640,True,17,390,1226,21,3,2024-12-21,False,False,True,0.7475609756097561,0.23780487804878048,0.012804878048780487,0.001829268292682927,Peak,Saturday,December
2024-12-21 18:00:00,111,872,13,1,997,299,513,8,2,822,27.0,84,3,12.7,1819,True,18,410,1385,21,3,2024-12-21,False,False,True,0.7614073666849918,0.22539857064321056,0.01154480483782298,0.0016492578339747114,Peak,Saturday,December
2024-12-21 19:00:00,120,748,12,1,881,364,664,8,2,1038,26.1,90,3,11.4,1919,True,19,484,1412,20,3,2024-12-21,False,False,True,0.7357998957790516,0.2522146951537259,0.010422094841063054,0.001563314226159458,Peak,Saturday,December
2024-12-21 20:00:00,130,819,14,1,964,361,648,8,3,1020,25.4,92,3,12.2,1984,True,20,491,1467,22,4,2024-12-21,False,False,True,0.7394153225806451,0.2474798387096774,0.011088709677419355,0.0020161290322580645,Shoulder,Saturday,December
2024-12-21 21:00:00,120,731,15,3,869,328,581,9,3,921,25.8,91,3,15.3,1790,True,21,448,1312,24,6,2024-12-21,False,False,True,0.7329608938547486,0.25027932960893856,0.013407821229050279,0.0033519553072625698,Shoulder,Saturday,December
2024-12-21 22:00:00,97,660,12,2,771,250,402,8,3,663,25.6,90,3,14.3,1434,True,22,347,1062,20,5,2024-12-21,False,False,True,0.7405857740585774,0.2419804741980474,0.01394700139470014,0.003486750348675035,Shoulder,Saturday,December
2024-12-21 23:00:00,117,781,12,2,912,278,467,8,3,756,25.1,90,3,15.0,1668,True,23,395,1248,20,5,2024-12-21,False,False,True,0.7482014388489209,0.236810551558753,0.011990407673860911,0.002997601918465228,Shoulder,Saturday,December
2024-12-22 00:00:00,12,383,10,0,405,253,330,10,2,595,24.8,91,3,17.1,1000,True,0,265,713,20,2,2024-12-22,False,False,False,0.713,0.265,0.02,0.002,Off-Peak,Sunday,December
2024-12-22 01:00:00,92,550,9,0,651,383,461,8,1,853,24.7,90,3,16.7,1504,True,1,475,1011,17,1,2024-12-22,False,False,True,0.6722074468085106,0.3158244680851064,0.011303191489361703,0.0006648936170212766,Off-Peak,Sunday,December
2024-12-22 02:00:00,22,457,13,0,492,244,413,8,1,666,24.6,89,3,17.6,1158,True,2,266,870,21,1,2024-12-22,False,False,False,0.7512953367875648,0.229706390328152,0.018134715025906734,0.0008635578583765112,Off-Peak,Sunday,December
2024-12-22 03:00:00,39,599,12,0,650,223,366,8,2,599,24.5,89,3,15.5,1249,True,3,262,965,20,2,2024-12-22,False,False,False,0.7726180944755805,0.20976781425140112,0.016012810248198558,0.0016012810248198558,Off-Peak,Sunday,December
2024-12-22 04:00:00,89,521,10,1,621,300,562,7,2,871,24.2,90,3,19.5,1492,True,4,389,1083,17,3,2024-12-22,False,False,True,0.7258713136729222,0.26072386058981234,0.011394101876675604,0.0020107238605898124,Off-Peak,Sunday,December
2024-12-22 05:00:00,126,784,12,1,923,452,937,10,2,1401,24.1,90,3,17.1,2324,True,5,578,1721,22,3,2024-12-22,False,False,True,0.7405335628227194,0.2487091222030981,0.00946643717728055,0.0012908777969018934,Shoulder,Sunday,December
2024-12-22 06:00:00,103,629,11,1,744,440,894,9,2,1345,23.9,92,3,15.1,2089,True,6,543,1523,20,3,2024-12-22,False,False,True,0.7290569650550502,0.2599329822881762,0.009573958831977022,0.0014360938247965534,Shoulder,Sunday,December
2024-12-22 07:00:00,195,964,10,1,1170,373,844,8,2,1227,23.6,94,3,12.5,2397,True,7,568,1808,18,3,2024-12-22,False,False,True,0.754276178556529,0.2369628702544848,0.007509386733416771,0.0012515644555694619,Peak,Sunday,December
2024-12-22 08:00:00,141,908,14,1,1064,417,839,8,2,1266,24.0,93,3,12.0,2330,True,8,558,1747,22,3,2024-12-22,False,False,True,0.7497854077253219,0.23948497854077253,0.00944206008583691,0.0012875536480686696,Peak,Sunday,December
2024-12-22 09:00:00,135,845,14,1,995,410,819,8,2,1239,26.0,90,53,12.6,2234,True,9,545,1664,22,3,2024-12-22,False,False,True,0.7448522829006267,0.2439570277529096,0.009847806624888093,0.0013428827215756492,Shoulder,Sunday,December
2024-12-22 10:00:00,226,801,13,1,1041,570,1036,10,3,1619,27.2,83,51,16.9,2660,True,10,796,1837,23,4,2024-12-22,False,False,True,0.6906015037593985,0.2992481203007519,0.008646616541353383,0.0015037593984962407,Shoulder,Sunday,December
2024-12-22 11:00:00,138,883,14,1,1036,352,994,7,2,1355,27.8,78,51,14.9,2391,True,11,490,1877,21,3,2024-12-22,False,False,True,0.7850271852781263,0.20493517356754495,0.00878293601003764,0.0012547051442910915,Peak,Sunday,December
2024-12-22 12:00:00,194,1038,12,1,1245,302,867,8,2,1179,28.4,75,51,12.7,2424,True,12,496,1905,20,3,2024-12-22,False,False,True,0.7858910891089109,0.20462046204620463,0.00825082508250825,0.0012376237623762376,Peak,Sunday,December
2024-12-22 13:00:00,131,825,14,2,972,413,825,9,2,1249,29.5,71,51,13.1,2221,True,13,544,1650,23,4,2024-12-22,False,False,True,0.7429085997298515,0.24493471409275103,0.010355695632597929,0.0018009905447996398,Peak,Sunday,December
2024-12-22 14:00:00,136,869,13,1,1019,525,924,7,2,1458,29.8,71,51,9.9,2477,True,14,661,1793,20,3,2024-12-22,False,False,True,0.7238595074687122,0.2668550666128381,0.008074283407347598,0.0012111425111021397,Peak,Sunday,December
2024-12-22 15:00:00,121,753,13,2,889,303,874,6,2,1185,30.5,69,51,6.8,2074,True,15,424,1627,19,4,2024-12-22,False,False,True,0.7844744455159113,0.20443587270973965,0.009161041465766635,0.0019286403085824494,Peak,Sunday,December
2024-12-22 16:00:00,121,757,13,1,892,500,875,7,2,1384,29.9,71,3,8.1,2276,True,16,621,1632,20,3,2024-12-22,False,False,True,0.7170474516695958,0.2728471001757469,0.008787346221441126,0.0013181019332161687,Peak,Sunday,December
2024-12-22 17:00:00,130,817,12,1,960,452,924,10,2,1388,28.0,78,51,9.5,2348,True,17,582,1741,22,3,2024-12-22,False,False,True,0.7414821124361158,0.24787052810902896,0.009369676320272573,0.0012776831345826234,Peak,Sunday,December
2024-12-22 18:00:00,110,658,11,1,780,345,674,8,2,1029,27.8,78,3,8.1,1809,True,18,455,1332,19,3,2024-12-22,False,False,True,0.736318407960199,0.25152017689331124,0.010503040353786623,0.001658374792703151,Peak,Sunday,December
2024-12-22 19:00:00,116,711,13,1,841,404,801,11,2,1218,26.6,84,3,10.8,2059,True,19,520,1512,24,3,2024-12-22,False,False,True,0.7343370568237009,0.2525497814473045,0.011656143759106362,0.0014570179698882952,Peak,Sunday,December
2024-12-22 20:00:00,113,683,13,1,810,397,794,10,2,1203,25.5,89,3,11.3,2013,True,20,510,1477,23,3,2024-12-22,False,False,True,0.7337307501241928,0.2533532041728763,0.011425732737208148,0.0014903129657228018,Shoulder,Sunday,December
2024-12-22 21:00:00,103,610,11,1,725,325,618,8,2,953,26.2,89,51,7.5,1678,True,21,428,1228,19,3,2024-12-22,False,False,True,0.7318235995232419,0.2550655542312277,0.01132300357568534,0.0017878426698450535,Shoulder,Sunday,December
2024-12-22 22:00:00,102,620,12,1,735,396,801,11,2,1210,25.9,90,3,12.1,1945,True,22,498,1421,23,3,2024-12-22,False,False,True,0.7305912596401029,0.25604113110539845,0.011825192802056555,0.0015424164524421595,Shoulder,Sunday,December
2024-12-22 23:00:00,83,481,11,1,576,328,637,9,2,976,25.4,91,3,13.6,1552,True,23,411,1118,20,3,2024-12-22,False,False,True,0.720360824742268,0.264819587628866,0.01288659793814433,0.0019329896907216496,Shoulder,Sunday,December
2024-12-23 00:00:00,159,372,14,1,546,416,418,4,1,839,25.1,90,3,15.7,1385,False,0,575,790,18,2,2024-12-23,False,False,True,0.5703971119133574,0.4151624548736462,0.012996389891696752,0.001444043321299639,Off-Peak,Monday,December
2024-12-23 01:00:00,109,648,10,1,768,264,534,4,2,804,25.0,89,3,15.4,1572,False,1,373,1182,14,3,2024-12-23,False,False,True,0.7519083969465649,0.23727735368956743,0.008905852417302799,0.0019083969465648854,Off-Peak,Monday,December
2024-12-23 02:00:00,120,724,11,1,856,309,438,5,3,755,24.8,89,3,14.8,1611,False,2,429,1162,16,4,2024-12-23,False,False,True,0.7212911235257604,0.26629422718808193,0.009931719428926133,0.002482929857231533,Off-Peak,Monday,December
2024-12-23 03:00:00,131,775,14,1,921,365,591,4,2,962,24.7,89,3,17.1,1883,False,3,496,1366,18,3,2024-12-23,False,False,True,0.7254381306425917,0.2634094530005311,0.009559214020180564,0.0015932023366967605,Off-Peak,Monday,December
2024-12-23 04:00:00,151,655,15,1,822,386,544,4,2,936,24.7,88,3,16.1,1758,False,4,537,1199,19,3,2024-12-23,False,False,True,0.6820250284414107,0.3054607508532423,0.01080773606370876,0.0017064846416382253,Off-Peak,Monday,December
2024-12-23 05:00:00,144,894,13,1,1052,438,964,4,2,1408,24.6,88,3,16.2,2460,False,5,582,1858,17,3,2024-12-23,False,False,True,0.7552845528455284,0.23658536585365852,0.006910569105691057,0.0012195121951219512,Shoulder,Monday,December
2024-12-23 06:00:00,142,880,13,1,1036,340,727,4,1,1072,24.4,89,1,14.5,2108,False,6,482,1607,17,2,2024-12-23,False,False,True,0.7623339658444023,0.2286527514231499,0.008064516129032258,0.0009487666034155598,Shoulder,Monday,December
2024-12-23 07:00:00,105,895,10,1,1011,319,675,4,2,1000,24.2,90,0,11.8,2011,False,7,424,1570,14,3,2024-12-23,False,False,True,0.7807061163600199,0.21084037792143212,0.0069617105917454,0.0014917951268025858,Peak,Monday,December
2024-12-23 08:00:00,145,913,14,1,1073,288,889,4,2,1183,24.7,90,3,8.1,2256,False,8,433,1802,18,3,2024-12-23,False,False,True,0.7987588652482269,0.19193262411347517,0.007978723404255319,0.0013297872340425532,Peak,Monday,December
2024-12-23 09:00:00,157,995,14,1,1167,325,687,4,2,1018,26.8,82,3,14.6,2185,False,9,482,1682,18,3,2024-12-23,False,False,True,0.7697940503432494,0.2205949656750572,0.008237986270022883,0.0013729977116704805,Shoulder,Monday,December
2024-12-23 10:00:00,156,978,17,1,1152,364,1002,5,3,1374,28.3,75,3,16.4,2526,False,10,520,1980,22,4,2024-12-23,False,False,True,0.7838479809976246,0.2058590657165479,0.00870942201108472,0.001583531274742676,Shoulder,Monday,December
2024-12-23 11:00:00,138,805,13,1,957,311,841,4,2,1158,29.3,69,51,15.0,2115,False,11,449,1646,17,3,2024-12-23,False,False,True,0.7782505910165485,0.21229314420803783,0.008037825059101654,0.0014184397163120568,Peak,Monday,December
2024-12-23 12:00:00,128,1049,13,1,1191,376,825,4,2,1207,29.4,68,51,12.2,2398,False,12,504,1874,17,3,2024-12-23,False,False,True,0.7814845704753962,0.21017514595496248,0.007089241034195163,0.0012510425354462051,Peak,Monday,December
2024-12-23 13:00:00,130,1080,12,1,1223,308,635,5,3,951,30.0,70,51,8.6,2174,False,13,438,1715,17,4,2024-12-23,False,False,True,0.7888684452621895,0.2014719411223551,0.0078196872125115,0.0018399264029438822,Peak,Monday,December
2024-12-23 14:00:00,142,853,13,1,1009,380,814,4,2,1200,29.7,70,51,7.5,2209,False,14,522,1667,17,3,2024-12-23,False,False,True,0.7546401086464464,0.23630602082390223,0.007695789950203712,0.001358080579447714,Peak,Monday,December
2024-12-23 15:00:00,136,844,13,1,994,286,1079,4,3,1372,27.0,86,65,9.2,2366,False,15,422,1923,17,4,2024-12-23,False,False,True,0.812764158918005,0.17836010143702452,0.007185122569737954,0.0016906170752324597,Peak,Monday,December
2024-12-23 16:00:00,109,609,10,1,729,403,890,5,3,1301,26.9,85,63,8.5,2030,False,16,512,1499,15,4,2024-12-23,False,False,True,0.738423645320197,0.2522167487684729,0.007389162561576354,0.0019704433497536944,Peak,Monday,December
2024-12-23 17:00:00,153,960,16,3,1132,426,948,4,3,1381,26.6,90,61,9.5,2513,False,17,579,1908,20,6,2024-12-23,False,False,True,0.7592518901711103,0.23040191006764824,0.007958615200955034,0.00238758456028651,Peak,Monday,December
2024-12-23 18:00:00,118,710,12,2,842,269,546,5,4,824,26.0,92,61,5.7,1666,False,18,387,1256,17,6,2024-12-23,False,False,True,0.7539015606242497,0.23229291716686676,0.01020408163265306,0.003601440576230492,Peak,Monday,December
2024-12-23 19:00:00,158,994,15,2,1169,289,587,4,3,883,25.6,96,53,3.7,2052,False,19,447,1581,19,5,2024-12-23,False,False,True,0.77046783625731,0.21783625730994152,0.009259259259259259,0.0024366471734892786,Peak,Monday,December
2024-12-23 20:00:00,155,945,16,3,1119,450,1008,4,3,1465,25.3,98,51,4.4,2584,False,20,605,1953,20,6,2024-12-23,False,False,True,0.7558049535603715,0.23413312693498453,0.007739938080495356,0.0023219814241486067,Shoulder,Monday,December
2024-12-23 21:00:00,148,894,15,2,1059,321,674,5,3,1003,25.8,95,51,2.2,2062,False,21,469,1568,20,5,2024-12-23,False,False,True,0.7604267701260912,0.22744907856450047,0.009699321047526674,0.0024248302618816685,Shoulder,Monday,December
2024-12-23 22:00:00,136,821,14,2,973,429,960,4,3,1396,25.2,99,53,8.4,2369,False,22,565,1781,18,5,2024-12-23,False,False,True,0.7517940059096665,0.2384972562262558,0.007598142676234698,0.002110595187842972,Shoulder,Monday,December
2024-12-23 23:00:00,144,869,18,2,1033,256,514,4,3,777,24.8,97,55,9.4,1810,False,23,400,1383,22,5,2024-12-23,False,False,True,0.7640883977900552,0.22099447513812154,0.012154696132596685,0.0027624309392265192,Shoulder,Monday,December
2024-12-24 00:00:00,129,508,10,0,647,312,679,3,1,995,24.6,98,61,10.5,1642,False,0,441,1187,13,1,2024-12-24,False,True,True,0.7228989037758831,0.2685749086479903,0.007917174177831911,0.0006090133982947625,Off-Peak,Tuesday,December
2024-12-24 01:00:00,125,568,12,0,705,383,488,4,2,877,24.5,96,53,11.7,1582,False,1,508,1056,16,2,2024-12-24,False,True,True,0.6675094816687737,0.3211125158027813,0.010113780025284451,0.0012642225031605564,Off-Peak,Tuesday,December
2024-12-24 02:00:00,106,681,9,0,796,288,615,4,2,909,24.2,96,3,13.5,1705,False,2,394,1296,13,2,2024-12-24,False,True,True,0.7601173020527859,0.2310850439882698,0.007624633431085044,0.0011730205278592375,Off-Peak,Tuesday,December
2024-12-24 03:00:00,94,635,8,0,737,267,572,4,2,845,23.9,96,3,15.0,1582,False,3,361,1207,12,2,2024-12-24,False,True,True,0.7629582806573957,0.2281921618204804,0.007585335018963337,0.0012642225031605564,Off-Peak,Tuesday,December
2024-12-24 04:00:00,104,516,9,0,629,301,661,5,3,970,23.9,96,3,14.0,1599,False,4,405,1177,14,3,2024-12-24,False,True,True,0.7360850531582239,0.25328330206378985,0.008755472170106316,0.001876172607879925,Off-Peak,Tuesday,December
2024-12-24 05:00:00,122,872,11,0,1005,255,530,5,2,792,23.9,96,3,14.9,1797,False,5,377,1402,16,2,2024-12-24,False,True,True,0.780189204229271,0.20979410127991097,0.008903728436282694,0.0011129660545353367,Shoulder,Tuesday,December
2024-12-24 06:00:00,95,932,10,1,1038,292,649,4,2,947,23.8,95,3,14.4,1985,False,6,387,1581,14,3,2024-12-24,False,True,True,0.7964735516372796,0.19496221662468513,0.007052896725440806,0.0015113350125944584,Shoulder,Tuesday,December
2024-12-24 07:00:00,121,847,11,1,980,339,761,4,2,1106,23.7,95,3,14.3,2086,False,7,460,1608,15,3,2024-12-24,False,True,True,0.7708533077660594,0.22051773729626079,0.007190795781399808,0.0014381591562799617,Peak,Tuesday,December
2024-12-24 08:00:00,98,846,9,1,954,300,872,4,2,1178,23.9,94,3,14.2,2132,False,8,398,1718,13,3,2024-12-24,False,True,True,0.8058161350844277,0.18667917448405252,0.006097560975609756,0.0014071294559099437,Peak,Tuesday,December
2024-12-24 09:00:00,100,1036,9,1,1146,264,969,4,2,1239,25.5,92,3,14.2,2385,False,9,364,2005,13,3,2024-12-24,False,True,True,0.8406708595387841,0.15262054507337527,0.005450733752620545,0.0012578616352201257,Shoulder,Tuesday,December
2024-12-24 10:00:00,131,953,11,1,1096,388,905,4,2,1299,26.6,88,3,13.8,2395,False,10,519,1858,15,3,2024-12-24,False,True,True,0.7757828810020877,0.21670146137787055,0.006263048016701462,0.0012526096033402922,Shoulder,Tuesday,December
2024-12-24 11:00:00,141,978,12,1,1132,262,868,6,3,1139,28.5,79,3,13.7,2271,False,11,403,1846,18,4,2024-12-24,False,True,True,0.8128577719066491,0.17745486569793043,0.007926023778071334,0.0017613386173491853,Peak,Tuesday,December
2024-12-24 12:00:00,151,1089,15,1,1256,357,826,4,2,1189,28.8,78,51,10.6,2445,False,12,508,1915,19,3,2024-12-24,False,True,True,0.7832310838445807,0.20777096114519428,0.007770961145194274,0.001226993865030675,Peak,Tuesday,December
2024-12-24 13:00:00,136,992,12,1,1141,273,581,4,2,860,28.1,78,51,9.0,2001,False,13,409,1573,16,3,2024-12-24,False,True,True,0.7861069465267366,0.20439780109945027,0.0079960019990005,0.0014992503748125937,Peak,Tuesday,December
2024-12-24 14:00:00,120,846,11,1,978,350,812,4,2,1168,28.0,80,51,10.7,2146,False,14,470,1658,15,3,2024-12-24,False,True,True,0.7726001863932899,0.2190121155638397,0.006989748369058714,0.0013979496738117428,Peak,Tuesday,December
2024-12-24 15:00:00,128,903,14,2,1047,272,580,4,2,858,28.8,77,51,8.1,1905,False,15,400,1483,18,4,2024-12-24,False,True,True,0.7784776902887139,0.2099737532808399,0.009448818897637795,0.002099737532808399,Peak,Tuesday,December
2024-12-24 16:00:00,133,934,12,1,1080,328,727,4,2,1061,29.4,73,51,5.1,2141,False,16,461,1661,16,3,2024-12-24,False,True,True,0.7758056982718355,0.21531994395142456,0.007473143390938813,0.0014012143858010276,Peak,Tuesday,December
2024-12-24 17:00:00,125,881,12,1,1019,432,1030,5,2,1469,29.6,68,3,4.9,2488,False,17,557,1911,17,3,2024-12-24,False,True,True,0.7680868167202572,0.22387459807073956,0.006832797427652733,0.0012057877813504824,Peak,Tuesday,December
2024-12-24 18:00:00,142,1003,13,1,1159,355,815,5,2,1177,28.5,72,3,5.3,2336,False,18,497,1818,18,3,2024-12-24,False,True,True,0.7782534246575342,0.2127568493150685,0.007705479452054794,0.0012842465753424657,Peak,Tuesday,December
2024-12-24 19:00:00,102,669,10,1,782,370,849,5,3,1227,27.1,82,51,4.7,2009,False,19,472,1518,15,4,2024-12-24,False,True,True,0.7555998008959681,0.2349427575908412,0.007466401194624191,0.001991040318566451,Peak,Tuesday,December
2024-12-24 20:00:00,147,1029,13,1,1190,371,861,5,3,1240,25.3,94,51,11.5,2430,False,20,518,1890,18,4,2024-12-24,False,True,True,0.7777777777777778,0.21316872427983538,0.007407407407407408,0.0016460905349794238,Shoulder,Tuesday,December
2024-12-24 21:00:00,129,889,14,1,1033,278,574,6,4,862,24.6,97,63,12.3,1895,False,21,407,1463,20,5,2024-12-24,False,True,True,0.7720316622691293,0.21477572559366753,0.010554089709762533,0.002638522427440633,Shoulder,Tuesday,December
2024-12-24 22:00:00,98,646,11,1,756,407,451,6,3,867,24.3,97,65,7.9,1623,False,22,505,1097,17,4,2024-12-24,False,True,True,0.6759088108441158,0.3111521873074553,0.010474430067775724,0.0024645717806531116,Shoulder,Tuesday,December
2024-12-24 23:00:00,112,735,11,1,859,246,517,6,3,772,24.1,98,63,7.8,1631,False,23,358,1252,17,4,2024-12-24,False,True,True,0.7676272225628449,0.21949724095646841,0.010423053341508276,0.002452483139178418,Shoulder,Tuesday,December
2024-12-25 00:00:00,96,498,6,0,600,223,216,4,0,443,23.9,99,61,9.6,1043,False,0,319,714,10,0,2024-12-25,True,True,False,0.6845637583892618,0.3058485139022052,0.009587727708533078,0.0,Off-Peak,Wednesday,December
2024-12-25 01:00:00,110,533,8,0,651,179,322,5,0,506,23.9,97,53,10.4,1157,False,1,289,855,13,0,2024-12-25,True,True,False,0.7389801210025929,0.2497839239412273,0.011235955056179775,0.0,Off-Peak,Wednesday,December
2024-12-25 02:00:00,107,429,7,0,543,216,397,4,0,617,24.0,97,51,10.5,1160,False,2,323,826,11,0,2024-12-25,True,True,False,0.7120689655172414,0.27844827586206894,0.009482758620689655,0.0,Off-Peak,Wednesday,December
2024-12-25 03:00:00,121,609,8,1,739,211,397,4,1,613,24.0,97,61,8.6,1352,False,3,332,1006,12,2,2024-12-25,True,True,False,0.7440828402366864,0.2455621301775148,0.008875739644970414,0.0014792899408284023,Off-Peak,Wednesday,December
2024-12-25 04:00:00,94,673,6,0,773,225,424,5,2,656,23.9,98,51,8.1,1429,False,4,319,1097,11,2,2024-12-25,True,True,True,0.7676696990902729,0.2232330300909727,0.007697690692792162,0.0013995801259622112,Off-Peak,Wednesday,December
2024-12-25 05:00:00,87,604,7,0,698,239,458,5,1,703,23.9,98,51,7.4,1401,False,5,326,1062,12,1,2024-12-25,True,True,True,0.7580299785867237,0.23269093504639543,0.008565310492505354,0.0007137758743754461,Shoulder,Wednesday,December
2024-12-25 06:00:00,109,833,7,0,949,188,335,4,1,528,23.9,98,51,6.3,1477,False,6,297,1168,11,1,2024-12-25,True,True,True,0.7907921462423833,0.20108327691266079,0.007447528774542992,0.0006770480704129993,Shoulder,Wednesday,December
2024-12-25 07:00:00,107,989,9,0,1105,248,476,5,1,730,23.9,98,51,6.2,1835,False,7,355,1465,14,1,2024-12-25,True,True,True,0.7983651226158038,0.19346049046321526,0.007629427792915531,0.0005449591280653951,Peak,Wednesday,December
2024-12-25 08:00:00,84,1078,7,0,1169,249,480,5,1,735,24.1,98,53,6.0,1904,False,8,333,1558,12,1,2024-12-25,True,True,True,0.8182773109243697,0.17489495798319327,0.0063025210084033615,0.0005252100840336134,Peak,Wednesday,December
2024-12-25 09:00:00,121,896,8,0,1025,236,644,7,1,888,25.1,91,53,7.8,1913,False,9,357,1540,15,1,2024-12-25,True,True,True,0.8050182958703607,0.18661787767903815,0.007841087297438577,0.0005227391531625719,Shoulder,Wednesday,December
2024-12-25 10:00:00,124,951,7,0,1082,259,496,5,1,761,25.3,90,51,10.1,1843,False,10,383,1447,12,1,2024-12-25,True,True,True,0.7851329354313619,0.20781334780249594,0.0065111231687466084,0.0005425935973955507,Shoulder,Wednesday,December
2024-12-25 11:00:00,106,1068,7,0,1181,250,476,5,1,732,26.5,82,53,11.4,1913,False,11,356,1544,12,1,2024-12-25,True,True,True,0.807109252483011,0.1860951385258756,0.006272869837950863,0.0005227391531625719,Peak,Wednesday,December
2024-12-25 12:00:00,109,832,7,0,948,212,389,5,1,607,27.4,77,51,11.5,1555,False,12,321,1221,12,1,2024-12-25,True,True,True,0.7852090032154341,0.20643086816720257,0.0077170418006430866,0.0006430868167202572,Peak,Wednesday,December
2024-12-25 13:00:00,84,786,7,1,878,205,368,4,1,578,27.6,76,3,12.4,1456,False,13,289,1154,11,2,2024-12-25,True,True,True,0.7925824175824175,0.19848901098901098,0.007554945054945055,0.0013736263736263737,Peak,Wednesday,December
2024-12-25 14:00:00,109,811,7,1,928,193,348,4,1,546,27.5,75,3,11.0,1474,False,14,302,1159,11,2,2024-12-25,True,True,True,0.7862957937584804,0.20488466757123475,0.007462686567164179,0.0013568521031207597,Peak,Wednesday,December
2024-12-25 15:00:00,116,892,7,1,1016,163,283,4,1,451,27.3,77,3,9.3,1467,False,15,279,1175,11,2,2024-12-25,True,True,True,0.8009543285616906,0.1901840490797546,0.007498295841854124,0.0013633265167007499,Peak,Wednesday,December
2024-12-25 16:00:00,108,802,7,1,918,252,480,5,1,738,27.4,77,51,9.0,1656,False,16,360,1282,12,2,2024-12-25,True,True,True,0.7741545893719807,0.21739130434782608,0.007246376811594203,0.0012077294685990338,Peak,Wednesday,December
2024-12-25 17:00:00,80,551,7,1,639,216,402,5,1,624,26.8,79,51,7.8,1263,False,17,296,953,12,2,2024-12-25,True,True,False,0.7545526524148852,0.23436262866191607,0.009501187648456057,0.001583531274742676,Peak,Wednesday,December
2024-12-25 18:00:00,117,863,8,1,989,234,437,6,1,678,26.8,79,3,9.1,1667,False,18,351,1300,14,2,2024-12-25,True,True,True,0.7798440311937612,0.21055788842231554,0.008398320335932814,0.0011997600479904018,Peak,Wednesday,December
2024-12-25 19:00:00,95,669,7,1,772,209,384,5,1,599,26.1,84,3,7.9,1371,False,19,304,1053,12,2,2024-12-25,True,True,False,0.7680525164113785,0.22173595915390226,0.0087527352297593,0.0014587892049598833,Peak,Wednesday,December
2024-12-25 20:00:00,84,587,7,1,679,228,422,6,1,657,25.6,87,3,8.8,1336,False,20,312,1009,13,2,2024-12-25,True,True,False,0.7552395209580839,0.23353293413173654,0.009730538922155689,0.0014970059880239522,Shoulder,Wednesday,December
2024-12-25 21:00:00,116,859,8,1,984,178,319,5,1,503,25.1,93,51,9.3,1487,False,21,294,1178,13,2,2024-12-25,True,True,True,0.7921990585070612,0.1977135171486214,0.008742434431741762,0.0013449899125756557,Shoulder,Wednesday,December
2024-12-25 22:00:00,108,780,10,1,899,222,416,7,1,646,25.0,95,51,8.2,1545,False,22,330,1196,17,2,2024-12-25,True,True,True,0.7741100323624596,0.21359223300970873,0.011003236245954692,0.0012944983818770227,Shoulder,Wednesday,December
2024-12-25 23:00:00,99,682,9,1,791,220,397,6,1,624,25.0,96,53,7.4,1415,False,23,319,1079,15,2,2024-12-25,True,True,True,0.7625441696113074,0.2254416961130742,0.01060070671378092,0.0014134275618374558,Shoulder,Wednesday,December
2024-12-26 00:00:00,82,466,11,0,559,251,338,7,0,596,24.8,98,55,10.3,1155,False,0,333,804,18,0,2024-12-26,False,False,False,0.6961038961038961,0.2883116883116883,0.015584415584415584,0.0,Off-Peak,Thursday,December
2024-12-26 01:00:00,103,313,8,0,424,144,220,6,0,370,24.8,96,51,10.0,794,False,1,247,533,14,0,2024-12-26,False,False,False,0.6712846347607053,0.3110831234256927,0.017632241813602016,0.0,Off-Peak,Thursday,December
2024-12-26 02:00:00,81,334,7,0,422,135,304,6,0,445,24.6,95,51,11.4,867,False,2,216,638,13,0,2024-12-26,False,False,False,0.7358708189158016,0.2491349480968858,0.014994232987312572,0.0,Off-Peak,Thursday,December
2024-12-26 03:00:00,116,438,11,0,565,149,230,8,0,387,24.5,94,51,11.0,952,False,3,265,668,19,0,2024-12-26,False,False,False,0.7016806722689075,0.27836134453781514,0.01995798319327731,0.0,Off-Peak,Thursday,December
2024-12-26 04:00:00,107,869,8,0,984,227,380,7,0,614,24.4,93,51,10.3,1598,False,4,334,1249,15,0,2024-12-26,False,False,True,0.781602002503129,0.20901126408010012,0.009386733416770964,0.0,Off-Peak,Thursday,December
2024-12-26 05:00:00,75,545,7,0,627,172,274,5,0,451,24.3,94,51,9.0,1078,False,5,247,819,12,0,2024-12-26,False,False,False,0.7597402597402597,0.22912801484230055,0.011131725417439703,0.0,Shoulder,Thursday,December
2024-12-26 06:00:00,96,756,9,0,861,215,363,8,0,586,24.2,94,3,9.1,1447,False,6,311,1119,17,0,2024-12-26,False,False,True,0.7733241188666206,0.21492743607463718,0.011748445058742226,0.0,Shoulder,Thursday,December
2024-12-26 07:00:00,81,1105,7,0,1193,231,392,7,0,630,24.2,94,3,9.7,1823,False,7,312,1497,14,0,2024-12-26,False,False,True,0.8211738891936369,0.17114646187602853,0.007679648930334613,0.0,Peak,Thursday,December
2024-12-26 08:00:00,114,917,10,0,1041,213,358,8,0,579,24.4,94,3,9.9,1620,False,8,327,1275,18,0,2024-12-26,False,False,True,0.7870370370370371,0.20185185185185187,0.011111111111111112,0.0,Peak,Thursday,December
2024-12-26 09:00:00,116,817,7,0,940,358,554,7,1,920,25.9,93,51,6.4,1860,False,9,474,1371,14,1,2024-12-26,False,False,True,0.7370967741935484,0.25483870967741934,0.007526881720430108,0.0005376344086021505,Shoulder,Thursday,December
2024-12-26 10:00:00,114,919,10,1,1044,227,381,8,1,617,26.8,89,51,6.7,1661,False,10,341,1300,18,2,2024-12-26,False,False,True,0.7826610475617098,0.2052980132450331,0.010836845273931367,0.0012040939193257074,Shoulder,Thursday,December
2024-12-26 11:00:00,102,935,11,1,1049,209,452,7,1,669,27.5,84,3,8.5,1718,False,11,311,1387,18,2,2024-12-26,False,False,True,0.8073341094295693,0.1810244470314319,0.010477299185098952,0.0011641443538998836,Peak,Thursday,December
2024-12-26 12:00:00,102,1091,8,1,1202,288,407,6,1,702,28.1,79,3,7.6,1904,False,12,390,1498,14,2,2024-12-26,False,False,True,0.7867647058823529,0.20483193277310924,0.007352941176470588,0.0010504201680672268,Peak,Thursday,December
2024-12-26 13:00:00,113,866,11,1,991,216,360,7,1,584,28.6,74,3,7.6,1575,False,13,329,1226,18,2,2024-12-26,False,False,True,0.7784126984126984,0.2088888888888889,0.011428571428571429,0.0012698412698412698,Peak,Thursday,December
2024-12-26 14:00:00,96,922,9,2,1029,178,390,6,1,575,29.2,72,51,8.8,1604,False,14,274,1312,15,3,2024-12-26,False,False,True,0.8179551122194514,0.1708229426433915,0.009351620947630923,0.0018703241895261845,Peak,Thursday,December
2024-12-26 15:00:00,97,838,8,1,944,243,412,7,1,663,29.9,69,3,10.0,1607,False,15,340,1250,15,2,2024-12-26,False,False,True,0.7778469197261979,0.21157436216552583,0.009334163036714374,0.0012445550715619166,Peak,Thursday,December
2024-12-26 16:00:00,88,852,9,1,950,254,438,7,1,700,29.5,71,51,9.0,1650,False,16,342,1290,16,2,2024-12-26,False,False,True,0.7818181818181819,0.20727272727272728,0.009696969696969697,0.0012121212121212121,Peak,Thursday,December
2024-12-26 17:00:00,122,983,11,1,1117,163,257,6,1,427,29.1,72,51,7.4,1544,False,17,285,1240,17,2,2024-12-26,False,False,True,0.8031088082901554,0.18458549222797926,0.011010362694300517,0.0012953367875647669,Peak,Thursday,December
2024-12-26 18:00:00,86,644,8,1,739,171,274,6,1,452,29.0,71,51,5.1,1191,False,18,257,918,14,2,2024-12-26,False,False,False,0.7707808564231738,0.21578505457598657,0.011754827875734676,0.0016792611251049538,Peak,Thursday,December
2024-12-26 19:00:00,107,837,11,1,956,173,281,10,2,466,28.1,80,51,2.8,1422,False,19,280,1118,21,3,2024-12-26,False,False,True,0.7862165963431786,0.19690576652601968,0.014767932489451477,0.002109704641350211,Peak,Thursday,December
2024-12-26 20:00:00,88,634,8,1,731,254,443,8,1,706,27.2,85,3,2.8,1437,False,20,342,1077,16,2,2024-12-26,False,False,True,0.7494780793319415,0.23799582463465555,0.011134307585247043,0.0013917884481558804,Shoulder,Thursday,December
2024-12-26 21:00:00,111,876,11,1,999,162,255,7,1,425,26.5,84,3,4.8,1424,False,21,273,1131,18,2,2024-12-26,False,False,True,0.7942415730337079,0.19171348314606743,0.012640449438202247,0.0014044943820224719,Shoulder,Thursday,December
2024-12-26 22:00:00,86,621,10,1,718,265,459,8,1,733,26.1,86,3,4.2,1451,False,22,351,1080,18,2,2024-12-26,False,False,True,0.7443142660234321,0.24190213645761544,0.012405237767057202,0.0013783597518952446,Shoulder,Thursday,December
2024-12-26 23:00:00,118,925,13,1,1057,190,308,8,1,507,25.9,87,3,3.6,1564,False,23,308,1233,21,2,2024-12-26,False,False,True,0.7883631713554987,0.1969309462915601,0.013427109974424553,0.0012787723785166241,Shoulder,Thursday,December
2024-12-27 00:00:00,99,425,10,0,534,206,410,5,2,623,25.6,88,3,5.2,1157,False,0,305,835,15,2,2024-12-27,False,False,False,0.7216940363007779,0.2636127917026793,0.01296456352636128,0.001728608470181504,Off-Peak,Friday,December
2024-12-27 01:00:00,116,379,12,1,508,220,438,4,1,663,25.2,91,3,4.0,1171,False,1,336,817,16,2,2024-12-27,False,False,False,0.6976942783945346,0.28693424423569597,0.013663535439795047,0.0017079419299743809,Off-Peak,Friday,December
2024-12-27 02:00:00,103,660,12,2,777,292,625,5,1,923,24.7,94,3,4.2,1700,False,2,395,1285,17,3,2024-12-27,False,False,True,0.7558823529411764,0.2323529411764706,0.01,0.0017647058823529412,Off-Peak,Friday,December
2024-12-27 03:00:00,122,430,12,1,565,291,620,5,1,917,24.6,95,3,5.3,1482,False,3,413,1050,17,2,2024-12-27,False,False,True,0.708502024291498,0.2786774628879892,0.011470985155195682,0.001349527665317139,Off-Peak,Friday,December
2024-12-27 04:00:00,109,617,12,1,739,274,582,6,1,863,24.6,92,3,7.1,1602,False,4,383,1199,18,2,2024-12-27,False,False,True,0.7484394506866417,0.2390761548064919,0.011235955056179775,0.0012484394506866417,Off-Peak,Friday,December
2024-12-27 05:00:00,146,1023,17,1,1187,236,477,6,1,720,24.5,91,3,6.9,1907,False,5,382,1500,23,2,2024-12-27,False,False,True,0.7865757734661772,0.20031463030938648,0.012060828526481384,0.001048767697954903,Shoulder,Friday,December
2024-12-27 06:00:00,136,930,14,1,1081,215,428,5,1,649,24.3,91,3,8.2,1730,False,6,351,1358,19,2,2024-12-27,False,False,True,0.784971098265896,0.20289017341040463,0.010982658959537572,0.0011560693641618498,Shoulder,Friday,December
2024-12-27 07:00:00,138,980,14,1,1133,239,480,5,1,725,24.2,92,3,5.7,1858,False,7,377,1460,19,2,2024-12-27,False,False,True,0.7857911733046287,0.2029063509149623,0.01022604951560818,0.001076426264800861,Peak,Friday,December
2024-12-27 08:00:00,100,1047,10,1,1158,278,591,6,1,876,24.4,92,3,7.2,2034,False,8,378,1638,16,2,2024-12-27,False,False,True,0.8053097345132744,0.18584070796460178,0.007866273352999017,0.0009832841691248771,Peak,Friday,December
2024-12-27 09:00:00,139,945,16,1,1101,283,605,6,1,895,25.3,94,53,5.9,1996,False,9,422,1550,22,2,2024-12-27,False,False,True,0.7765531062124249,0.21142284569138275,0.011022044088176353,0.001002004008016032,Shoulder,Friday,December
2024-12-27 10:00:00,106,980,13,1,1100,186,656,5,1,848,26.5,87,51,0.7,1948,False,10,292,1636,18,2,2024-12-27,False,False,True,0.839835728952772,0.14989733059548255,0.009240246406570842,0.001026694045174538,Shoulder,Friday,December
2024-12-27 11:00:00,148,1145,15,1,1309,215,423,6,1,645,27.0,86,51,4.2,1954,False,11,363,1568,21,2,2024-12-27,False,False,True,0.8024564994882293,0.18577277379733878,0.010747185261003071,0.0010235414534288639,Peak,Friday,December
2024-12-27 12:00:00,101,917,11,1,1030,255,523,6,1,785,28.3,79,53,2.9,1815,False,12,356,1440,17,2,2024-12-27,False,False,True,0.7933884297520661,0.19614325068870522,0.009366391184573003,0.0011019283746556473,Peak,Friday,December
2024-12-27 13:00:00,101,864,11,1,977,206,406,5,1,618,29.2,76,51,3.4,1595,False,13,307,1270,16,2,2024-12-27,False,False,True,0.7962382445141066,0.19247648902821315,0.010031347962382446,0.0012539184952978057,Peak,Friday,December
2024-12-27 14:00:00,103,881,11,1,996,196,383,6,2,587,29.4,75,51,2.7,1583,False,14,299,1264,17,3,2024-12-27,False,False,True,0.7984838913455464,0.18888186986734049,0.010739102969046115,0.0018951358180669614,Peak,Friday,December
2024-12-27 15:00:00,135,933,14,1,1083,209,410,6,2,627,29.5,74,51,1.5,1710,False,15,344,1343,20,3,2024-12-27,False,False,True,0.7853801169590643,0.20116959064327486,0.011695906432748537,0.0017543859649122807,Peak,Friday,December
2024-12-27 16:00:00,115,761,12,1,889,201,394,6,3,604,29.2,73,61,6.3,1493,False,16,316,1155,18,4,2024-12-27,False,False,True,0.7736101808439384,0.2116543871399866,0.012056262558606833,0.0026791694574681848,Peak,Friday,December
2024-12-27 17:00:00,151,1078,15,1,1245,236,487,6,2,731,27.3,82,61,10.4,1976,False,17,387,1565,21,3,2024-12-27,False,False,True,0.792004048582996,0.1958502024291498,0.01062753036437247,0.0015182186234817814,Peak,Friday,December
2024-12-27 18:00:00,159,1016,16,1,1192,256,526,7,2,791,27.0,85,3,7.2,1983,False,18,415,1542,23,3,2024-12-27,False,False,True,0.7776096822995462,0.20927887039838627,0.011598587997982855,0.0015128593040847202,Peak,Friday,December
2024-12-27 19:00:00,114,778,12,1,905,268,551,8,2,829,26.4,86,3,7.0,1734,False,19,382,1329,20,3,2024-12-27,False,False,True,0.7664359861591695,0.22029988465974626,0.011534025374855825,0.0017301038062283738,Peak,Friday,December
2024-12-27 20:00:00,107,678,13,1,799,279,587,7,2,875,25.8,90,3,8.5,1674,False,20,386,1265,20,3,2024-12-27,False,False,True,0.7556750298685783,0.23058542413381122,0.011947431302270013,0.0017921146953405018,Shoulder,Friday,December
2024-12-27 21:00:00,131,871,15,1,1018,261,546,7,2,816,26.0,91,2,8.9,1834,False,21,392,1417,22,3,2024-12-27,False,False,True,0.7726281352235551,0.21374045801526717,0.011995637949836423,0.0016357688113413304,Shoulder,Friday,December
2024-12-27 22:00:00,154,807,18,2,981,259,544,8,2,813,25.8,91,2,10.4,1794,False,22,413,1351,26,4,2024-12-27,False,False,True,0.7530657748049052,0.2302118171683389,0.014492753623188406,0.002229654403567447,Shoulder,Friday,December
2024-12-27 23:00:00,135,901,17,1,1054,291,311,8,2,612,25.4,93,1,9.5,1666,False,23,426,1212,25,3,2024-12-27,False,False,True,0.7274909963985594,0.25570228091236497,0.015006002400960384,0.001800720288115246,Shoulder,Friday,December
2024-12-28 00:00:00,93,473,11,0,577,151,297,8,1,457,25.1,93,2,10.3,1034,True,0,244,770,19,1,2024-12-28,False,False,False,0.7446808510638298,0.23597678916827852,0.0183752417794971,0.0009671179883945841,Off-Peak,Saturday,December
2024-12-28 01:00:00,109,567,12,0,688,139,384,6,1,530,24.8,94,3,10.5,1218,True,1,248,951,18,1,2024-12-28,False,False,False,0.7807881773399015,0.20361247947454844,0.014778325123152709,0.0008210180623973727,Off-Peak,Saturday,December
2024-12-28 02:00:00,86,535,12,0,633,291,487,8,2,788,24.6,94,3,9.9,1421,True,2,377,1022,20,2,2024-12-28,False,False,True,0.7192118226600985,0.2653061224489796,0.014074595355383532,0.0014074595355383533,Off-Peak,Saturday,December
2024-12-28 03:00:00,108,559,11,0,678,279,461,7,1,748,24.5,94,3,11.6,1426,True,3,387,1020,18,1,2024-12-28,False,False,True,0.7152875175315568,0.2713884992987377,0.012622720897615708,0.0007012622720897616,Off-Peak,Saturday,December
2024-12-28 04:00:00,106,743,11,0,860,355,601,7,1,964,24.4,94,3,11.2,1824,True,4,461,1344,18,1,2024-12-28,False,False,True,0.7368421052631579,0.25274122807017546,0.009868421052631578,0.0005482456140350877,Off-Peak,Saturday,December
2024-12-28 05:00:00,136,501,13,1,651,281,460,7,1,749,24.3,94,1,12.1,1400,True,5,417,961,20,2,2024-12-28,False,False,True,0.6864285714285714,0.2978571428571429,0.014285714285714285,0.0014285714285714286,Shoulder,Saturday,December
2024-12-28 06:00:00,104,794,12,1,911,234,567,6,2,809,24.2,94,1,13.8,1720,True,6,338,1361,18,3,2024-12-28,False,False,True,0.7912790697674419,0.19651162790697674,0.010465116279069767,0.0017441860465116279,Shoulder,Saturday,December
2024-12-28 07:00:00,124,887,13,2,1026,482,766,6,2,1256,24.1,94,1,13.3,2282,True,7,606,1653,19,4,2024-12-28,False,False,True,0.724364592462752,0.26555652936021035,0.008326029798422436,0.0017528483786152498,Peak,Saturday,December
2024-12-28 08:00:00,110,981,11,1,1103,341,580,6,2,929,24.6,93,1,11.8,2032,True,8,451,1561,17,3,2024-12-28,False,False,True,0.7682086614173228,0.2219488188976378,0.008366141732283465,0.0014763779527559055,Peak,Saturday,December
2024-12-28 09:00:00,114,891,11,1,1017,352,593,7,2,954,27.1,83,3,15.0,1971,True,9,466,1484,18,3,2024-12-28,False,False,True,0.7529173008625063,0.23642820903094874,0.0091324200913242,0.0015220700152207,Shoulder,Saturday,December
2024-12-28 10:00:00,113,1103,12,1,1229,348,692,6,2,1048,28.5,76,3,18.0,2277,True,10,461,1795,18,3,2024-12-28,False,False,True,0.7883179622310057,0.20245937637241984,0.007905138339920948,0.0013175230566534915,Shoulder,Saturday,December
2024-12-28 11:00:00,104,986,12,1,1103,358,613,8,2,981,29.9,69,3,16.8,2084,True,11,462,1599,20,3,2024-12-28,False,False,True,0.767274472168906,0.22168905950095968,0.009596928982725527,0.0014395393474088292,Peak,Saturday,December
2024-12-28 12:00:00,140,1013,15,1,1169,340,575,8,2,925,31.2,62,3,16.7,2094,True,12,480,1588,23,3,2024-12-28,False,False,True,0.7583572110792741,0.22922636103151864,0.010983763132760267,0.0014326647564469914,Peak,Saturday,December
2024-12-28 13:00:00,123,1255,12,1,1391,304,502,7,2,815,32.0,60,3,13.7,2206,True,13,427,1757,19,3,2024-12-28,False,False,True,0.7964641885766093,0.19356300997280146,0.008612873980054397,0.0013599274705349048,Peak,Saturday,December
2024-12-28 14:00:00,113,987,12,1,1113,284,459,6,2,751,31.4,63,51,12.4,1864,True,14,397,1446,18,3,2024-12-28,False,False,True,0.7757510729613734,0.21298283261802575,0.009656652360515022,0.001609442060085837,Peak,Saturday,December
2024-12-28 15:00:00,103,1001,11,1,1116,221,548,7,2,778,31.1,63,1,11.6,1894,True,15,324,1549,18,3,2024-12-28,False,False,True,0.8178458289334741,0.17106652587117213,0.009503695881731784,0.0015839493136219642,Peak,Saturday,December
2024-12-28 16:00:00,115,872,13,1,1001,274,445,7,3,729,30.7,65,53,14.6,1730,True,16,389,1317,20,4,2024-12-28,False,False,True,0.761271676300578,0.22485549132947977,0.011560693641618497,0.0023121387283236996,Peak,Saturday,December
2024-12-28 17:00:00,100,957,13,1,1071,245,387,7,2,641,29.8,68,51,14.3,1712,True,17,345,1344,20,3,2024-12-28,False,False,True,0.7850467289719626,0.20151869158878505,0.011682242990654205,0.0017523364485981308,Peak,Saturday,December
2024-12-28 18:00:00,111,701,12,1,825,340,580,9,2,931,29.5,70,2,11.9,1756,True,18,451,1281,21,3,2024-12-28,False,False,True,0.729498861047836,0.25683371298405466,0.011958997722095672,0.0017084282460136675,Peak,Saturday,December
2024-12-28 19:00:00,150,982,17,2,1151,346,591,8,2,947,28.3,76,3,13.2,2098,True,19,496,1573,25,4,2024-12-28,False,False,True,0.7497616777883699,0.23641563393708293,0.011916110581506196,0.0019065776930409914,Peak,Saturday,December
2024-12-28 20:00:00,116,796,12,1,925,220,339,7,2,568,27.5,80,3,12.2,1493,True,20,336,1135,19,3,2024-12-28,False,False,True,0.7602143335565975,0.22505023442732752,0.012726054922973878,0.0020093770931011385,Shoulder,Saturday,December
2024-12-28 21:00:00,103,705,13,1,822,242,381,7,2,632,24.8,98,63,1.5,1454,True,21,345,1086,20,3,2024-12-28,False,False,True,0.7469050894085282,0.23727647867950483,0.013755158184319119,0.0020632737276478678,Shoulder,Saturday,December
2024-12-28 22:00:00,143,416,16,1,576,314,222,8,2,546,24.9,94,61,3.6,1122,True,22,457,638,24,3,2024-12-28,False,False,False,0.5686274509803921,0.40730837789661317,0.0213903743315508,0.00267379679144385,Shoulder,Saturday,December
2024-12-28 23:00:00,105,633,20,1,759,382,266,11,2,661,24.7,97,51,2.0,1420,True,23,487,899,31,3,2024-12-28,False,False,True,0.6330985915492958,0.3429577464788732,0.021830985915492956,0.002112676056338028,Shoulder,Saturday,December
2024-12-29 00:00:00,51,448,18,1,518,105,361,6,2,474,24.4,98,51,6.1,992,True,0,156,809,24,3,2024-12-29,False,False,False,0.8155241935483871,0.15725806451612903,0.024193548387096774,0.0030241935483870967,Off-Peak,Sunday,December
2024-12-29 01:00:00,32,309,17,2,360,282,428,5,2,717,24.1,98,3,5.1,1077,True,1,314,737,22,4,2024-12-29,False,False,False,0.6843082636954503,0.2915506035283194,0.02042711234911792,0.003714020427112349,Off-Peak,Sunday,December
2024-12-29 02:00:00,99,229,12,2,342,388,334,5,2,729,24.1,97,3,7.7,1071,True,2,487,563,17,4,2024-12-29,False,False,False,0.5256769374416433,0.45471521942110177,0.015873015873015872,0.003734827264239029,Off-Peak,Sunday,December
2024-12-29 03:00:00,107,584,15,2,708,330,428,5,2,765,24.2,96,3,10.4,1473,True,3,437,1012,20,4,2024-12-29,False,False,True,0.6870332654446707,0.296673455532926,0.013577732518669382,0.0027155465037338763,Off-Peak,Sunday,December
2024-12-29 04:00:00,119,568,17,2,706,332,528,5,2,867,24.1,96,3,10.4,1573,True,4,451,1096,22,4,2024-12-29,False,False,True,0.6967577876668786,0.2867132867132867,0.013986013986013986,0.0025429116338207248,Off-Peak,Sunday,December
2024-12-29 05:00:00,122,828,15,2,967,369,595,7,3,974,24.1,96,3,12.5,1941,True,5,491,1423,22,5,2024-12-29,False,False,True,0.7331272539927872,0.25296239052035036,0.011334363730036065,0.002575991756826378,Shoulder,Sunday,December
2024-12-29 06:00:00,190,765,12,2,969,298,465,6,2,771,24.1,96,3,13.9,1740,True,6,488,1230,18,4,2024-12-29,False,False,True,0.7068965517241379,0.28045977011494255,0.010344827586206896,0.0022988505747126436,Shoulder,Sunday,December
2024-12-29 07:00:00,132,924,16,2,1074,272,408,7,2,689,23.9,96,3,12.7,1763,True,7,404,1332,23,4,2024-12-29,False,False,True,0.7555303460011344,0.22915484968803176,0.013045944412932501,0.0022688598979013048,Peak,Sunday,December
2024-12-29 08:00:00,208,822,15,3,1048,253,667,6,3,929,24.2,94,3,13.7,1977,True,8,461,1489,21,6,2024-12-29,False,False,True,0.7531613555892767,0.23318158826504806,0.010622154779969651,0.0030349013657056147,Peak,Sunday,December
2024-12-29 09:00:00,114,1063,15,2,1194,398,462,5,2,867,26.3,87,3,13.0,2061,True,9,512,1525,20,4,2024-12-29,False,False,True,0.739932071809801,0.24842309558466763,0.009704027171276079,0.0019408054342552159,Shoulder,Sunday,December
2024-12-29 10:00:00,133,967,13,2,1115,343,853,6,2,1204,28.1,78,3,17.2,2319,True,10,476,1820,19,4,2024-12-29,False,False,True,0.7848210435532557,0.2052608883139284,0.008193186718413108,0.0017248814144027599,Shoulder,Sunday,December
2024-12-29 11:00:00,124,1251,16,2,1393,364,403,6,2,775,29.5,69,3,18.5,2168,True,11,488,1654,22,4,2024-12-29,False,False,True,0.7629151291512916,0.22509225092250923,0.01014760147601476,0.0018450184501845018,Peak,Sunday,December
2024-12-29 12:00:00,103,976,13,2,1094,320,502,6,3,831,30.8,63,3,15.9,1925,True,12,423,1478,19,5,2024-12-29,False,False,True,0.7677922077922078,0.21974025974025974,0.009870129870129871,0.0025974025974025974,Peak,Sunday,December
2024-12-29 13:00:00,114,972,15,2,1103,369,516,5,3,893,31.7,59,51,11.2,1996,True,13,483,1488,20,5,2024-12-29,False,False,True,0.7454909819639278,0.24198396793587174,0.01002004008016032,0.00250501002004008,Peak,Sunday,December
2024-12-29 14:00:00,143,1309,18,2,1472,323,509,5,3,840,32.2,60,3,9.5,2312,True,14,466,1818,23,5,2024-12-29,False,False,True,0.7863321799307958,0.20155709342560554,0.009948096885813149,0.0021626297577854673,Peak,Sunday,December
2024-12-29 15:00:00,111,1016,16,2,1145,322,514,5,3,844,32.4,59,3,7.6,1989,True,15,433,1530,21,5,2024-12-29,False,False,True,0.7692307692307693,0.21769733534439417,0.010558069381598794,0.002513826043237808,Peak,Sunday,December
2024-12-29 16:00:00,113,747,16,2,878,324,519,6,3,852,29.5,68,61,14.1,1730,True,16,437,1266,22,5,2024-12-29,False,False,True,0.7317919075144509,0.2526011560693642,0.012716763005780347,0.002890173410404624,Peak,Sunday,December
2024-12-29 17:00:00,108,701,15,2,826,393,644,7,3,1047,27.7,80,61,6.9,1873,True,17,501,1345,22,5,2024-12-29,False,False,True,0.7180993059263214,0.26748531767218364,0.011745862253069941,0.0026695141484249867,Peak,Sunday,December
2024-12-29 18:00:00,130,885,17,2,1034,307,477,6,3,793,25.9,87,63,8.4,1827,True,18,437,1362,23,5,2024-12-29,False,False,True,0.7454844006568144,0.23918992884510126,0.012588943623426382,0.002736726874657909,Peak,Sunday,December
2024-12-29 19:00:00,129,890,18,2,1039,293,448,6,3,750,26.1,90,51,12.7,1789,True,19,422,1338,24,5,2024-12-29,False,False,True,0.747903856903298,0.23588596981553941,0.013415315818893237,0.002794857462269424,Peak,Sunday,December
2024-12-29 20:00:00,136,869,21,4,1030,296,456,6,3,761,25.2,92,3,15.4,1791,True,20,432,1325,27,7,2024-12-29,False,False,True,0.7398101619207147,0.24120603015075376,0.01507537688442211,0.003908431044109436,Shoulder,Sunday,December
2024-12-29 21:00:00,99,637,15,2,753,381,619,9,4,1013,25.4,94,51,10.3,1766,True,21,480,1256,24,6,2024-12-29,False,False,True,0.711211778029445,0.2718006795016987,0.013590033975084938,0.0033975084937712344,Shoulder,Sunday,December
2024-12-29 22:00:00,107,695,16,2,820,335,538,8,3,884,24.9,95,51,13.5,1704,True,22,442,1233,24,5,2024-12-29,False,False,True,0.7235915492957746,0.25938967136150237,0.014084507042253521,0.0029342723004694834,Shoulder,Sunday,December
2024-12-29 23:00:00,144,761,21,2,928,268,405,7,3,683,24.3,95,51,16.7,1611,True,23,412,1166,28,5,2024-12-29,False,False,True,0.7237740533829919,0.25574177529484793,0.01738050900062073,0.0031036623215394167,Shoulder,Sunday,December
2024-12-30 00:00:00,137,399,13,1,550,290,293,4,1,588,23.6,95,51,13.1,1138,False,0,427,692,17,2,2024-12-30,False,False,False,0.6080843585237259,0.37521968365553604,0.014938488576449912,0.0017574692442882249,Off-Peak,Monday,December
2024-12-30 01:00:00,127,448,12,1,588,245,450,3,2,700,23.4,95,51,13.7,1288,False,1,372,898,15,3,2024-12-30,False,False,False,0.6972049689440993,0.2888198757763975,0.011645962732919254,0.002329192546583851,Off-Peak,Monday,December
2024-12-30 02:00:00,105,511,11,1,628,262,493,3,2,760,23.4,96,53,16.2,1388,False,2,367,1004,14,3,2024-12-30,False,False,True,0.723342939481268,0.26440922190201727,0.010086455331412104,0.002161383285302594,Off-Peak,Monday,December
2024-12-30 03:00:00,162,504,16,1,683,174,358,4,2,538,23.4,97,61,14.3,1221,False,3,336,862,20,3,2024-12-30,False,False,False,0.7059787059787059,0.2751842751842752,0.01638001638001638,0.002457002457002457,Off-Peak,Monday,December
2024-12-30 04:00:00,120,709,12,1,842,301,577,4,2,884,23.4,97,51,18.7,1726,False,4,421,1286,16,3,2024-12-30,False,False,True,0.7450753186558516,0.24391657010428738,0.009269988412514484,0.0017381228273464658,Off-Peak,Monday,December
2024-12-30 05:00:00,103,946,12,2,1063,282,531,4,2,819,23.6,96,51,15.4,1882,False,5,385,1477,16,4,2024-12-30,False,False,True,0.7848034006376196,0.20456960680127523,0.008501594048884165,0.0021253985122210413,Shoulder,Monday,December
2024-12-30 06:00:00,138,819,15,1,973,276,613,4,2,895,23.2,98,63,11.3,1868,False,6,414,1432,19,3,2024-12-30,False,False,True,0.7665952890792291,0.22162740899357602,0.010171306209850108,0.0016059957173447537,Shoulder,Monday,December
2024-12-30 07:00:00,154,941,15,1,1111,350,708,4,2,1064,23.3,97,55,12.6,2175,False,7,504,1649,19,3,2024-12-30,False,False,True,0.7581609195402299,0.2317241379310345,0.008735632183908045,0.001379310344827586,Peak,Monday,December
2024-12-30 08:00:00,169,989,11,1,1170,376,756,5,3,1140,23.6,95,51,15.9,2310,False,8,545,1745,16,4,2024-12-30,False,False,True,0.7554112554112554,0.23593073593073594,0.006926406926406926,0.0017316017316017316,Peak,Monday,December
2024-12-30 09:00:00,125,843,12,1,981,443,646,4,2,1095,24.5,96,55,9.8,2076,False,9,568,1489,16,3,2024-12-30,False,False,True,0.7172447013487476,0.27360308285163776,0.007707129094412331,0.001445086705202312,Shoulder,Monday,December
2024-12-30 10:00:00,134,934,14,1,1083,369,838,4,2,1213,25.7,91,53,16.4,2296,False,10,503,1772,18,3,2024-12-30,False,False,True,0.7717770034843205,0.2190766550522648,0.0078397212543554,0.0013066202090592336,Shoulder,Monday,December
2024-12-30 11:00:00,164,1040,16,1,1221,331,648,4,2,985,26.6,87,51,18.3,2206,False,11,495,1688,20,3,2024-12-30,False,False,True,0.7651858567543064,0.2243880326382593,0.009066183136899365,0.0013599274705349048,Peak,Monday,December
2024-12-30 12:00:00,140,1032,14,1,1187,320,621,5,2,948,27.2,84,51,16.9,2135,False,12,460,1653,19,3,2024-12-30,False,False,True,0.7742388758782202,0.2154566744730679,0.008899297423887589,0.001405152224824356,Peak,Monday,December
2024-12-30 13:00:00,143,980,14,1,1138,346,780,4,2,1132,28.0,80,51,17.9,2270,False,13,489,1760,18,3,2024-12-30,False,False,True,0.775330396475771,0.21541850220264316,0.007929515418502203,0.0013215859030837004,Peak,Monday,December
2024-12-30 14:00:00,162,1108,17,2,1289,345,639,4,2,990,27.2,78,51,19.2,2279,False,14,507,1747,21,4,2024-12-30,False,False,True,0.766564282580079,0.2224659938569548,0.009214567792891619,0.0017551557700745941,Peak,Monday,December
2024-12-30 15:00:00,118,997,13,1,1129,363,735,4,2,1104,27.0,81,51,13.3,2233,False,15,481,1732,17,3,2024-12-30,False,False,True,0.7756381549484997,0.21540528437080161,0.00761307657859382,0.0013434841021047917,Peak,Monday,December
2024-12-30 16:00:00,137,954,14,1,1106,277,511,5,3,796,27.4,79,51,10.9,1902,False,16,414,1465,19,4,2024-12-30,False,False,True,0.770241850683491,0.21766561514195584,0.009989484752891693,0.002103049421661409,Peak,Monday,December
2024-12-30 17:00:00,160,990,18,2,1170,249,668,4,2,923,28.3,73,3,12.5,2093,False,17,409,1658,22,4,2024-12-30,False,False,True,0.7921643573817487,0.1954132823698041,0.01051122790253225,0.0019111323459149545,Peak,Monday,December
2024-12-30 18:00:00,148,900,16,2,1066,324,625,4,2,955,27.7,76,3,11.5,2021,False,18,472,1525,20,4,2024-12-30,False,False,True,0.7545769421078674,0.23354774863928748,0.009896091044037604,0.0019792182088075212,Peak,Monday,December
2024-12-30 19:00:00,127,754,14,2,897,289,562,4,3,858,26.9,79,2,10.1,1755,False,19,416,1316,18,5,2024-12-30,False,False,True,0.7498575498575498,0.23703703703703705,0.010256410256410256,0.002849002849002849,Peak,Monday,December
2024-12-30 20:00:00,138,823,15,2,978,384,775,5,4,1168,26.1,84,3,6.2,2146,False,20,522,1598,20,6,2024-12-30,False,False,True,0.744641192917055,0.24324324324324326,0.009319664492078284,0.0027958993476234857,Shoulder,Monday,December
2024-12-30 21:00:00,93,500,11,2,606,313,595,4,3,915,25.2,90,3,11.3,1521,False,21,406,1095,15,5,2024-12-30,False,False,True,0.7199211045364892,0.2669296515450362,0.009861932938856016,0.003287310979618672,Shoulder,Monday,December
2024-12-30 22:00:00,120,705,14,2,841,272,502,4,3,781,24.9,92,3,11.6,1622,False,22,392,1207,18,5,2024-12-30,False,False,True,0.7441430332922319,0.24167694204685575,0.011097410604192354,0.0030826140567200987,Shoulder,Monday,December
2024-12-30 23:00:00,123,673,17,2,815,317,610,4,3,934,24.9,91,3,11.9,1749,False,23,440,1283,21,5,2024-12-30,False,False,True,0.7335620354488279,0.25157232704402516,0.012006861063464836,0.002858776443682104,Shoulder,Monday,December
2024-12-31 00:00:00,134,734,11,0,879,235,581,2,1,819,24.8,90,3,12.0,1698,False,0,369,1315,13,1,2024-12-31,False,False,True,0.7744405182567726,0.21731448763250882,0.0076560659599528855,0.0005889281507656066,Off-Peak,Tuesday,December
2024-12-31 01:00:00,124,528,10,1,663,262,338,3,1,604,24.6,90,3,12.5,1267,False,1,386,866,13,2,2024-12-31,False,False,False,0.6835043409629045,0.30465666929755325,0.010260457774269928,0.0015785319652722968,Off-Peak,Tuesday,December
2024-12-31 02:00:00,129,290,11,1,431,290,250,3,1,544,24.4,91,3,11.9,975,False,2,419,540,14,2,2024-12-31,False,False,False,0.5538461538461539,0.4297435897435897,0.014358974358974359,0.0020512820512820513,Off-Peak,Tuesday,December
2024-12-31 03:00:00,115,280,9,1,405,219,211,3,1,434,24.1,93,3,10.4,839,False,3,334,491,12,2,2024-12-31,False,False,False,0.5852205005959475,0.39809296781883197,0.014302741358760428,0.0023837902264600714,Off-Peak,Tuesday,December
2024-12-31 04:00:00,128,264,10,1,403,243,190,3,1,437,24.0,94,3,8.2,840,False,4,371,454,13,2,2024-12-31,False,False,False,0.5404761904761904,0.44166666666666665,0.015476190476190477,0.002380952380952381,Off-Peak,Tuesday,December
2024-12-31 05:00:00,111,315,11,2,439,249,405,3,1,658,24.1,93,3,6.5,1097,False,5,360,720,14,3,2024-12-31,False,False,False,0.6563354603463992,0.3281677301731996,0.01276207839562443,0.0027347310847766638,Shoulder,Tuesday,December
2024-12-31 06:00:00,110,608,9,1,728,256,641,3,1,901,24.1,92,3,5.3,1629,False,6,366,1249,12,2,2024-12-31,False,False,True,0.7667280540208717,0.22467771639042358,0.007366482504604052,0.0012277470841006752,Shoulder,Tuesday,December
2024-12-31 07:00:00,143,873,12,1,1029,214,618,3,1,836,23.9,92,3,5.5,1865,False,7,357,1491,15,2,2024-12-31,False,False,True,0.7994638069705093,0.19142091152815013,0.00804289544235925,0.0010723860589812334,Peak,Tuesday,December
2024-12-31 08:00:00,118,891,13,1,1023,225,845,3,1,1074,24.1,92,3,8.1,2097,False,8,343,1736,16,2,2024-12-31,False,False,True,0.8278493085360038,0.16356700047687173,0.007629947544110634,0.0009537434430138292,Peak,Tuesday,December
2024-12-31 09:00:00,98,992,11,1,1102,275,708,3,1,987,25.8,84,3,13.4,2089,False,9,373,1700,14,2,2024-12-31,False,False,True,0.8137865007180469,0.17855433221637146,0.006701771182383916,0.0009573958831977022,Shoulder,Tuesday,December
2024-12-31 10:00:00,122,923,11,1,1057,256,737,3,1,997,27.0,78,3,14.5,2054,False,10,378,1660,14,2,2024-12-31,False,False,True,0.8081791626095424,0.18403115871470302,0.006815968841285297,0.0009737098344693282,Shoulder,Tuesday,December
2024-12-31 11:00:00,135,938,12,1,1086,212,804,3,1,1020,28.4,70,3,19.3,2106,False,11,347,1742,15,2,2024-12-31,False,False,True,0.8271604938271605,0.1647673314339981,0.007122507122507123,0.000949667616334283,Peak,Tuesday,December
2024-12-31 12:00:00,136,907,13,1,1057,244,807,4,1,1056,28.8,70,3,19.5,2113,False,12,380,1714,17,2,2024-12-31,False,False,True,0.8111689540937056,0.17983909133932796,0.008045433033601515,0.000946521533364884,Peak,Tuesday,December
2024-12-31 13:00:00,104,971,10,1,1086,302,780,5,2,1089,29.1,71,3,15.3,2175,False,13,406,1751,15,3,2024-12-31,False,False,True,0.8050574712643678,0.18666666666666668,0.006896551724137931,0.001379310344827586,Peak,Tuesday,December
2024-12-31 14:00:00,97,902,9,1,1009,253,822,4,1,1080,29.7,70,3,14.5,2089,False,14,350,1724,13,2,2024-12-31,False,False,True,0.8252752513164193,0.1675442795595979,0.006223073240785065,0.0009573958831977022,Peak,Tuesday,December
2024-12-31 15:00:00,129,991,12,1,1133,268,681,5,2,956,30.0,67,3,11.0,2089,False,15,397,1672,17,3,2024-12-31,False,False,True,0.8003829583532791,0.19004308281474389,0.008137865007180469,0.0014360938247965534,Peak,Tuesday,December
2024-12-31 16:00:00,115,920,11,1,1047,235,872,4,1,1112,30.1,66,3,7.7,2159,False,16,350,1792,15,2,2024-12-31,False,False,True,0.8300138953219083,0.1621120889300602,0.006947660954145438,0.0009263547938860583,Peak,Tuesday,December
2024-12-31 17:00:00,138,954,13,1,1106,280,722,4,1,1007,29.4,68,3,7.1,2113,False,17,418,1676,17,2,2024-12-31,False,False,True,0.7931850449597728,0.19782300047326076,0.008045433033601515,0.000946521533364884,Peak,Tuesday,December
2024-12-31 18:00:00,109,998,10,1,1118,282,704,5,2,993,28.5,72,3,8.1,2111,False,18,391,1702,15,3,2024-12-31,False,False,True,0.8062529606821411,0.1852202747513027,0.0071056371387967785,0.0014211274277593558,Peak,Tuesday,December
2024-12-31 19:00:00,135,995,14,2,1146,273,679,4,2,958,27.1,84,3,6.7,2104,False,19,408,1674,18,4,2024-12-31,False,False,True,0.7956273764258555,0.19391634980988592,0.008555133079847909,0.0019011406844106464,Peak,Tuesday,December
2024-12-31 20:00:00,128,956,13,1,1098,234,782,4,2,1022,25.9,90,3,8.7,2120,False,20,362,1738,17,3,2024-12-31,False,False,True,0.819811320754717,0.17075471698113207,0.008018867924528302,0.0014150943396226414,Shoulder,Tuesday,December
2024-12-31 21:00:00,104,922,9,1,1036,202,455,4,2,663,25.4,93,63,3.8,1699,False,21,306,1377,13,3,2024-12-31,False,False,True,0.8104767510300177,0.18010594467333726,0.007651559741024131,0.0017657445556209534,Shoulder,Tuesday,December
2024-12-31 22:00:00,105,946,12,1,1064,243,587,4,2,836,25.2,95,51,11.3,1900,False,22,348,1533,16,3,2024-12-31,False,False,True,0.8068421052631579,0.1831578947368421,0.008421052631578947,0.0015789473684210526,Shoulder,Tuesday,December
2024-12-31 23:00:00,109,882,11,1,1003,217,528,5,2,752,24.7,96,51,8.3,1755,False,23,326,1410,16,3,2024-12-31,False,False,True,0.8034188034188035,0.18575498575498575,0.009116809116809116,0.0017094017094017094,Shoulder,Tuesday,December
